ᆜ	j ɯ	jㅡ
ㄱㄱ	k o̞ ɡ o̞	고고
ㄹ혜	k ɯ n ʝ e̞	근헤
ㅇㅇ	ɯ ŋ	응
ㅈ	t͡ɕ	ㅈ
ㅈㅅ	t͡ɕ w e̞ sʰ o̞ ŋ	ㅈe송
ㅏ	a̠	아
ㅑ	j a̠	야
ㅓ	ʌ̹	어
ㅔ	e̞	에
ㅕ	j ʌ̹	여
ㅖ	j e̞	예
ㅗ	o̞	오
ㅘ	w a̠	와
ㅚ	w e̞	외
ㅛ	j o	요
ㅜ	u	우
ㅝ	w ʌ̹	워
ㅞ	w e̞	웨
ㅟ	ɥ i	위
ㅠ	j u	유
ㅡ	ɯ	으
ㅢ	ɰ i	의
ㅣ	i	이
가	k a̠	가
가가우스어	k a̠ ɡ a̠ u sʰ ɯ ʌ̹	가가우스어
가감하다	k a̠ ɡ a̠ m ɦ a̠ d a̠	가감하다
가강수량	k a̠ ɡ a̠ ŋ sʰ u ɾ j a̠ ŋ	가강수량
가갸시절	k a̠ ɡ j a̠ ɕʰ i d͡ʑ ʌ̹ ɭ	가갸시절
가공되다	k a̠ː ɡ o̞ ŋ d w e̞ d a̠	가공되다
가공하다	k a̠ ɡ o̞ ŋ ɦ a̠ d a̠	가공하다
가관	k a̠ ɡ w a̠ n	가관
가금	k a̠ ɡ ɯ m	가금
가껍다	k a̠ k͈ ʌ̹ p̚ t͈ a̠	가껍따
가꾸다	k a̠ k͈ u d a̠	가꾸다
가나다순	k a̠ n a̠ d a̠ sʰ u n	가나다순
가난히	k a̠ n a̠ n ʝ i	가난히
가누다	k a̠ n u d a̠	가누다
가닛	k a̠ n i t̚	가닏
가다가	k a̠ d a̠ ɡ a̠	가다가
가다붙다	k a̠ d a̠ b u t̚ t͈ a̠	가다붇따
가달	k a̠ d a̠ ɭ	가달
가돌리늄	k a̠ d o̞ ʎ ʎ i ɲ u m	가돌리눔
가동되다	k a̠ d o̞ ŋ d w e̞ d a̠	가동되다
가동하다	k a̠ d o̞ ŋ ɦ a̠ d a̠	가동하다
가두녀성	k a̠ d u ɲ ʌ̹ sʰ ʌ̹ ŋ	가두너성
가두다	k a̠ d u d a̠	가두다
가라	k a̠ ɾ a̠	가라
가라앉다	k a̠ ɾ a̠ a̠ n t͈ a̠	가라안따
가락점	k a̠ ɾ a̠ k̚ t͡ɕ͈ ʌ̹ m	가락쩜
가락지	k a̠ ɾ a̠ k̚ t͡ɕ͈ i	가락찌
가락지빵	k a̠ ɾ a̠ k̚ t͡ɕ͈ i p͈ a̠ ŋ	가락찌빵
가람	k a̠ ɾ a̠ m	가람
가련하다	k a̠ː ɾ j ʌ̹ n ɦ a̠ d a̠	가련하다
가련히	k a̠ ɾ j ʌ̹ n ʝ i	가련히
가렵다	k a̠ ɾ j ʌ̹ p̚ t͈ a̠	가렵따
가령가령ᄒᆞ다	k a̠ ɾ j ʌ̹ ŋ ɡ a̠ ɾ j ʌ̹ ŋ ɦ a̠ d a̠	가령가령하다
가로막	k a̠ ɾ o̞ m a̠ k̚	가로막
가로지다	k a̠ ɾ o̞ d͡ʑ i d a̠	가로지다
가뢰	k a̠ ɾ w e̞	가뢰
가름	k a̠ ɾ ɯ m	가름
가마	k a̠ m a̠	가마
가마괴	k a̠ m a̠ ɡ w e̞	가마괴
가마치	k a̠ m a̠ t͡ɕʰ i	가마치
가멸다	k a̠ː m j ʌ̹ ɭ d a̠	가멸다
가뭇가뭇	k a̠ m u t̚ k͈ a̠ m u t̚	가묻까묻
가벼워지다	k a̠ b j ʌ̹ w ʌ̹ d͡ʑ i d a̠	가벼워지다
가변	k a̠ b j ʌ̹ n	가변
가보로네	k a̠ b o̞ ɾ o̞ n e̞	가보로네
가불기	k a̠ b u ɭ ɡ i	가불기
가쁘다	k a̠ p͈ ɯ d a̠	가쁘다
가산되다	k a̠ sʰ a̠ n d w e̞ d a̠	가산되다
가산하다	k a̠ sʰ a̠ n ɦ a̠ d a̠	가산하다
가설	k a̠ sʰ ʌ̹ ɭ	가설
가설되다	k a̠ sʰ ʌ̹ ɭ d w e̞ d a̠	가설되다
가설법	k a̠ː sʰ ʌ̹ ɭ p͈ ʌ̹ p̚	가설뻡
가설하다	k a̠ sʰ ʌ̹ ɾ ɦ a̠ d a̠	가설하다
가성비	k a̠ sʰ ʌ̹ ŋ b i	가성비
가세하다	k a̠ sʰ e̞ ɦ a̠ d a̠	가세하다
가소롭다	k a̠ː sʰ o̞ ɾ o̞ p̚ t͈ a̠	가소롭따
가소제	k a̠ː sʰ o̞ d͡ʑ e̞	가소제
가스나이	k a̠ sʰ ɯ n a̠ i	가스나이
가스파초	k a̠ sʰ ɯ pʰ a̠ t͡ɕʰ o̞	가스파초
가슴뼈	k a̠ sʰ ɯ m p͈ j ʌ̹	가슴뼈
가슴주머니	k a̠ sʰ ɯ m d͡ʑ u m ʌ̹ n i	가슴주머니
가시납지리	k a̠ ɕʰ i n a̠ p̚ t͡ɕ͈ i ɾ i	가시납찌리
가시두더지	k a̠ ɕʰ i d u d ʌ̹ d͡ʑ i	가시두더지
가시버시	k a̠ ɕʰ i b ʌ̹ ɕʰ i	가시버시
가시비름	k a̠ ɕʰ i b i ɾ ɯ m	가시비름
가시어머니	k a̠ ɕʰ i ʌ̹ m ʌ̹ n i	가시어머니
가시집	k a̠ ɕʰ i d͡ʑ i p̚	가시집
가식하다	k a̠ː ɕʰ i kʰ a̠ d a̠	가시카다
가실	k a̠ ɕʰ i ɭ	가실
가쓰오부시	k a̠ s͈ ɯ o̞ b u ɕʰ i	가쓰오부시
가언적	k a̠ ʌ̹ ɲ d͡ʑ ʌ̹ k̚	가언적
가없다	k a̠ː ʌ̹ p̚ t͈ a̠	가업따
가연성	k a̠ː j ʌ̹ n s͈ ʌ̹ ŋ	가연썽
가웃	k a̠ u t̚	가욷
가위주먹	k a̠ ɥ i d͡ʑ u m ʌ̹ k̚	가위주먹
가이	k a̠ i	가이
가장	k a̠ d͡ʑ a̠ ŋ	가장
가정	k a̠ d͡ʑ ʌ̹ ŋ	가정
가정교사	k a̠ d͡ʑ ʌ̹ ŋ k j oː sʰ a̠	가정교사
가정하다	k a̠ː d͡ʑ ʌ̹ ŋ ɦ a̠ d a̠	가정하다
가주	k a̠ d͡ʑ u	가주
가죽끈	k a̠ d͡ʑ u k̚ k͈ ɯ n	가죽끈
가지가지	k a̠ d͡ʑ i ɡ a̠ d͡ʑ i	가지가지
가찹다	k a̠ t͡ɕʰ a̠ p̚ t͈ a̠	가찹따
가창	k a̠ t͡ɕʰ a̠ ŋ	가창
가창오리	k a̠ t͡ɕʰ a̠ ŋ o̞ ɾ i	가창오리
가철	k a̠ː t͡ɕʰ ʌ̹ ɭ	가철
가체	k a̠ t͡ɕʰ e̞	가체
가타나	k a̠ tʰ a̠ n a̠	가타나
가티노	k a̠ tʰ i n o̞	가티노
가하다	k a̠ ɦ a̠ d a̠	가하다
가혹	k a̠ː β o̞ k̚	가혹
각	k a̠ k̚	각
각골난망	k a̠ k̚ k͈ o̞ ɭ ɭ a̠ n m a̠ ŋ	각꼴란망
각목	k a̠ ŋ m o̞ k̚	강목
각오	k a̠ ɡ o̞	가고
간	k a̠ n	간
간계	k a̠ n ɡ j e̞	간계
간곡	k a̠ː n ɡ o̞ k̚	간곡
간곡하다	k a̠ː n ɡ o̞ kʰ a̠ d a̠	간고카다
간균	k a̠ n ɡ j u n	간균
간나	k a̠ n n a̠	간나
간난	k a̠ n n a̠ n	간난
간단	k a̠ n d a̠ n	간단
간단하다	k a̠ n t͈ a̠ n ɦ a̠ d a̠	간딴하다
간데없이	k a̠ n d e̞ ʌ̹ p ɕ͈ i	간데업씨
간모	k a̠ n m o̞	간모
간물	k a̠ n m u ɭ	간물
간밤	k a̠ n b a̠ m	간밤
간병인	k a̠ n b j ʌ̹ ŋ i n	간병인
간부회	k a̠ n b u β w e̞	간부회
간사히	k a̠ n sʰ a̠ ʝ i	간사히
간섭하다	k a̠ n sʰ ʌ̹ pʰ a̠ d a̠	간서파다
간신	k a̠ n ɕʰ i n	간신
간신히	k a̠ n ɕʰ i n ʝ i	간신히
간쑤	k a̠ n s͈ u	간쑤
간악	k a̠ n a̠ k̚	가낙
간장	k a̠ ɲ d͡ʑ a̠ ŋ	간장
간접화법	k a̠ ɲ d͡ʑ ʌ̹ pʰ w a̠ b ʌ̹ p̚	간저퐈법
간증	k a̠ ɲ d͡ʑ ɯ ŋ	간증
간직하다	k a̠ ɲ d͡ʑ i kʰ a̠ d a̠	간지카다
간청	k a̠ː ɲ t͡ɕʰ ʌ̹ ŋ	간청
간청하다	k a̠ː ɲ t͡ɕʰ ʌ̹ ŋ ɦ a̠ d a̠	간청하다
간체자	k a̠ ɲ t͡ɕʰ e̞ d͡ʑ a̠	간체자
간추리다	k a̠ ɲ t͡ɕʰ u ɾ i d a̠	간추리다
간파	k a̠ n pʰ a̠	간파
간호	k a̠ n β o̞	간호
간호하다	k a̠ n β o̞ ɦ a̠ d a̠	간호하다
갇히다	k a̠ t͡ɕʰ i d a̠	가치다
갈	k a̠ ɭ	갈
갈겨니	k a̠ ɭ ɡ j ʌ̹ n i	갈겨니
갈고닦다	k a̠ː ɭ ɡ o̞ d a̠ k̚ t͈ a̠	갈고닥따
갈고랑이	k a̠ ɭ ɡ o̞ ɾ a̠ ŋ i	갈고랑이
갈까마귀	k a̠ ɭ k͈ a̠ m a̠ ɡ ɥ i	갈까마귀
갈나무	k a̠ ɭ ɭ a̠ m u	갈라무
갈다	k a̠ ɭ d a̠	갈다
갈닦다	k a̠ː ɭ d a̠ k̚ t͈ a̠	갈닥따
갈라지다	k a̠ ɭ ɭ a̠ d͡ʑ i d a̠	갈라지다
갈리	k a̠ ʎ ʎ i	갈리
갈리다	k a̠ ʎ ʎ i d a̠	갈리다
갈림	k a̠ ʎ ʎ i m	갈림
갈문망둑	k a̠ ɭ m u n m a̠ ŋ d u k̚	갈문망둑
갈밭	k a̠ ɭ b a̠ t̚	갈받
갈밭쥐	k a̠ ɭ b a̠ t̚ t͡ɕ͈ ɥ i	갈받쮜
갈보	k a̠ ɭ b o̞	갈보
갈보집	k a̠ ɭ b o̞ d͡ʑ i p̚	갈보집
갈부수다	k a̠ː ɭ b u sʰ u d a̠	갈부수다
갈쓰뚝	k a̠ ɭ s͈ ɯ t͈ u k̚	갈쓰뚝
갈아들다	k a̠ ɾ a̠ d ɯ ɭ d a̠	가라들다
갈아신다	k a̠ ɾ a̠ ɕʰ i n d a̠	가라신다
갈아입다	k a̠ ɾ a̠ i p̚ t͈ a̠	가라입따
갈옷	k a̠ ɾ o̞ t̚	가롣
갈음이름씨	k a̠ ɾ ɯ m i ɾ ɯ m ɕ͈ i	가르미름씨
갈음하다	k a̠ ɾ ɯ m ɦ a̠ d a̠	가름하다
갈참나무	k a̠ ʎ t͡ɕʰ a̠ m n a̠ m u	갈참나무
갈치	k a̠ ʎ t͡ɕʰ i	갈치
갈퀴	k a̠ ɭ kʰ ɥ i	갈퀴
갈퀴다	k a̠ ɭ kʰ ɥ i d a̠	갈퀴다
갈토	k a̠ ɭ tʰ o̞	갈토
갉	k a̠ k̚	각
감	k a̠ m	감
감기다	k a̠ m ɡ i d a̠	감기다
감나무	k a̠ː m n a̠ m u	감나무
감당되다	k a̠ m d a̠ ŋ d w e̞ d a̠	감당되다
감돌고기	k a̠ m d o̞ ɭ ɡ o̞ ɡ i	감돌고기
감동사	k a̠ː m d o̞ ŋ sʰ a̠	감동사
감람	k a̠ m n a̠ m	감남
감람나무	k a̠ m n a̠ m n a̠ m u	감남나무
감로	k a̠ m n o̞	감노
감명되다	k a̠ː m m j ʌ̹ ŋ d w e̞ d a̠	감명되다
감명하다	k a̠ː m m j ʌ̹ ŋ ɦ a̠ d a̠	감명하다
감비아	k a̠ m b i a̠	감비아
감사	k a̠ m sʰ a̠	감사
감송	k a̠ m sʰ o̞ ŋ	감송
감쇠기	k a̠ː m sʰ w e̞ ɡ i	감쇠기
감수	k a̠ m sʰ u	감수
감숙	k a̠ m sʰ u k̚	감숙
감싸다	k a̠ː m s͈ a̠ d a̠	감싸다
감염증	k a̠ː m j ʌ̹ m t͡ɕ͈ ɯ ŋ	가몀쯩
감응	k a̠ m ɯ ŋ	가믕
감자	k a̠ m d͡ʑ a̠	감자
감정아이	k a̠ m d͡ʑ ʌ̹ ŋ a̠ i	감정아이
감지	k a̠ː m d͡ʑ i	감지
감지하다	k a̠ː m d͡ʑ i ɦ a̠ d a̠	감지하다
감추다	k a̠ m t͡ɕʰ u d a̠	감추다
감탄사	k a̠ː m tʰ a̠ n sʰ a̠	감탄사
감탄하다	k a̠ː m tʰ a̠ n ɦ a̠ d a̠	감탄하다
감투	k a̠ m tʰ u	감투
감파르다	k a̠ː m pʰ a̠ ɾ ɯ d a̠	감파르다
갑	k a̠ p̚	갑
갑각	k a̠ p̚ k͈ a̠ k̚	갑깍
갑각류	k a̠ p̚ k͈ a̠ ŋ ɲ u	갑깡누
갑작스럽다	k a̠ p̚ t͡ɕ͈ a̠ k s͈ ɯ ɾ ʌ̹ p̚ t͈ a̠	갑짝쓰럽따
값	k a̠ p̚	갑
갓	k a̠ t̚	갇
갓난아기	k a̠ n n a̠ n a̠ ɡ i	간나나기
갓난아이	k a̠ n n a̠ n a̠ i	간나나이
강	k a̠ ŋ	강
강계	k a̠ ŋ ɡ j e̞	강계
강구다	k a̠ ŋ ɡ u d a̠	강구다
강권	k a̠ ŋ k͈ w ʌ̹ n	강꿘
강권하다	k a̠ː ŋ ɡ w ʌ̹ n ɦ a̠ d a̠	강권하다
강남	k a̠ ŋ n a̠ m	강남
강남천자국	k a̠ ŋ n a̠ m t͡ɕʰ ʌ̹ ɲ d͡ʑ a̠ ɡ u k̚	강남천자국
강녕	k a̠ ŋ ɲ ʌ̹ ŋ	강넝
강단	k a̠ ŋ d a̠ n	강단
강도다리	k a̠ ŋ d o̞ d a̠ ɾ i	강도다리
강소	k a̠ ŋ sʰ o̞	강소
강속구	k a̠ ŋ sʰ o̞ k̚ k͈ u	강속꾸
강신무	k a̠ː ŋ ɕʰ i n m u	강신무
강압	k a̠ː ŋ a̠ p̚	강압
강어귀	k a̠ ŋ ʌ̹ ɡ ɥ i	강어귀
강점	k a̠ ŋ t͡ɕ͈ ʌ̹ m	강쩜
강점되다	k a̠ː ŋ d͡ʑ ʌ̹ m d w e̞ d a̠	강점되다
강점하다	k a̠ː ŋ d͡ʑ ʌ̹ m ɦ a̠ d a̠	강점하다
강조	k a̠ ŋ d͡ʑ o̞	강조
강탈	k a̠ː ŋ tʰ a̠ ɭ	강탈
강탈되다	k a̠ː ŋ tʰ a̠ ɭ d w e̞ d a̠	강탈되다
강탈하다	k a̠ː ŋ tʰ a̠ ɾ ɦ a̠ d a̠	강탈하다
강퇴	k a̠ː ŋ tʰ w e̞	강퇴
강퍅	k a̠ ŋ pʰ j a̠ k̚	강퍅
강퍅하다	k a̠ ŋ pʰ j a̠ kʰ a̠ d a̠	강퍄카다
강풍	k a̠ ŋ pʰ u ŋ	강풍
강화	k a̠ ŋ β w a̠	강화
강화하다	k a̠ ŋ β w a̠ ɦ a̠ d a̠	강화하다
강활	k a̠ ŋ β w a̠ ɭ	강활
강희자전	k a̠ ŋ ʝ i d͡ʑ a̠ d͡ʑ ʌ̹ n	강히자전
갖	k a̠ t̚	갇
개	k ɛː	개
개가하다	k ɛː ɡ a̠ ɦ a̠ d a̠	개가하다
개같다	k ɛː ɡ a̠ t̚ t͈ a̠	개갇따
개기장	k ɛː ɡ i d͡ʑ a̠ ŋ	개기장
개꿈	k ɛː k͈ u m	개꿈
개꿩	k ɛː k͈ w ʌ̹ ŋ	개꿩
개독교	k ɛː d o̞ k̚ k͈ j o	개독꾜
개량하다	k ɛː ɾ j a̠ ŋ ɦ a̠ d a̠	개량하다
개마고원	k ɛː m a̠ ɡ o̞ w ʌ̹ n	개마고원
개명	k ɛː m j ʌ̹ ŋ	개명
개명되다	k ɛː m j ʌ̹ ŋ d w e̞ d a̠	개명되다
개명하다	k ɛː m j ʌ̹ ŋ ɦ a̠ d a̠	개명하다
개밥바라기	k ɛː b a̠ p̚ p͈ a̠ ɾ a̠ ɡ i	개밥빠라기
개별자	k ɛː b j ʌ̹ ʎ t͡ɕ͈ a̠	개별짜
개사	k ɛː sʰ a̠	개사
개사곡	k ɛː sʰ a̠ ɡ o̞ k̚	개사곡
개사되다	k ɛː sʰ a̠ d w e̞ d a̠	개사되다
개사하다	k ɛː sʰ a̠ ɦ a̠ d a̠	개사하다
개살구	k ɛː sʰ a̠ ɭ ɡ u	개살구
개선되다	k ɛː sʰ ʌ̹ n d w e̞ d a̠	개선되다
개선문	k ɛː sʰ ʌ̹ n m u n	개선문
개선하다	k ɛː sʰ ʌ̹ n ɦ a̠ d a̠	개선하다
개소주	k ɛː sʰ o̞ d͡ʑ u	개소주
개역	k ɛː j ʌ̹ k̚	개역
개인주의	k ɛː i ɲ d͡ʑ u ɰ i	개인주의
개자식	k ɛː d͡ʑ a̠ ɕʰ i k̚	개자식
개장국	k ɛː d͡ʑ a̠ ŋ k͈ u k̚	개장꾹
개조	k ɛː d͡ʑ o̞	개조
개조되다	k ɛː d͡ʑ o̞ d w e̞ d a̠	개조되다
개조하다	k ɛː d͡ʑ o̞ ɦ a̠ d a̠	개조하다
개지랄	k ɛː d͡ʑ i ɾ a̠ ɭ	개지랄
개지랄하다	k ɛː d͡ʑ i ɾ a̠ ɾ ɦ a̠ d a̠	개지랄하다
개집	k ɛː d͡ʑ i p̚	개집
개혁되다	k ɛː ʝ ʌ̹ k̚ t͈ w e̞ d a̠	개헉뙤다
개혁하다	k ɛː ʝ ʌ̹ kʰ a̠ d a̠	개허카다
갯과	k ɛː t̚ k͈ w a̠	갣꽈
갱지	k ɛː ŋ d͡ʑ i	갱지
갸울다	k j a̠ u ɭ d a̠	갸울다
갹	k j a̠ k̚	갹
갹출하다	k j a̠ k̚ t͡ɕʰ u ɾ ɦ a̠ d a̠	갹출하다
거	k ʌ̹	거
거느리다	k ʌ̹ n ɯ ɾ i d a̠	거느리다
거두다	k ʌ̹ d u d a̠	거두다
거듭씨	k ʌ̹ d ɯ p ɕ͈ i	거듭씨
거듭홀소리	k ʌ̹ d ɯ pʰ o̞ ɭ sʰ o̞ ɾ i	거드폴소리
거류	k ʌ̹ ɾ j u	거류
거르다	k ʌ̹ ɾ ɯ d a̠	거르다
거리	k ʌ̹ ɾ i	거리
거릿모티이	k ʌ̹ ɾ i n m o̞ tʰ i i	거린모티이
거무스름하다	k ʌ̹ m u sʰ ɯ ɾ ɯ m ɦ a̠ d a̠	거무스름하다
거서간	k ʌ̹ sʰ ʌ̹ ɡ a̠ n	거서간
거스르다	k ʌ̹ sʰ ɯ ɾ ɯ d a̠	거스르다
거웃	k ʌ̹ u t̚	거욷
거이	k ʌ̹ i	거이
거주자	k ʌ̹ d͡ʑ u d͡ʑ a̠	거주자
거품기	k ʌ̹ pʰ u m ɡ i	거품기
걱정되다	k ʌ̹ k̚ t͡ɕ͈ ʌ̹ ŋ d w e̞ d a̠	걱쩡되다
걱정스럽다	k ʌ̹ k̚ t͡ɕ͈ ʌ̹ ŋ sʰ ɯ ɾ ʌ̹ p̚ t͈ a̠	걱쩡스럽따
건늠길	k ʌ̹ n n ɯ m ɡ i ɭ	건늠길
건발기	k ʌ̹ n b a̠ ɭ ɡ i	건발기
건초	k ʌ̹ ɲ t͡ɕʰ o̞	건초
걷다	k ʌ̹ t̚ t͈ a̠	걷따
걸	k ʌ̹ ɭ	걸
걸그룹	k ʌ̹ ɭ ɡ ɯ ɾ u p̚	걸그룹
걸림갈음이름씨	k ʌ̹ ʎ ʎ i m ɡ a̠ ɾ ɯ m i ɾ ɯ m ɕ͈ i	걸림가르미름씨
걸림씨	k ʌ̹ ʎ ʎ i m ɕ͈ i	걸림씨
걸어오다	k ʌ̹ ɾ ʌ̹ o̞ d a̠	거러오다
걸쭉하다	k ʌ̹ ʎ t͡ɕ͈ u kʰ a̠ d a̠	걸쭈카다
걸핏걸핏	k ʌ̹ ɭ pʰ i t̚ k͈ ʌ̹ ɭ pʰ i t̚	걸핃껄핃
검스	k ʌ̹ m sʰ ɯ	검스
검양옻나무	k ʌ̹ m j a̠ ŋ o̞ n n a̠ m u	거먕온나무
검열하다	k ʌ̹ m j ʌ̹ ɾ ɦ a̠ d a̠	거멸하다
검은	k ʌ̹ m ɯ n	거믄
검은목논병아리	k ʌ̹ m ɯ n m o̞ ŋ n o̞ n b j ʌ̹ ŋ a̠ ɾ i	거믄몽논병아리
검은목두루미	k ʌ̹ m ɯ n m o̞ k̚ t͈ u ɾ u m i	거믄목뚜루미
검은무리	k ʌ̹ m ɯ n m u ɾ i	거믄무리
검은지빠귀	k ʌ̹ m ɯ ɲ d͡ʑ i p͈ a̠ ɡ ɥ i	거믄지빠귀
겁	k ʌ̹ p̚	겁
겁나다	k ʌ̹ m n a̠ d a̠	검나다
겁먹다	k ʌ̹ m m ʌ̹ k̚ t͈ a̠	검먹따
겁박	k ʌ̹ p̚ p͈ a̠ k̚	겁빡
겁박하다	k ʌ̹ p̚ p͈ a̠ kʰ a̠ d a̠	겁빠카다
것	k ʌ̹ t̚	걷
겉	k ʌ̹ t̚	걷
겉옷	k ʌ̹ tʰ o̞ t̚	거톧
겉장	k ʌ̹ t̚ t͡ɕ͈ a̠ ŋ	걷짱
게	k e̞	게
게니자	k e̞ n i d͡ʑ a̠	게니자
게사니	k e̞ sʰ a̠ n i	게사니
게시되다	k e̞ː ɕʰ i d w e̞ d a̠	게시되다
게양되다	k e̞ː j a̠ ŋ d w e̞ d a̠	게양되다
게양하다	k e̞ː j a̠ ŋ ɦ a̠ d a̠	게양하다
게우다	k e̞ u d a̠	게우다
게이기	k e̞ i ɡ i	게이기
게이다	k e̞ i d a̠	게이다
게임성	k͈ e̞ i m sʰ ʌ̹ ŋ	께임성
게타	k͈ e̞ tʰ a̠	께타
게톱치	k e̞ tʰ o̞ p̚ t͡ɕʰ i	게톱치
겜	k͈ e̞ m	껨
겨	k j ʌ̹	겨
겨란	k j ʌ̹ ɾ a̠ n	겨란
겨르	k j ʌ̹ ɾ ɯ	겨르
겨리	k j ʌ̹ ɾ i	겨리
겨우살이	k j ʌ̹ u sʰ a̠ ɾ i	겨우사리
겨울잠쥐	k j ʌ̹ u ʎ d͡ʑ a̠ m d͡ʑ ɥ i	겨울잠쥐
겨이삭	k j ʌ̹ i sʰ a̠ k̚	겨이삭
겨풀	k j ʌ̹ pʰ u ɭ	겨풀
격	k j ʌ̹ k̚	격
격려되다	k j ʌ̹ ŋ ɲ ʌ̹ d w e̞ d a̠	경너되다
격려하다	k j ʌ̹ ŋ ɲ ʌ̹ ɦ a̠ d a̠	경너하다
격전	k j ʌ̹ k̚ t͡ɕ͈ ʌ̹ n	격쩐
격찬하다	k j ʌ̹ k̚ t͡ɕʰ a̠ n ɦ a̠ d a̠	격찬하다
격파하다	k j ʌ̹ k̚ pʰ a̠ ɦ a̠ d a̠	격파하다
격화하다	k j ʌ̹ kʰ w a̠ ɦ a̠ d a̠	겨콰하다
견	k j ʌ̹ n	견
견과	k j ʌ̹ n ɡ w a̠	견과
견성	k j ʌ̹ n sʰ ʌ̹ ŋ	견성
견실	k j ʌ̹ n ɕʰ i ɭ	견실
결	k j ʌ̹ ɭ	결
결단	k j ʌ̹ ɭ t͈ a̠ n	결딴
결단코	k j ʌ̹ ɭ t͈ a̠ n kʰ o̞	결딴코
결렬	k j ʌ̹ ʎ ʎ ʌ̹ ɭ	결럴
결사옹위	k j ʌ̹ ɭ s͈ a̠ o̞ ŋ ɥ i	결싸옹위
결석하다	k j ʌ̹ ɭ s͈ ʌ̹ kʰ a̠ d a̠	결써카다
결속	k j ʌ̹ ɭ s͈ o̞ k̚	결쏙
결심하다	k j ʌ̹ ɭ ɕ͈ i m ɦ a̠ d a̠	결씸하다
결점	k j ʌ̹ ʎ t͡ɕ͈ ʌ̹ m	결쩜
결정수	k j ʌ̹ ʎ t͡ɕ͈ ʌ̹ ŋ sʰ u	결쩡수
결핍하다	k j ʌ̹ ɭ pʰ i pʰ a̠ d a̠	결피파다
결합하다	k j ʌ̹ ɾ ɦ a̠ pʰ a̠ d a̠	결하파다
결혼하다	k j ʌ̹ ɾ β o̞ n ɦ a̠ d a̠	결혼하다
겸	k j ʌ̹ m	겸
겸하다	k j ʌ̹ m ɦ a̠ d a̠	겸하다
겸허하다	k j ʌ̹ m ɦ ʌ̹ ɦ a̠ d a̠	겸허하다
겹	k j ʌ̹ p̚	겹
겹놓다	k j ʌ̹ m n o̞ tʰ a̠	겸노타
겹빵이	k j ʌ̹ p̚ p͈ a̠ ŋ i	겹빵이
겹치다	k j ʌ̹ p̚ t͡ɕʰ i d a̠	겹치다
경공업	k j ʌ̹ ŋ ɡ o̞ ŋ ʌ̹ p̚	경공업
경기	k j ʌ̹ ŋ ɡ i	경기
경기충청도방언	k j ʌ̹ ŋ ɡ i t͡ɕʰ u ŋ t͡ɕʰ ʌ̹ ŋ d o̞ b a̠ ŋ ʌ̹ n	경기충청도방언
경량	k j ʌ̹ ŋ ɲ a̠ ŋ	경낭
경멸	k j ʌ̹ ŋ m j ʌ̹ ɭ	경멸
경멸감	k j ʌ̹ ŋ m j ʌ̹ ɭ ɡ a̠ m	경멸감
경사	k j ʌ̹ ŋ sʰ a̠	경사
경악하다	k j ʌ̹ ŋ a̠ kʰ a̠ d a̠	경아카다
경옥	k j ʌ̹ ŋ o̞ k̚	경옥
경음기	k j ʌ̹ ŋ ɯ m ɡ i	경음기
경입자	k j ʌ̹ ŋ i p̚ t͡ɕ͈ a̠	경입짜
경작	k j ʌ̹ ŋ d͡ʑ a̠ k̚	경작
경장근	k j ʌ̹ ŋ d͡ʑ a̠ ŋ ɡ ɯ n	경장근
경적	k j ʌ̹ ŋ d͡ʑ ʌ̹ k̚	경적
경죄	k j ʌ̹ ŋ d͡ʑ w e̞	경죄
경청자	k j ʌ̹ ŋ t͡ɕʰ ʌ̹ ŋ d͡ʑ a̠	경청자
경청하다	k j ʌ̹ ŋ t͡ɕʰ ʌ̹ ŋ ɦ a̠ d a̠	경청하다
경험되다	k j ʌ̹ ŋ ɦ ʌ̹ m d w e̞ d a̠	경험되다
경험론	k j ʌ̹ ŋ ɦ ʌ̹ m n o̞ n	경험논
경험치	k j ʌ̹ ŋ ɦ ʌ̹ m t͡ɕʰ i	경험치
곁	k j ʌ̹ t̚	겯
곁들이다	k j ʌ̹ t̚ t͈ ɯ ɾ i d a̠	겯뜨리다
계	k j e̞	계
계기판	k j e̞ː ɡ i pʰ a̠ n	계기판
계략	k j e̞ː ɾ j a̠ k̚	계략
계림	k j e̞ ɾ i m	계림
계명	k j e̞ m j ʌ̹ ŋ	계명
계부	k j e̞ː b u	계부
계사	k j e̞ː sʰ a̠	계사
계산하다	k j e̞ː sʰ a̠ n ɦ a̠ d a̠	계산하다
계약서	k j e̞ː j a̠ k s͈ ʌ̹	계약써
계약하다	k j e̞ː j a̠ kʰ a̠ d a̠	계야카다
계엄	k j e̞ː ʌ̹ m	계엄
계엄령	k j e̞ː ʌ̹ m ɲ ʌ̹ ŋ	계엄넝
계집	k j e̞ː d͡ʑ i p̚	계집
계집년	k j e̞ː d͡ʑ i m ɲ ʌ̹ n	계짐넌
계집아이	k j e̞ː d͡ʑ i b a̠ i	계지바이
계집종	k j e̞ː d͡ʑ i p̚ t͡ɕ͈ o̞ ŋ	계집쫑
계집질	k j e̞ː d͡ʑ i p̚ t͡ɕ͈ i ɭ	계집찔
계획되다	k j e̞ː β w e̞ k̚ t͈ w e̞ d a̠	계획뙤다
고	k o̞	고
고가	k o̞ k͈ a̠	고까
고갈	k o̞ ɡ a̠ ɭ	고갈
고금	k o̞ː ɡ ɯ m	고금
고금동서	k o̞ː ɡ ɯ m d o̞ ŋ sʰ ʌ̹	고금동서
고기	k o̞ ɡ i	고기
고기숨구멍	k o̞ ɡ i sʰ u m ɡ u m ʌ̹ ŋ	고기숨구멍
고기후학	k o̞ː ɡ i β u ɦ a̠ k̚	고기후학
고나리	k o̞ n a̠ ɾ i	고나리
고나리질	k o̞ n a̠ ɾ i d͡ʑ i ɭ	고나리질
고단수	k o̞ d a̠ n sʰ u	고단수
고독사	k o̞ d o̞ k s͈ a̠	고독싸
고동	k o̞ d o̞ ŋ	고동
고동물학	k o̞ː d o̞ ŋ m u ɾ ɦ a̠ k̚	고동물학
고되다	k o̞ d w e̞ d a̠	고되다
고두	k o̞ d u	고두
고두하다	k o̞ d u ɦ a̠ d a̠	고두하다
고둥	k o̞ d u ŋ	고둥
고드름	k o̞ d ɯ ɾ ɯ m	고드름
고딕체	k o̞ d i k̚ t͡ɕʰ e̞	고딕체
고레말	k o̞ ɾ e̞ m a̠ ɭ	고레말
고로케	k o̞ ɾ o̞ kʰ e̞	고로케
고르고	k o̞ ɾ ɯ ɡ o̞	고르고
고리도롱뇽	k o̞ ɾ i d o̞ ɾ o̞ ŋ ɲ o ŋ	고리도롱뇽
고리무늬물범	k o̞ ɾ i m u n i m u ɭ b ʌ̹ m	고리무니물범
고리짝	k o̞ ɾ i t͡ɕ͈ a̠ k̚	고리짝
고립지	k o̞ ɾ i p̚ t͡ɕ͈ i	고립찌
고막	k o̞ m a̠ k̚	고막
고명	k o̞ m j ʌ̹ ŋ	고명
고명하다	k o̞ m j ʌ̹ ŋ ɦ a̠ d a̠	고명하다
고무락고무락	k o̞ m u ɾ a̠ k̚ k͈ o̞ m u ɾ a̠ k̚	고무락꼬무락
고문관	k o̞ m u n ɡ w a̠ n	고문관
고문하다	k o̞ m u n ɦ a̠ d a̠	고문하다
고물	k o̞ m u ɭ	고물
고물고물	k o̞ m u ɭ ɡ o̞ m u ɭ	고물고물
고발하다	k o̞ː b a̠ ɾ ɦ a̠ d a̠	고발하다
고방	k o̞ b a̠ ŋ	고방
고별	k o̞ b j ʌ̹ ɭ	고별
고뿌	k o̞ p͈ u	고뿌
고뿔	k o̞ p͈ u ɭ	고뿔
고사	k o̞ sʰ a̠	고사
고소인	k o̞ː sʰ o̞ i n	고소인
고소하다	k o̞ sʰ o̞ ɦ a̠ d a̠	고소하다
고열	k o̞ j ʌ̹ ɭ	고열
고용하다	k o̞ j o ŋ ɦ a̠ d a̠	고용하다
고위	k o̞ ɥ i	고위
고유명사	k o̞ j u m j ʌ̹ ŋ sʰ a̠	고유명사
고의	k o̞ː ɰ i	고의
고의사구	k o̞ː ɰ i sʰ a̠ː ɡ u	고의사구
고이다	k o̞ i d a̠	고이다
고인돌	k o̞ i n d o̞ ɭ	고인돌
고인류학	k o̞ː i ʎ ʎ u ɦ a̠ k̚	고일루학
고장	k o̞ d͡ʑ a̠ ŋ	고장
고조되다	k o̞ d͡ʑ o̞ d w e̞ d a̠	고조되다
고지혈증	k o̞ d͡ʑ i ʝ ʌ̹ ʎ d͡ʑ ɯ ŋ	고지헐증
고집불통	k o̞ d͡ʑ i p̚ p͈ u ɭ tʰ o̞ ŋ	고집뿔통
고체온	k o̞ t͡ɕʰ e̞ o̞ n	고체온
고추나물	k o̞ t͡ɕʰ u n a̠ m u ɭ	고추나물
고추자지	k o̞ t͡ɕʰ u d͡ʑ a̠ d͡ʑ i	고추자지
고치	k o̞ t͡ɕʰ i	고치
고치다	k o̞ t͡ɕʰ i d a̠	고치다
고하다	k o̞ː ɦ a̠ d a̠	고하다
곡	k o̞ k̚	곡
곡선	k o̞ k s͈ ʌ̹ n	곡썬
곡셱	k o̞ k ɕ͈ e̞ k̚	곡쎅
곡용	k o̞ ɡ j o ŋ	고굥
곡창	k o̞ k̚ t͡ɕʰ a̠ ŋ	곡창
곤경	k o̞ː n ɡ j ʌ̹ ŋ	곤경
곤난	k o̞ n n a̠ n	곤난
곤뇽	k o̞ n ɲ o ŋ	곤뇽
곤운	k o̞ n u n	고눈
골	k o̞ ɭ	골
골골	k o̞ ɭ ɡ o̞ ɭ	골골
골다	k o̞ː ɭ d a̠	골다
골짜구니	k o̞ ʎ t͡ɕ͈ a̠ ɡ u n i	골짜구니
골초	k o̞ ʎ t͡ɕʰ o̞	골초
골치	k o̞ ʎ t͡ɕʰ i	골치
골칫거리	k o̞ ʎ t͡ɕʰ i t̚ k͈ ʌ̹ ɾ i	골칟꺼리
골탄	k o̞ ɭ tʰ a̠ n	골탄
곬	k o̞ ɭ	골
곰	k o̞ː m	곰
곰소	k o̞ m sʰ o̞	곰소
곰솔	k o̞ m sʰ o̞ ɭ	곰솔
곰작	k o̞ m d͡ʑ a̠ k̚	곰작
곰작곰작	k o̞ m d͡ʑ a̠ k̚ k͈ o̞ m d͡ʑ a̠ k̚	곰작꼼작
곰지락	k o̞ m d͡ʑ i ɾ a̠ k̚	곰지락
곰지락곰지락	k o̞ m d͡ʑ i ɾ a̠ k̚ k͈ o̞ m d͡ʑ i ɾ a̠ k̚	곰지락꼼지락
곰탕	k o̞ m tʰ a̠ ŋ	곰탕
곰틀곰틀	k o̞ m tʰ ɯ ɭ ɡ o̞ m tʰ ɯ ɭ	곰틀곰틀
곱	k o̞ p̚	곱
곱다	k o̞ p̚ t͈ a̠	곱따
곱다랗다	k o̞ː p̚ t͈ a̠ ɾ a̠ tʰ a̠	곱따라타
곱사	k o̞ p s͈ a̠	곱싸
곱이곱이	k o̞ b i ɡ o̞ b i	고비고비
곱창	k o̞ p̚ t͡ɕʰ a̠ ŋ	곱창
곱하다	k o̞ pʰ a̠ d a̠	고파다
곳	k o̞ t̚	곧
공	k o̞ ŋ	공
공갈치다	k o̞ː ŋ ɡ a̠ ʎ t͡ɕʰ i d a̠	공갈치다
공갈하다	k o̞ː ŋ ɡ a̠ ɾ ɦ a̠ d a̠	공갈하다
공강	k o̞ ŋ ɡ a̠ ŋ	공강
공격전	k o̞ː ŋ ɡ j ʌ̹ k̚ t͡ɕ͈ ʌ̹ n	공격쩐
공격하다	k o̞ː ŋ ɡ j ʌ̹ kʰ a̠ d a̠	공겨카다
공교	k o̞ ŋ ɡ j o	공교
공교롭다	k o̞ ŋ ɡ j o ɾ o̞ p̚ t͈ a̠	공교롭따
공국	k o̞ː ŋ ɡ u k̚	공국
공급되다	k o̞ː ŋ ɡ ɯ p̚ t͈ w e̞ d a̠	공급뙤다
공급자	k o̞ː ŋ ɡ ɯ p̚ t͡ɕ͈ a̠	공급짜
공급하다	k o̞ː ŋ ɡ ɯ pʰ a̠ d a̠	공그파다
공기	k o̞ ŋ ɡ i	공기
공기방석	k o̞ ŋ ɡ i b a̠ ŋ sʰ ʌ̹ k̚	공기방석
공기방석자동차	k o̞ ŋ ɡ i b a̠ ŋ sʰ ʌ̹ k̚ t͡ɕ͈ a̠ d o̞ ŋ t͡ɕʰ a̠	공기방석짜동차
공략	k o̞ ŋ ɲ a̠ k̚	공낙
공리	k o̞ ŋ n i	공니
공립	k o̞ ŋ n i p̚	공닙
공무	k o̞ ŋ m u	공무
공문서	k o̞ ŋ m u n sʰ ʌ̹	공문서
공법	k o̞ ŋ p͈ ʌ̹ p̚	공뻡
공변	k o̞ ŋ b j ʌ̹ n	공변
공변되다	k o̞ ŋ b j ʌ̹ n d w e̞ d a̠	공변되다
공보	k o̞ ŋ b o̞	공보
공부벌레	k o̞ ŋ b u b ʌ̹ ɭ ɭ e̞	공부벌레
공부자	k o̞ː ŋ b u d͡ʑ a̠	공부자
공분	k o̞ ŋ b u n	공분
공사하다	k o̞ ŋ sʰ a̠ ɦ a̠ d a̠	공사하다
공상	k o̞ ŋ sʰ a̠ ŋ	공상
공손	k o̞ ŋ sʰ o̞ n	공손
공습	k o̞ ŋ sʰ ɯ p̚	공습
공습하다	k o̞ ŋ sʰ ɯ pʰ a̠ d a̠	공스파다
공식적	k o̞ ŋ ɕʰ i k̚ t͡ɕ͈ ʌ̹ k̚	공식쩍
공알	k o̞ː ŋ a̠ ɭ	공알
공영	k o̞ ŋ j ʌ̹ ŋ	공영
공유	k o̞ ŋ j u	공유
공유하다	k o̞ː ŋ j u ɦ a̠ d a̠	공유하다
공자	k o̞ ŋ d͡ʑ a̠	공자
공작나비	k o̞ ŋ d͡ʑ a̠ ŋ n a̠ b i	공장나비
공작원	k o̞ ŋ d͡ʑ a̠ ɡ w ʌ̹ n	공자권
공정가	k o̞ ŋ d͡ʑ ʌ̹ ŋ k͈ a̠	공정까
공주병	k o̞ ŋ d͡ʑ u p͈ j ʌ̹ ŋ	공주뼝
공중제비	k o̞ ŋ d͡ʑ u ŋ d͡ʑ e̞ b i	공중제비
공증인	k o̞ ŋ d͡ʑ ɯ ŋ i n	공증인
공지하다	k o̞ ŋ d͡ʑ i ɦ a̠ d a̠	공지하다
공직	k o̞ ŋ d͡ʑ i k̚	공직
공차	k o̞ ŋ t͡ɕʰ a̠	공차
공천	k o̞ ŋ t͡ɕʰ ʌ̹ n	공천
공칠과삼	k o̞ ŋ t͡ɕʰ i ɭ ɡ w a̠ sʰ a̠ m	공칠과삼
공판	k o̞ ŋ pʰ a̠ n	공판
공평	k o̞ ŋ pʰ j ʌ̹ ŋ	공평
공표	k o̞ ŋ pʰ j o	공표
공표하다	k o̞ ŋ pʰ j o ɦ a̠ d a̠	공표하다
공헌	k o̞ː ŋ ɦ ʌ̹ n	공헌
공훈	k o̞ ŋ β u n	공훈
공휴	k o̞ ŋ ʝ u	공후
공휴일	k o̞ ŋ ʝ u i ɭ	공후일
곶	k o̞ t̚	곧
곶감	k o̞ t̚ k͈ a̠ m	곧깜
과	k w a̠	과
과거	k w a̠ ɡ ʌ̹	과거
과거시제	k w a̠ː ɡ ʌ̹ ɕʰ i d͡ʑ e̞	과거시제
과거하다	k w a̠ ɡ ʌ̹ ɦ a̠ d a̠	과거하다
과금되다	k w a̠ ɡ ɯ m d w e̞ d a̠	과금되다
과금하다	k w a̠ ɡ ɯ m ɦ a̠ d a̠	과금하다
과다	k w a̠ː d a̠	과다
과다하다	k w a̠ː d a̠ ɦ a̠ d a̠	과다하다
과도기	k w a̠ː d o̞ ɡ i	과도기
과두제	k w a̠ː d u d͡ʑ e̞	과두제
과소평가	k w a̠ː sʰ o̞ pʰ j ʌ̹ ŋ ɡ a̠	과소평가
과시하다	k w a̠ː ɕʰ i ɦ a̠ d a̠	과시하다
과식하다	k w a̠ː ɕʰ i kʰ a̠ d a̠	과시카다
과장되다	k w a̠ː d͡ʑ a̠ ŋ d w e̞ d a̠	과장되다
과장하다	k w a̠ː d͡ʑ a̠ ŋ ɦ a̠ d a̠	과장하다
과즙	k w a̠ː d͡ʑ ɯ p̚	과즙
과학기술	k w a̠ ɦ a̠ k̚ k i sʰ u ɭ	과학기술
관건	k w a̠ n k͈ ʌ̹ n	관껀
관광하다	k w a̠ n ɡ w a̠ ŋ ɦ a̠ d a̠	관광하다
관군	k w a̠ n ɡ u n	관군
관능미	k w a̠ n n ɯ ŋ m i	관능미
관람자	k w a̠ ɭ ɭ a̠ m d͡ʑ a̠	괄람자
관련되다	k w a̠ ʎ ʎ ʌ̹ n d w e̞ d a̠	괄런되다
관련하다	k w a̠ ʎ ʎ ʌ̹ n ɦ a̠ d a̠	괄런하다
관로	k w a̠ ɭ ɭ o̞	괄로
관료제	k w a̠ ʎ ʎ o d͡ʑ e̞	괄료제
관방학	k w a̠ n b a̠ ŋ ɦ a̠ k̚	관방학
관수리	k w a̠ n sʰ u ɾ i	관수리
관심종자	k w a̠ n ɕʰ i m t͡ɕ o̞ ŋ d͡ʑ a̠	관심종자
관장	k w a̠ ɲ d͡ʑ a̠ ŋ	관장
관종	k w a̠ ɲ d͡ʑ o̞ ŋ	관종
관중	k w a̠ ɲ d͡ʑ u ŋ	관중
관청	k w a̠ ɲ t͡ɕʰ ʌ̹ ŋ	관청
관하다	k w a̠ n ɦ a̠ d a̠	관하다
관화	k w a̠ n β w a̠	관화
괄시	k w a̠ ɭ ɕ͈ i	괄씨
괌	k w a̠ m	괌
괌도	k w a̠ m d o̞	괌도
광	k w a̠ ŋ	광
광구	k w a̠ ŋ ɡ u	광구
광기	k w a̠ ŋ k͈ i	광끼
광둥어	k w a̠ ŋ d u ŋ ʌ̹	광둥어
광란	k w a̠ ŋ n a̠ n	광난
광물학	k w a̠ː ŋ m u ɾ ɦ a̠ k̚	광물학
광복절	k w a̠ ŋ b o̞ k̚ t͡ɕ͈ ʌ̹ ɭ	광복쩔
광서	k w a̠ː ŋ sʰ ʌ̹	광서
광신도	k w a̠ ŋ ɕʰ i n d o̞	광신도
광신자	k w a̠ ŋ ɕʰ i ɲ d͡ʑ a̠	광신자
광야	k w a̠ː ŋ j a̠	광야
광음사전	k w a̠ ŋ ɯ m sʰ a̠ d͡ʑ ʌ̹ n	광음사전
광인	k w a̠ ŋ i n	광인
광자	k w a̠ ŋ d͡ʑ a̠	광자
광자학	k w a̠ ŋ d͡ʑ a̠ ɦ a̠ k̚	광자학
광주	k w a̠ ŋ d͡ʑ u	광주
광호흡	k w a̠ ŋ β o̞ ɣ ɯ p̚	광호흡
광화학	k w a̠ ŋ β w a̠ ɦ a̠ k̚	광화학
괘	k w ɛː	괘
괭이	k w ɛː ŋ i	괭이
괴	k w e̞ː	괴
괴롭히다	k w e̞ ɾ o̞ pʰ i d a̠	괴로피다
괴이히	k w e̞ i ʝ i	괴이히
괴혈병	k w e̞ː ʝ ʌ̹ ɭ p͈ j ʌ̹ ŋ	괴헐뼝
굉장하다	k w e̞ ŋ d͡ʑ a̠ ŋ ɦ a̠ d a̠	굉장하다
교	k j oː	교
교교	k j oː ɡ j o	교교
교교하다	k j oː ɡ j o ɦ a̠ d a̠	교교하다
교또	k j o t͈ o̞	교또
교란되다	k j o ɾ a̠ n d w e̞ d a̠	교란되다
교란하다	k j o ɾ a̠ n ɦ a̠ d a̠	교란하다
교류하다	k j o ɾ j u ɦ a̠ d a̠	교류하다
교만	k j o m a̠ n	교만
교묘	k j o m j o	교묘
교미하다	k j o m i ɦ a̠ d a̠	교미하다
교반	k j o b a̠ n	교반
교사	k j o sʰ a̠	교사
교사하다	k j o sʰ a̠ ɦ a̠ d a̠	교사하다
교언	k j o ʌ̹ n	교언
교육되다	k j oː j u k̚ t͈ w e̞ d a̠	교육뙤다
교육하다	k j oː j u kʰ a̠ d a̠	교유카다
교의	k j o ɰ i	교의
교차위	k j o t͡ɕʰ a̠ ɥ i	교차위
교착	k j o t͡ɕʰ a̠ k̚	교착
교파	k j oː pʰ a̠	교파
교편	k j oː pʰ j ʌ̹ n	교편
교화	k j oː β w a̠	교화
교화소	k j oː β w a̠ sʰ o̞	교화소
교환되다	k j o β w a̠ n d w e̞ d a̠	교환되다
교환하다	k j o β w a̠ n ɦ a̠ d a̠	교환하다
교훈	k j oː β u n	교훈
구	k u	구
구걸하다	k u ɡ ʌ̹ ɾ ɦ a̠ d a̠	구걸하다
구결	k uː ɡ j ʌ̹ ɭ	구결
구경군	k uː ɡ j ʌ̹ ŋ ɡ u n	구경군
구균	k u ɡ j u n	구균
구기다	k u ɡ i d a̠	구기다
구기자나무	k u ɡ i d͡ʑ a̠ n a̠ m u	구기자나무
구기차	k u ɡ i t͡ɕʰ a̠	구기차
구나	k u n a̠	구나
구니	k u n i	구니
구니되다	k u n i d w e̞ d a̠	구니되다
구니하다	k u n i ɦ a̠ d a̠	구니하다
구독	k u d o̞ k̚	구독
구독료	k u d o̞ ŋ ɲ o	구동뇨
구독자	k u d o̞ k̚ t͡ɕ͈ a̠	구독짜
구독하다	k u d o̞ kʰ a̠ d a̠	구도카다
구두	k u d u	구두
구두점	k u d u t͡ɕ͈ ʌ̹ m	구두쩜
구들	k u d ɯ ɭ	구들
구라	k u ɾ a̠	구라
구로나	k u ɾ o̞ n a̠	구로나
구류되다	k u ɾ j u d w e̞ d a̠	구류되다
구류하다	k u ɾ j u ɦ a̠ d a̠	구류하다
구르다	k u ɾ ɯ d a̠	구르다
구리다	k u ɾ i d a̠	구리다
구마모또	k u m a̠ m o̞ t͈ o̞	구마모또
구멍가게	k u m ʌ̹ ŋ ɡ a̠ ɡ e̞	구멍가게
구무럭구무럭	k u m u ɾ ʌ̹ k̚ k͈ u m u ɾ ʌ̹ k̚	구무럭꾸무럭
구물구물	k u m u ɭ ɡ u m u ɭ	구물구물
구미	k u m i	구미
구미화	k u m i β w a̠	구미화
구별되다	k u b j ʌ̹ ɭ d w e̞ d a̠	구별되다
구별하다	k u b j ʌ̹ ɾ ɦ a̠ d a̠	구별하다
구보	k u b o̞	구보
구부러지다	k u b u ɾ ʌ̹ d͡ʑ i d a̠	구부러지다
구분되다	k u b u n d w e̞ d a̠	구분되다
구분하다	k u b u n ɦ a̠ d a̠	구분하다
구석차기	k u sʰ ʌ̹ k̚ t͡ɕʰ a̠ ɡ i	구석차기
구성되다	k u sʰ ʌ̹ ŋ d w e̞ d a̠	구성되다
구세계	k u sʰ e̞ ɡ j e̞	구세계
구세군	k uː sʰ e̞ ɡ u n	구세군
구속되다	k u sʰ o̞ k̚ t͈ w e̞ d a̠	구속뙤다
구속하다	k u sʰ o̞ kʰ a̠ d a̠	구소카다
구실	k u ɕʰ i ɭ	구실
구실잣밤나무	k u ɕʰ i ʎ d͡ʑ a̠ t̚ p͈ a̠ m n a̠ m u	구실잗빰나무
구아니딘	k u a̠ n i d i n	구아니딘
구아바	k u a̠ b a̠	구아바
구월	k u w ʌ̹ ɭ	구월
구입하다	k u i pʰ a̠ d a̠	구이파다
구적	k u d͡ʑ ʌ̹ k̚	구적
구조	k u d͡ʑ o̞	구조
구청	k u t͡ɕʰ ʌ̹ ŋ	구청
구축하다	k u t͡ɕʰ u kʰ a̠ d a̠	구추카다
구출하다	k uː t͡ɕʰ u ɾ ɦ a̠ d a̠	구출하다
구타하다	k u tʰ a̠ ɦ a̠ d a̠	구타하다
구토하다	k u tʰ o̞ ɦ a̠ d a̠	구토하다
구판	k u pʰ a̠ n	구판
구하다	k u ɦ a̠ d a̠	구하다
구현되다	k u ʝ ʌ̹ n d w e̞ d a̠	구헌되다
구현하다	k u ʝ ʌ̹ n ɦ a̠ d a̠	구헌하다
구혼하다	k u β o̞ n ɦ a̠ d a̠	구혼하다
구휼	k uː ʝ u ɭ	구훌
국	k u k̚	국
국가보안법	k u k̚ k͈ a̠ b o̞ a̠ n b ʌ̹ p̚	국까보안법
국경일	k u k̚ k͈ j ʌ̹ ŋ i ɭ	국꼉일
국룰	k u ŋ n u ɭ	궁눌
국무총리	k u ŋ m u t͡ɕʰ o̞ ŋ n i	궁무총니
국문	k u ŋ m u n	궁문
국보	k u k̚ p͈ o̞	국뽀
국비	k u k̚ p͈ i	국삐
국뽕	k u k̚ p͈ o̞ ŋ	국뽕
국수나무	k u k s͈ u n a̠ m u	국쑤나무
국어학	k u ɡ ʌ̹ ɦ a̠ k̚	구거학
국영하다	k u ɡ j ʌ̹ ŋ ɦ a̠ d a̠	구경하다
국유화하다	k u ɡ j u β w a̠ ɦ a̠ d a̠	구규화하다
국제가	k u k̚ t͡ɕ͈ e̞ ɡ a̠	국쩨가
국제보조어	k u k̚ t͡ɕ͈ e̞ b o̞ d͡ʑ o̞ ʌ̹	국쩨보조어
국제어	k u k̚ t͡ɕ͈ e̞ ʌ̹	국쩨어
국제적	k u k̚ t͡ɕ͈ e̞ d͡ʑ ʌ̹ k̚	국쩨적
국한	k u kʰ a̠ n	구칸
군	k u n	군
군기훈련	k u n ɡ i β uː ʎ ʎ ʌ̹ n	군기훌런
군디	k u n d i	군디
군마	k u n m a̠	군마
군벌	k u n b ʌ̹ ɭ	군벌
군사경찰	k uː n sʰ a̠ ɡ j ʌ̹ ŋ t͡ɕʰ a̠ ɭ	군사경찰
군사력	k u n sʰ a̠ ɾ j ʌ̹ k̚	군사력
군사화	k u n sʰ a̠ β w a̠	군사화
군주국	k u ɲ d͡ʑ u ɡ u k̚	군주국
군중가요	k u ɲ d͡ʑ u ŋ ɡ a̠ j o	군중가요
군집	k u ɲ d͡ʑ i p̚	군집
군체	k u ɲ t͡ɕʰ e̞	군체
군함	k u n ɦ a̠ m	군함
군함조	k u n ɦ a̠ m d͡ʑ o̞	군함조
굳기름	k u t̚ k͈ i ɾ ɯ m	굳끼름
굳어지다	k u d ʌ̹ d͡ʑ i d a̠	구더지다
굴	k u ɭ	굴
굴러가다	k u ɭ ɭ ʌ̹ ɡ a̠ d a̠	굴러가다
굴리다	k uː ʎ ʎ i d a̠	굴리다
굴욕	k u ɾ j o k̚	구룍
굴종	k u ʎ t͡ɕ͈ o̞ ŋ	굴쫑
굴참나무	k u ʎ t͡ɕʰ a̠ m n a̠ m u	굴참나무
굵다랗다	k uː k̚ t͈ a̠ ɾ a̠ tʰ a̠	국따라타
굼뜨다	k u m t͈ ɯ d a̠	굼뜨다
굼적	k u m d͡ʑ ʌ̹ k̚	굼적
굼지럭	k u m d͡ʑ i ɾ ʌ̹ k̚	굼지럭
굼틀굼틀	k u m tʰ ɯ ɭ ɡ u m tʰ ɯ ɭ	굼틀굼틀
굽다	k u p̚ t͈ a̠	굽따
굽신거리다	k u p ɕ͈ i n ɡ ʌ̹ ɾ i d a̠	굽씬거리다
굿	k u t̚	굳
궁둥이	k u ŋ d u ŋ i	궁둥이
궁륭	k u ŋ ɲ u ŋ	궁눙
궁예	k u ŋ j e̞	궁예
궁현	k u ŋ ʝ ʌ̹ n	궁헌
궂다	k u t̚ t͈ a̠	굳따
권	k w ʌ̹ n	권
권투하다	k w ʌ̹ n tʰ u ɦ a̠ d a̠	권투하다
궐녀	k w ʌ̹ ʎ ʎ ʌ̹	궐러
궐련	k w ʌ̹ ʎ ʎ ʌ̹ n	궐런
궤	k w e̞	궤
귀	k ɥ i	귀
귀갓길	k ɥ iː ɡ a̠ t̚ k͈ i ɭ	귀갇낄
귀결	k ɥ iː ɡ j ʌ̹ ɭ	귀결
귀녀	k ɥ iː ɲ ʌ̹	귀너
귀두	k ɥ i d u	귀두
귀밑털	k ɥ i m i t̚ tʰ ʌ̹ ɭ	귀믿털
귀부인	k ɥ iː b u i n	귀부인
귀빈	k ɥ iː b i n	귀빈
귀뿔논병아리	k ɥ i p͈ u ɭ ɭ o̞ n b j ʌ̹ ŋ a̠ ɾ i	귀뿔론병아리
귀상어	k ɥ i sʰ a̠ ŋ ʌ̹	귀상어
귀순	k ɥ iː sʰ u n	귀순
귀엣말	k ɥ i e̞ n m a̠ ɭ	귀엔말
귀엣말하다	k ɥ i e̞ n m a̠ ɾ ɦ a̠ d a̠	귀엔말하다
귀염둥이	k ɥ iː j ʌ̹ m d u ŋ i	귀염둥이
귀접	k ɥ iː d͡ʑ ʌ̹ p̚	귀접
귀지	k ɥ i d͡ʑ i	귀지
귀하	k ɥ iː ɦ a̠	귀하
귓결	k ɥ i t̚ k͈ j ʌ̹ ɭ	귇껼
귓구멍	k ɥ i t̚ k͈ u m ʌ̹ ŋ	귇꾸멍
규률	k j u ɾ j u ɭ	규률
규소수지	k j u sʰ o̞ sʰ u d͡ʑ i	규소수지
규정되다	k j u d͡ʑ ʌ̹ ŋ d w e̞ d a̠	규정되다
규정하다	k j u d͡ʑ ʌ̹ ŋ ɦ a̠ d a̠	규정하다
규제되다	k j u d͡ʑ e̞ d w e̞ d a̠	규제되다
규제하다	k j u d͡ʑ e̞ ɦ a̠ d a̠	규제하다
규탄되다	k j u tʰ a̠ n d w e̞ d a̠	규탄되다
규탄하다	k j u tʰ a̠ n ɦ a̠ d a̠	규탄하다
균계	k j u n ɡ j e̞	균계
균류	k j u ʎ ʎ u	귤루
귤	k j u ɭ	귤
그	k ɯ	그
그끄제	k ɯ k͈ ɯ d͡ʑ e̞	그끄제
그노시스	k ɯ n o̞ ɕʰ i sʰ ɯ	그노시스
그라피토	k͈ ɯ ɾ a̠ pʰ i tʰ o̞	끄라피토
그랴	k ɯ ɾ j a̠	그랴
그러자	k ɯ ɾ ʌ̹ d͡ʑ a̠	그러자
그런지	k ɯ ɾ ʌ̹ ɲ d͡ʑ i	그런지
그레고리오	k ɯ ɾ e̞ ɡ o̞ ɾ i o̞	그레고리오
그레이비	k ɯ ɾ e̞ i b i	그레이비
그레이트브리튼	k ɯ ɾ e̞ i tʰ ɯ b ɯ ɾ i tʰ ɯ n	그레이트브리튼
그렐린	k ɯ ɾ e̞ ʎ ʎ i n	그렐린
그려지다	k ɯ ɾ j ʌ̹ d͡ʑ i d a̠	그려지다
그루빠	k ɯ ɾ u p͈ a̠	그루빠
그루지야어	k ɯ ɾ u d͡ʑ i j a̠ ʌ̹	그루지야어
그루터기	k ɯ ɾ u tʰ ʌ̹ ɡ i	그루터기
그르치다	k ɯ ɾ ɯ t͡ɕʰ i d a̠	그르치다
그리마	k ɯ ɾ i m a̠	그리마
그림기호	k ɯː ɾ i m k i β o̞	그림기호
그림분필	k ɯ ɾ i m b u n pʰ i ɭ	그림분필
그림엽서	k ɯː ɾ i m j ʌ̹ p s͈ ʌ̹	그리몁써
그림영화	k ɯː ɾ i m j ʌ̹ ŋ β w a̠	그리명화
그림풀이	k ɯ ɾ i m pʰ u ɾ i	그림푸리
그만두다	k ɯ m a̠ n d u d a̠	그만두다
그물기름갖	k ɯ m u ɭ ɡ i ɾ ɯ m ɡ a̠ t̚	그물기름갇
그위	k ɯ ɥ i	그위
그을리다	k ɯ ɯ ʎ ʎ i d a̠	그을리다
그을음	k ɯ ɯ ɾ ɯ m	그으름
그치	k ɯ t͡ɕʰ i	그치
극광	k ɯ k̚ k͈ w a̠ ŋ	극꽝
극기	k ɯ k̚ k͈ i	극끼
극기하다	k ɯ k̚ k͈ i ɦ a̠ d a̠	극끼하다
극복하다	k ɯ k̚ p͈ o̞ kʰ a̠ d a̠	극뽀카다
극심	k ɯ k ɕ͈ i m	극씸
극적	k ɯ k̚ t͡ɕ͈ ʌ̹ k̚	극쩍
극중	k ɯ k̚ t͡ɕ͈ u ŋ	극쭝
극호	k ɯ kʰ o̞	그코
근거하다	k ɯ n ɡ ʌ̹ ɦ a̠ d a̠	근거하다
근면하다	k ɯː n m j ʌ̹ n ɦ a̠ d a̠	근면하다
근본주의	k ɯ n b o̞ ɲ d͡ʑ u ɰ i	근본주의
근사하다	k ɯː n sʰ a̠ ɦ a̠ d a̠	근사하다
근자감	k ɯ ɲ d͡ʑ a̠ ɡ a̠ m	근자감
근절하다	k ɯ ɲ d͡ʑ ʌ̹ ɾ ɦ a̠ d a̠	근절하다
근접하다	k ɯː ɲ d͡ʑ ʌ̹ pʰ a̠ d a̠	근저파다
근지럽다	k ɯ ɲ d͡ʑ i ɾ ʌ̹ p̚ t͈ a̠	근지럽따
근친	k ɯ ɲ t͡ɕʰ i n	근친
근친상간	k ɯ ɲ t͡ɕʰ i n sʰ a̠ ŋ ɡ a̠ n	근친상간
근황	k ɯː n β w a̠ ŋ	근황
글	k ɯ ɭ	글
글고	k ɯ ɭ ɡ o̞	글고
글라스노스트	k ɯ ɭ ɭ a̠ sʰ ɯ n o̞ sʰ ɯ tʰ ɯ	글라스노스트
글쇠	k ɯ ɭ sʰ w e̞	글쇠
글쇠판	k ɯ ɭ sʰ w e̞ pʰ a̠ n	글쇠판
글쓴이	k ɯ ɭ s͈ ɯ n i	글쓰니
글월	k ɯ ɾ w ʌ̹ ɭ	그뤌
금	k ɯ m	금
금강모치	k ɯ m ɡ a̠ ŋ m o̞ t͡ɕʰ i	금강모치
금강초롱꽃	k ɯ m ɡ a̠ ŋ t͡ɕʰ o̞ ɾ o̞ ŋ k͈ o̞ t̚	금강초롱꼳
금귤	k ɯ m ɡ j u ɭ	금귤
금기	k ɯː m ɡ i	금기
금기시	k ɯː m ɡ i ɕʰ i	금기시
금기시되다	k ɯː m ɡ i ɕʰ i d w e̞ d a̠	금기시되다
금기시하다	k ɯː m ɡ i ɕʰ i ɦ a̠ d a̠	금기시하다
금기하다	k ɯː m ɡ i ɦ a̠ d a̠	금기하다
금번	k ɯ m b ʌ̹ n	금번
금사빠	k ɯ m sʰ a̠ p͈ a̠	금사빠
금석학	k ɯ m sʰ ʌ̹ kʰ a̠ k̚	금서칵
금수저	k ɯ m sʰ u d͡ʑ ʌ̹	금수저
금월	k ɯ m w ʌ̹ ɭ	그뭘
금지하다	k ɯː m d͡ʑ i ɦ a̠ d a̠	금지하다
금하다	k ɯː m ɦ a̠ d a̠	금하다
급감하다	k ɯ p̚ k͈ a̠ m ɦ a̠ d a̠	급깜하다
급박	k ɯ p̚ p͈ a̠ k̚	급빡
급병	k ɯ p̚ p͈ j ʌ̹ ŋ	급뼝
급속	k ɯ p s͈ o̞ k̚	급쏙
급여되다	k ɯ b j ʌ̹ d w e̞ d a̠	그벼되다
급여하다	k ɯ b j ʌ̹ ɦ a̠ d a̠	그벼하다
급증하다	k ɯ p̚ t͡ɕ͈ ɯ ŋ ɦ a̠ d a̠	급쯩하다
긍정	k ɯ ŋ d͡ʑ ʌ̹ ŋ	긍정
기	k i	기
기결수	k i ɡ j ʌ̹ ɭ sʰ u	기결수
기계단정	k i ɡ j e̞ d a̠ ɲ d͡ʑ ʌ̹ ŋ	기계단정
기계화	k i ɡ j e̞ β w a̠	기계화
기니	k i n i	기니
기니비사우	k i n i b i sʰ a̠ u	기니비사우
기다랗다	k iː d a̠ ɾ a̠ tʰ a̠	기다라타
기동	k i d o̞ ŋ	기동
기따가	k i t͈ a̠ ɡ a̠	기따가
기똥차다	k i t͈ o̞ ŋ t͡ɕʰ a̠ d a̠	기똥차다
기록영화	k i ɾ o̞ ɡ j ʌ̹ ŋ β w a̠	기로경화
기름갖	k i ɾ ɯ m ɡ a̠ t̚	기름갇
기름사탕	k i ɾ ɯ m sʰ a̠ tʰ a̠ ŋ	기름사탕
기름장	k i ɾ ɯ m d͡ʑ a̠ ŋ	기름장
기리다	k i ɾ i d a̠	기리다
기마	k i m a̠	기마
기마하다	k i m a̠ ɦ a̠ d a̠	기마하다
기만되다	k i m a̠ n d w e̞ d a̠	기만되다
기모찌	k i m o̞ t͡ɕ͈ i	기모찌
기묘	k i m j o	기묘
기묘하다	k i m j o ɦ a̠ d a̠	기묘하다
기미상궁	k i m i sʰ a̠ ŋ ɡ u ŋ	기미상궁
기민하다	k i m i n ɦ a̠ d a̠	기민하다
기밀	k i m i ɭ	기밀
기발	k i b a̠ ɭ	기발
기부금	k i b u ɡ ɯ m	기부금
기쁨조	k i p͈ ɯ m d͡ʑ o̞	기쁨조
기세하다	k i sʰ e̞ ɦ a̠ d a̠	기세하다
기소되다	k i sʰ o̞ d w e̞ d a̠	기소되다
기소하다	k i sʰ o̞ ɦ a̠ d a̠	기소하다
기시감	k i ɕʰ i ɡ a̠ m	기시감
기실	k i ɕʰ i ɭ	기실
기약하다	k i j a̠ kʰ a̠ d a̠	기야카다
기어	k i ʌ̹	기어
기어가다	k i ʌ̹ ɡ a̠ d a̠	기어가다
기억되다	k i ʌ̹ k̚ t͈ w e̞ d a̠	기억뙤다
기업하다	k i ʌ̹ pʰ a̠ d a̠	기어파다
기왕증	k i w a̠ ŋ t͡ɕ͈ ɯ ŋ	기왕쯩
기요틴	k i j o tʰ i n	기요틴
기원하다	k i w ʌ̹ n ɦ a̠ d a̠	기원하다
기이	k i i	기이
기이다	k i i d a̠	기이다
기입하다	k i i pʰ a̠ d a̠	기이파다
기자회견	k i d͡ʑ a̠ β w e̞ ɡ j ʌ̹ n	기자회견
기장	k i d͡ʑ a̠ ŋ	기장
기절하다	k i d͡ʑ ʌ̹ ɾ ɦ a̠ d a̠	기절하다
기제	k i d͡ʑ e̞	기제
기증	k i d͡ʑ ɯ ŋ	기증
기증되다	k i d͡ʑ ɯ ŋ d w e̞ d a̠	기증되다
기증자	k i d͡ʑ ɯ ŋ d͡ʑ a̠	기증자
기증하다	k i d͡ʑ ɯ ŋ ɦ a̠ d a̠	기증하다
기찻길	k i t͡ɕʰ a̠ t̚ k͈ i ɭ	기찯낄
기초하다	k i t͡ɕʰ o̞ ɦ a̠ d a̠	기초하다
기침하다	k i t͡ɕʰ i m ɦ a̠ d a̠	기침하다
기피	k i pʰ i	기피
기필코	k i pʰ i ɭ kʰ o̞	기필코
기하학	k i ɦ a̠ ɦ a̠ k̚	기하학
기후학	k i β u ɦ a̠ k̚	기후학
긴발톱첨서	k i n b a̠ ɭ tʰ o̞ p̚ t͡ɕʰ ʌ̹ m sʰ ʌ̹	긴발톱첨서
긴업	k iː n ʌ̹ p̚	기넙
긴장되다	k i ɲ d͡ʑ a̠ ŋ d w e̞ d a̠	긴장되다
긴장하다	k i ɲ d͡ʑ a̠ ŋ ɦ a̠ d a̠	긴장하다
긴털쥐	k i n tʰ ʌ̹ ʎ d͡ʑ ɥ i	긴털쥐
길	k i ɭ	길
길강아지	k i ɭ k͈ a̠ ŋ a̠ d͡ʑ i	길깡아지
길동무	k i ɭ t͈ o̞ ŋ m u	길똥무
길르앗	k i ɭ ɭ ɯ a̠ t̚	길르앋
길림	k i ʎ ʎ i m	길림
길막	k i ɭ m a̠ k̚	길막
길모퉁이	k i ɭ m o̞ tʰ u ŋ i	길모퉁이
길몽	k i ɭ m o̞ ŋ	길몽
길벗	k i ɭ p͈ ʌ̹ t̚	길뻗
길쌈	k i ɭ s͈ a̠ m	길쌈
길운	k i ɾ u n	기룬
길차다	k iː ʎ t͡ɕʰ a̠ d a̠	길차다
길하다	k i ɾ ɦ a̠ d a̠	길하다
김	k i m	김
김멜	k i m m e̞ ɭ	김멜
김심	k iː m ɕʰ i m	김심
김치국	k i m t͡ɕʰ i k͈ u k̚	김치꾹
김치녀	k i m t͡ɕʰ i ɲ ʌ̹	김치너
깁	k iː p̚	깁
깁다	k iː p̚ t͈ a̠	깁따
깁스	k i p s͈ ɯ	깁쓰
깃	k i t̚	긷
깊은	k i pʰ ɯ n	기픈
까	k͈ a̠	까
까까	k͈ a̠ k͈ a̠	까까
까꿍	k͈ a̠ k͈ u ŋ	까꿍
까뀌	k͈ a̠ː k͈ ɥ i	까뀌
까끄라기	k͈ a̠ k͈ ɯ ɾ a̠ ɡ i	까끄라기
까다	k͈ a̠ d a̠	까다
까마귓과	k͈ a̠ m a̠ ɡ ɥ i t̚ k͈ w a̠	까마귇꽈
까마중	k͈ a̠ m a̠ d͡ʑ u ŋ	까마중
까막	k͈ a̠ m a̠ k̚	까막
까막까치밥나무	k͈ a̠ m a̠ k̚ k͈ a̠ t͡ɕʰ i b a̠ m n a̠ m u	까막까치밤나무
까막딱따구리	k͈ a̠ m a̠ k̚ t͈ a̠ k̚ t͈ a̠ ɡ u ɾ i	까막딱따구리
까막잡기	k͈ a̠ m a̠ k̚ t͡ɕ͈ a̠ p̚ k͈ i	까막짭끼
까먹다	k͈ a̠ m ʌ̹ k̚ t͈ a̠	까먹따
까메룬	k͈ a̠ m e̞ ɾ u n	까메룬
까물까물	k͈ a̠ m u ɭ k͈ a̠ m u ɭ	까물까물
까자	k͈ a̠ d͡ʑ a̠	까자
까자흐스딴	k͈ a̠ d͡ʑ a̠ ɣ ɯ sʰ ɯ t͈ a̠ n	까자흐스딴
까치발	k͈ a̠ t͡ɕʰ i b a̠ ɭ	까치발
까타르	k͈ a̠ tʰ a̠ ɾ ɯ	까타르
깐부	k͈ a̠ n b u	깐부
깔깔이	k͈ a̠ ɭ k͈ a̠ ɾ i	깔까리
깔다	k͈ a̠ ɭ d a̠	깔다
깜빡하다	k͈ a̠ m p͈ a̠ kʰ a̠ d a̠	깜빠카다
깜작깜작	k͈ a̠ m d͡ʑ a̠ k̚ k͈ a̠ m d͡ʑ a̠ k̚	깜작깜작
깡치	k͈ a̠ ŋ t͡ɕʰ i	깡치
깨	k͈ ɛː	깨
꺅도요	k͈ j a̠ k̚ t͈ o̞ j o	꺅또요
꺼	k͈ ʌ̹	꺼
꺽저구	k͈ ʌ̹ k̚ t͡ɕ͈ ʌ̹ ɡ u	꺽쩌구
꺽저기	k͈ ʌ̹ k̚ t͡ɕ͈ ʌ̹ ɡ i	꺽쩌기
꺽정이	k͈ ʌ̹ k̚ t͡ɕ͈ ʌ̹ ŋ i	꺽쩡이
껌	k͈ ʌ̹ m	껌
껌벅	k͈ ʌ̹ m b ʌ̹ k̚	껌벅
껌뻑	k͈ ʌ̹ m p͈ ʌ̹ k̚	껌뻑
께끈하다	k͈ e̞ k͈ ɯ n ɦ a̠ d a̠	께끈하다
께낀하다	k͈ e̞ k͈ i n ɦ a̠ d a̠	께낀하다
껴안다	k͈ j ʌ̹ a̠ n t͈ a̠	껴안따
꼬다	k͈ o̞ː d a̠	꼬다
꼬리치레	k͈ o̞ ɾ i t͡ɕʰ i ɾ e̞	꼬리치레
꼬리치레도롱뇽	k͈ o̞ ɾ i t͡ɕʰ i ɾ e̞ d o̞ ɾ o̞ ŋ ɲ o ŋ	꼬리치레도롱뇽
꼬마뒤쥐	k͈ o̞ m a̠ d ɥ i d͡ʑ ɥ i	꼬마뒤쥐
꼬마청황	k͈ o̞ m a̠ t͡ɕʰ ʌ̹ ŋ β w a̠ ŋ	꼬마청황
꼬막	k͈ o̞ m a̠ k̚	꼬막
꼬무락꼬무락	k͈ o̞ m u ɾ a̠ k̚ k͈ o̞ m u ɾ a̠ k̚	꼬무락꼬무락
꼬무룩	k͈ o̞ m u ɾ u k̚	꼬무룩
꼬부랑국수	k͈ o̞ b u ɾ a̠ ŋ ɡ u k s͈ u	꼬부랑국쑤
꼬집다	k͈ o̞ d͡ʑ i p̚ t͈ a̠	꼬집따
꼬치고기	k͈ o̞ t͡ɕʰ i ɡ o̞ ɡ i	꼬치고기
꼭지	k͈ o̞ k̚ t͡ɕ͈ i	꼭찌
꼴	k͈ o̞ ɭ	꼴
꼴리다	k͈ o̞ ʎ ʎ i d a̠	꼴리다
꼴사납다	k͈ o̞ ɭ sʰ a̠ n a̠ p̚ t͈ a̠	꼴사납따
꼼꼼하다	k͈ o̞ m k͈ o̞ m ɦ a̠ d a̠	꼼꼼하다
꼼꼼히	k͈ o̞ m k͈ o̞ m ʝ i	꼼꼼히
꼼작	k͈ o̞ m d͡ʑ a̠ k̚	꼼작
꼼지락	k͈ o̞ m d͡ʑ i ɾ a̠ k̚	꼼지락
꼼짝꼼짝	k͈ o̞ m t͡ɕ͈ a̠ k̚ k͈ o̞ m t͡ɕ͈ a̠ k̚	꼼짝꼼짝
꼼치	k͈ o̞ m t͡ɕʰ i	꼼치
꼼틀	k͈ o̞ m tʰ ɯ ɭ	꼼틀
꼼틀꼼틀	k͈ o̞ m tʰ ɯ ɭ k͈ o̞ m tʰ ɯ ɭ	꼼틀꼼틀
꼿발	k͈ o̞ t̚ p͈ a̠ ɭ	꼳빨
꽁초	k͈ o̞ ŋ t͡ɕʰ o̞	꽁초
꽃	k͈ o̞ t̚	꼳
꽃게	k͈ o̞ t̚ k͈ e̞	꼳께
꽃말	k͈ o̞ n m a̠ ɭ	꼰말
꽃빵	k͈ o̞ t̚ p͈ a̠ ŋ	꼳빵
꽃제비	k͈ o̞ t̚ t͡ɕ͈ e̞ b i	꼳쩨비
꽉	k͈ w a̠ k̚	꽉
꽌시	k͈ w a̠ n ɕʰ i	꽌시
꾸구리	k͈ u ɡ u ɾ i	꾸구리
꾸다	k͈ u d a̠	꾸다
꾸드스	k͈ u d ɯ sʰ ɯ	꾸드스
꾸란	k͈ u ɾ a̠ n	꾸란
꾸르륵꾸르륵	k͈ u ɾ ɯ ɾ ɯ k̚ k͈ u ɾ ɯ ɾ ɯ k̚	꾸르륵꾸르륵
꾸무럭꾸무럭	k͈ u m u ɾ ʌ̹ k̚ k͈ u m u ɾ ʌ̹ k̚	꾸무럭꾸무럭
꾸미다	k͈ u m i d a̠	꾸미다
꾸바	k͈ u b a̠	꾸바
꾹저구	k͈ u k̚ t͡ɕ͈ ʌ̹ ɡ u	꾹쩌구
꿀	k͈ u ɭ	꿀
꿀꿀	k͈ u ɭ k͈ u ɭ	꿀꿀
꿀꿀이	k͈ u ɭ k͈ u ɾ i	꿀꾸리
꿀떡	k͈ u ɭ t͈ ʌ̹ k̚	꿀떡
꿀맛	k͈ u ɭ m a̠ t̚	꿀맏
꿀벅지	k͈ u ɭ b ʌ̹ k̚ t͡ɕ͈ i	꿀벅찌
꿇다	k͈ u ɭ tʰ a̠	꿀타
꿈	k͈ u m	꿈
꿈실꿈실	k͈ u m ɕʰ i ɭ k͈ u m ɕʰ i ɭ	꿈실꿈실
꿈적꿈적	k͈ u m d͡ʑ ʌ̹ k̚ k͈ u m d͡ʑ ʌ̹ k̚	꿈적꿈적
꿈지럭	k͈ u m d͡ʑ i ɾ ʌ̹ k̚	꿈지럭
꿈트럭꿈트럭	k͈ u m tʰ ɯ ɾ ʌ̹ k̚ k͈ u m tʰ ɯ ɾ ʌ̹ k̚	꿈트럭꿈트럭
꿈틀꿈틀	k͈ u m tʰ ɯ ɭ k͈ u m tʰ ɯ ɭ	꿈틀꿈틀
꿩	k͈ w ʌ̹ ŋ	꿩
꿩의밥	k͈ w ʌ̹ ŋ ɰ i b a̠ p̚	꿩의밥
꿰다	k͈ w e̞ː d a̠	꿰다
꿰뚫다	k͈ w e̞ː t͈ u ɭ tʰ a̠	꿰뚤타
끄다	k͈ ɯ d a̠	끄다
끄덕이다	k͈ ɯ d ʌ̹ ɡ i d a̠	끄더기다
끄르다	k͈ ɯ ɾ ɯ d a̠	끄르다
끄리	k͈ ɯ ɾ i	끄리
끈	k͈ ɯ n	끈
끈적끈적하다	k͈ ɯ ɲ d͡ʑ ʌ̹ k̚ k͈ ɯ ɲ d͡ʑ ʌ̹ kʰ a̠ d a̠	끈적끈저카다
끈적하다	k͈ ɯ ɲ d͡ʑ ʌ̹ kʰ a̠ d a̠	끈저카다
끊이다	k͈ ɯ n i d a̠	끄니다
끊임	k͈ ɯ n i m	끄님
끊임없다	k͈ ɯ n i m ʌ̹ p̚ t͈ a̠	끄니멉따
끌	k͈ ɯ ɭ	끌
끌리다	k͈ ɯː ʎ ʎ i d a̠	끌리다
끓다	k͈ ɯ ɭ tʰ a̠	끌타
끔뻑	k͈ ɯ m p͈ ʌ̹ k̚	끔뻑
끔적	k͈ ɯ m d͡ʑ ʌ̹ k̚	끔적
끔쩍끔쩍	k͈ ɯ m t͡ɕ͈ ʌ̹ k̚ k͈ ɯ m t͡ɕ͈ ʌ̹ k̚	끔쩍끔쩍
끔찍끔찍하다	k͈ ɯ m t͡ɕ͈ i k̚ k͈ ɯ m t͡ɕ͈ i kʰ a̠ d a̠	끔찍끔찌카다
끝	k͈ ɯ t̚	끋
끝나다	k͈ ɯ n n a̠ d a̠	끈나다
끝말잇기	k͈ ɯ n m a̠ ɾ i t̚ k͈ i	끈마릳끼
끼야기	k͈ i j a̠ ɡ i	끼야기
끼예브	k͈ i j e̞ b ɯ	끼예브
끽	k͈ i k̚	끽
끽반하다	k͈ i k̚ p͈ a̠ n ɦ a̠ d a̠	끽빤하다
끽연	k͈ i ɡ j ʌ̹ n	끼견
끽연하다	k͈ i ɡ j ʌ̹ n ɦ a̠ d a̠	끼견하다
나	n a̠	나
나귀	n a̠ ɡ ɥ i	나귀
나그푸르	n a̠ ɡ ɯ pʰ u ɾ ɯ	나그푸르
나근나근	n a̠ ɡ ɯ n n a̠ ɡ ɯ n	나근나근
나누이다	n a̠ n u i d a̠	나누이다
나뉘다	n a̠ n ɥ i d a̠	나뉘다
나닐다	n a̠ n i ɭ d a̠	나닐다
나라이름	n a̠ ɾ a̠ i ɾ ɯ m	나라이름
나루	n a̠ ɾ u	나루
나룻	n a̠ ɾ u t̚	나룯
나르다	n a̠ ɾ ɯ d a̠	나르다
나무껍질	n a̠ m u k͈ ʌ̹ p̚ t͡ɕ͈ i ɭ	나무껍찔
나무꾼	n a̠ m u k͈ u n	나무꾼
나무늘보	n a̠ m u n ɯ ɭ b o̞	나무늘보
나무라다	n a̠ m u ɾ a̠ d a̠	나무라다
나무하다	n a̠ m u ɦ a̠ d a̠	나무하다
나뭇결	n a̠ m u t̚ k͈ j ʌ̹ ɭ	나묻껼
나뭇잎	n a̠ m u n n i p̚	나문닙
나발	n a̠ b a̠ ɭ	나발
나발니	n a̠ b a̠ ʎ ʎ i	나발리
나병	n a̠ː b j ʌ̹ ŋ	나병
나부끼다	n a̠ b u k͈ i d a̠	나부끼다
나사로	n a̠ sʰ a̠ ɾ o̞	나사로
나성	n a̠ sʰ ʌ̹ ŋ	나성
나수다	n a̠ sʰ u d a̠	나수다
나아지다	n a̠ a̠ d͡ʑ i d a̠	나아지다
나이피다우	n a̠ i pʰ i d a̠ u	나이피다우
나전	n a̠ d͡ʑ ʌ̹ n	나전
나체	n a̠ː t͡ɕʰ e̞	나체
나포되다	n a̠ː pʰ o̞ d w e̞ d a̠	나포되다
나포하다	n a̠ː pʰ o̞ ɦ a̠ d a̠	나포하다
나프탈렌	n a̠ pʰ ɯ tʰ a̠ ɭ ɭ e̞ n	나프탈렌
나프티리딘	n a̠ pʰ ɯ tʰ i ɾ i d i n	나프티리딘
낙	n a̠ k̚	낙
낙관	n a̠ k̚ k͈ w a̠ n	낙꽌
낙수	n a̠ k s͈ u	낙쑤
낙양	n a̠ ɡ j a̠ ŋ	나걍
낙원	n a̠ ɡ w ʌ̹ n	나권
낙천주의	n a̠ k̚ t͡ɕʰ ʌ̹ ɲ d͡ʑ u ɰ i	낙천주의
낙천주의자	n a̠ k̚ t͡ɕʰ ʌ̹ ɲ d͡ʑ u ɰ i d͡ʑ a̠	낙천주의자
낚	n a̠ k̚	낙
낚시질	n a̠ k ɕ͈ i d͡ʑ i ɭ	낙씨질
낚시하다	n a̠ k ɕ͈ i ɦ a̠ d a̠	낙씨하다
난	n a̠ n	난
난각	n a̠ː n ɡ a̠ k̚	난각
난공불락	n a̠ n ɡ o̞ ŋ b u ɭ ɭ a̠ k̚	난공불락
난관	n a̠ n ɡ w a̠ n	난관
난데없이	n a̠ː n d e̞ ʌ̹ p ɕ͈ i	난데업씨
난리하다	n a̠ː ʎ ʎ i ɦ a̠ d a̠	날리하다
난무	n a̠ː n m u	난무
난문	n a̠ n m u n	난문
난제	n a̠ ɲ d͡ʑ e̞	난제
난질이	n a̠ː ɲ d͡ʑ i ɾ i	난지리
난처하다	n a̠ ɲ t͡ɕʰ ʌ̹ ɦ a̠ d a̠	난처하다
난치하다	n a̠ ɲ t͡ɕʰ i ɦ a̠ d a̠	난치하다
난황	n a̠ː n β w a̠ ŋ	난황
낟	n a̠ t̚	낟
날	n a̠ ɭ	날
날뛰다	n a̠ ɭ t͈ ɥ i d a̠	날뛰다
날려가다	n a̠ ʎ ʎ ʌ̹ ɡ a̠ d a̠	날러가다
날망둑	n a̠ ɭ m a̠ ŋ d u k̚	날망둑
날씬하다	n a̠ ɭ ɕ͈ i n ɦ a̠ d a̠	날씬하다
날조되다	n a̠ ʎ d͡ʑ o̞ d w e̞ d a̠	날조되다
날조하다	n a̠ ʎ d͡ʑ o̞ ɦ a̠ d a̠	날조하다
날짐승	n a̠ ʎ t͡ɕ͈ i m sʰ ɯ ŋ	날찜승
낡	n a̠ k̚	낙
낡다	n a̠ k̚ t͈ a̠	낙따
남	n a̠ m	남
남겨지다	n a̠ m ɡ j ʌ̹ d͡ʑ i d a̠	남겨지다
남근	n a̠ m ɡ ɯ n	남근
남기다	n a̠ m ɡ i d a̠	남기다
남남북녀	n a̠ m n a̠ m b u ŋ ɲ ʌ̹	남남붕너
남다	n a̠ː m t͈ a̠	남따
남돌	n a̠ m d o̞ ɭ	남돌
남루하다	n a̠ː m n u ɦ a̠ d a̠	남누하다
남만	n a̠ m m a̠ n	남만
남벌하다	n a̠ː m b ʌ̹ ɾ ɦ a̠ d a̠	남벌하다
남비	n a̠ m b i	남비
남사친	n a̠ m sʰ a̠ t͡ɕʰ i n	남사친
남성고음	n a̠ m sʰ ʌ̹ ŋ ɡ o̞ ɯ m	남성고음
남성중음	n a̠ m sʰ ʌ̹ ŋ d͡ʑ u ŋ ɯ m	남성중음
남수단	n a̠ m sʰ u d a̠ n	남수단
남아공	n a̠ m a̠ ɡ o̞ ŋ	나마공
남월	n a̠ m w ʌ̹ ɭ	나뭘
남의자	n a̠ m ɰ i d͡ʑ a̠	나믜자
남이사	n a̠ m i sʰ a̠	나미사
남장하다	n a̠ m d͡ʑ a̠ ŋ ɦ a̠ d a̠	남장하다
남존여비	n a̠ m d͡ʑ o̞ n ɲ ʌ̹ b i	남존너비
납득하다	n a̠ p̚ t͈ ɯ kʰ a̠ d a̠	납뜨카다
납량하다	n a̠ m ɲ a̠ ŋ ɦ a̠ d a̠	남낭하다
납자루	n a̠ p̚ t͡ɕ͈ a̠ ɾ u	납짜루
납치되다	n a̠ p̚ t͡ɕʰ i d w e̞ d a̠	납치되다
납치하다	n a̠ p̚ t͡ɕʰ i ɦ a̠ d a̠	납치하다
낫	n a̠ t̚	낟
낭구	n a̠ ŋ ɡ u	낭구
낭독되다	n a̠ː ŋ d o̞ k̚ t͈ w e̞ d a̠	낭독뙤다
낭독하다	n a̠ː ŋ d o̞ kʰ a̠ d a̠	낭도카다
낭비하다	n a̠ː ŋ b i ɦ a̠ d a̠	낭비하다
낭송	n a̠ː ŋ sʰ o̞ ŋ	낭송
낭송되다	n a̠ː ŋ sʰ o̞ ŋ d w e̞ d a̠	낭송되다
낭송하다	n a̠ː ŋ sʰ o̞ ŋ ɦ a̠ d a̠	낭송하다
낭중	n a̠ː ŋ d͡ʑ u ŋ	낭중
낭하	n a̠ ŋ ɦ a̠	낭하
낮	n a̠ t̚	낟
낮잡다	n a̠ t̚ t͡ɕ͈ a̠ p̚ t͈ a̠	낟짭따
낯	n a̠ t̚	낟
낱	n a̠ː t̚	낟
내	n ɛː	내
내강	n ɛː ɡ a̠ ŋ	내강
내놓다	n ɛː n o̞ tʰ a̠	내노타
내달	n ɛː d a̠ ɭ	내달
내독소	n ɛː d o̞ k s͈ o̞	내독쏘
내뚫다	n ɛː t͈ u ɭ tʰ a̠	내뚤타
내리	n ɛː ɾ i	내리
내몰다	n ɛː m o̞ ɭ d a̠	내몰다
내몰리다	n ɛː m o̞ ʎ ʎ i d a̠	내몰리다
내버리다	n ɛː b ʌ̹ ɾ i d a̠	내버리다
내빈	n ɛː b i n	내빈
내수	n ɛː sʰ u	내수
내숭	n ɛː sʰ u ŋ	내숭
내쉬다	n ɛː ʃʰ ɥ i d a̠	내쉬다
내월	n ɛː w ʌ̹ ɭ	내월
내접원	n ɛː d͡ʑ ʌ̹ b w ʌ̹ n	내저붠
내칙	n ɛː t͡ɕʰ i k̚	내칙
내한하다	n ɛː ɦ a̠ n ɦ a̠ d a̠	내한하다
낼	n ɛː ɭ	낼
냇가	n ɛː t̚ k͈ a̠	낻까
냉소	n ɛː ŋ sʰ o̞	냉소
냥	ɲ a̠ ŋ	낭
냥반	ɲ a̠ ŋ b a̠ n	낭반
너	n ʌ̹	너
너도밤나무	n ʌ̹ d o̞ b a̠ m n a̠ m u	너도밤나무
너울	n ʌ̹ u ɭ	너울
너이	n ʌ̹ i	너이
너저분하다	n ʌ̹ d͡ʑ ʌ̹ b u n ɦ a̠ d a̠	너저분하다
너테	n ʌ̹ tʰ e̞	너테
너페	n ʌ̹ pʰ e̞	너페
너히	n ʌ̹ ʝ i	너히
넋	n ʌ̹ k̚	넉
넋두리	n ʌ̹ k̚ t͈ u ɾ i	넉뚜리
넌즈시	n ʌ̹ ɲ d͡ʑ ɯ ɕʰ i	넌즈시
넌지시	n ʌ̹ ɲ d͡ʑ i ɕʰ i	넌지시
널	n ʌ̹ ɭ	널
널찌다	n ʌ̹ ʎ t͡ɕ͈ i d a̠	널찌다
넓은주둥이상어	n ʌ̹ ɭ b ɯ ɲ d͡ʑ u d u ŋ i sʰ a̠ ŋ ʌ̹	널븐주둥이상어
넓적부리	n ʌ̹ p̚ t͡ɕ͈ ʌ̹ k̚ p͈ u ɾ i	넙쩍뿌리
넓히다	n ʌ̹ ɭ pʰ i d a̠	널피다
넘어가다	n ʌ̹ m ʌ̹ ɡ a̠ d a̠	너머가다
넘어서다	n ʌ̹ m ʌ̹ sʰ ʌ̹ d a̠	너머서다
넘어지다	n ʌ̹ m ʌ̹ d͡ʑ i d a̠	너머지다
넝마	n ʌ̹ ŋ m a̠	넝마
네	n e̞ː	네
네꾸다이	n e̞ k͈ u d a̠ i	네꾸다이
네덕	n e̞ d ʌ̹ k̚	네덕
네로	n e̞ ɾ o̞	네로
네발가락도롱뇽	n e̞ː b a̠ ɭ k͈ a̠ ɾ a̠ k̚ t͈ o̞ ɾ o̞ ŋ ɲ o ŋ	네발까락또롱뇽
네브라스카	n e̞ b ɯ ɾ a̠ s͈ ɯ kʰ a̠	네브라쓰카
네오디뮴	n e̞ o̞ d i m j u m	네오디뮴
네토라레	n e̞ tʰ o̞ ɾ a̠ ɾ e̞	네토라레
넷	n e̞ː t̚	넫
넷카마	n e̞ t̚ kʰ a̠ m a̠	넫카마
넷플릭스	n e̞ t̚ pʰ ɯ ʎ ʎ i k s͈ ɯ	넫플릭쓰
녀름	ɲ ʌ̹ ɾ ɯ m	너름
녀성	ɲ ʌ̹ sʰ ʌ̹ ŋ	너성
녀성고음	ɲ ʌ̹ sʰ ʌ̹ ŋ ɡ o̞ ɯ m	너성고음
녀성저음	ɲ ʌ̹ sʰ ʌ̹ ŋ d͡ʑ ʌ̹ ɯ m	너성저음
녀왕	ɲ ʌ̹ w a̠ ŋ	너왕
녀자	ɲ ʌ̹ d͡ʑ a̠	너자
녁	ɲ ʌ̹ k̚	넉
년	ɲ ʌ̹ n	넌
년금	ɲ ʌ̹ n ɡ ɯ m	넌금
년세	ɲ ʌ̹ n sʰ e̞	넌세
념	ɲ ʌ̹ m	넘
녑	ɲ ʌ̹ p̚	넙
녕	ɲ ʌ̹ ŋ	넝
녕하	ɲ ʌ̹ ŋ ɦ a̠	넝하
녘	ɲ ʌ̹ k̚	넉
녜	ɲ e̞	네
노	n o̞	노
노가리	n o̞ ɡ a̠ ɾ i	노가리
노국	n o̞ ɡ u k̚	노국
노나다	n o̞ n a̠ d a̠	노나다
노느다	n o̞ n ɯ d a̠	노느다
노닐다	n o̞ː n i ɭ d a̠	노닐다
노던줄	n o̞ d ʌ̹ ɲ d͡ʑ u ɭ	노던줄
노동계급화	n o̞ d o̞ ŋ ɡ j e̞ ɡ ɯ pʰ w a̠	노동계그퐈
노동계급화하다	n o̞ d o̞ ŋ ɡ j e̞ ɡ ɯ pʰ w a̠ ɦ a̠ d a̠	노동계그퐈하다
노르다	n o̞ ɾ ɯ d a̠	노르다
노릇	n o̞ ɾ ɯ t̚	노륻
노릇노릇하다	n o̞ ɾ ɯ n n o̞ ɾ ɯ tʰ a̠ d a̠	노른노르타다
노망하다	n o̞ː m a̠ ŋ ɦ a̠ d a̠	노망하다
노바스코샤	n o̞ b a̠ s͈ ɯ kʰ o̞ ɕʰ a̠	노바쓰코사
노박덩굴	n o̞ b a̠ k̚ t͈ ʌ̹ ŋ ɡ u ɭ	노박떵굴
노벨륨	n o̞ b e̞ ʎ ʎ u m	노벨룸
노비	n o̞ b i	노비
노숙하다	n o̞ sʰ u kʰ a̠ d a̠	노수카다
노스다코타	n o̞ s͈ ɯ d a̠ kʰ o̞ tʰ a̠	노쓰다코타
노인병학	n o̞ː i n p͈ j ʌ̹ ŋ ɦ a̠ k̚	노인뼝학
노인의학	n o̞ː i n ɰ i ɦ a̠ k̚	노이늬학
노조	n o̞ d͡ʑ o̞	노조
노크하다	n o̞ k x ɯ ɦ a̠ d a̠	노크하다
노화하다	n o̞ː β w a̠ ɦ a̠ d a̠	노화하다
녹	n o̞ k̚	녹
녹다	n o̞ k̚ t͈ a̠	녹따
녹두	n o̞ k̚ t͈ u	녹뚜
녹두나물	n o̞ k̚ t͈ u n a̠ m u ɭ	녹뚜나물
녹유	n o̞ ɡ j u	노규
녹이다	n o̞ ɡ i d a̠	노기다
녹화	n o̞ kʰ w a̠	노콰
논	n o̞ n	논
논길	n o̞ n k͈ i ɭ	논낄
논단	n o̞ n d a̠ n	논단
논란	n o̞ ɭ ɭ a̠ n	놀란
논바이너리	n o̞ n b a̠ i n ʌ̹ ɾ i	논바이너리
논제	n o̞ ɲ d͡ʑ e̞	논제
논쥐	n o̞ ɲ d͡ʑ ɥ i	논쥐
놀라다	n o̞ː ɭ ɭ a̠ d a̠	놀라다
놀리다	n o̞ ʎ ʎ i d a̠	놀리다
놀아나다	n o̞ ɾ a̠ n a̠ d a̠	노라나다
놀토	n o̞ ɭ tʰ o̞	놀토
놈	n o̞ m	놈
농구하다	n o̞ ŋ ɡ u ɦ a̠ d a̠	농구하다
농노	n o̞ ŋ n o̞	농노
농담	n o̞ ŋ d a̠ m	농담
농담하다	n o̞ː ŋ d a̠ m ɦ a̠ d a̠	농담하다
농력	n o̞ ŋ ɲ ʌ̹ k̚	농넉
농사꾼	n o̞ ŋ sʰ a̠ k͈ u n	농사꾼
농사하다	n o̞ ŋ sʰ a̠ ɦ a̠ d a̠	농사하다
농악	n o̞ ŋ a̠ k̚	농악
농요	n o̞ ŋ j o	농요
농학	n o̞ ŋ ɦ a̠ k̚	농학
농학자	n o̞ ŋ ɦ a̠ k̚ t͡ɕ͈ a̠	농학짜
높아지다	n o̞ pʰ a̠ d͡ʑ i d a̠	노파지다
높임말	n o̞ pʰ i m m a̠ ɭ	노핌말
놓아두다	n o̞ a̠ d u d a̠	노아두다
놔두다	n w a̠ d u d a̠	놔두다
뇌	n w e̞ː	뇌
뇌리	n w e̞ ɾ i	뇌리
뇌명	n w e̞ m j ʌ̹ ŋ	뇌명
뇌수	n w e̞ sʰ u	뇌수
뇌졸증	n w e̞ d͡ʑ o̞ ʎ t͡ɕ͈ ɯ ŋ	뇌졸쯩
뇍이다	n w e̞ ɡ i d a̠	뇌기다
뇨소	ɲ o sʰ o̞	뇨소
뇨자	ɲ o d͡ʑ a̠	뇨자
누	n u	누
누가	n u ɡ a̠	누가
누그러뜨리다	n u ɡ ɯ ɾ ʌ̹ t͈ ɯ ɾ i d a̠	누그러뜨리다
누나부트	n u n a̠ b u tʰ ɯ	누나부트
누다	n u d a̠	누다
누룩	n u ɾ u k̚	누룩
누룽지	n u ɾ u ŋ d͡ʑ i	누룽지
누르술탄	n u ɾ ɯ sʰ u ɭ tʰ a̠ n	누르술탄
누선	n u sʰ ʌ̹ n	누선
누적하다	n uː d͡ʑ ʌ̹ kʰ a̠ d a̠	누저카다
누쿠알로파	n u kʰ u a̠ ɭ ɭ o̞ pʰ a̠	누쿠알로파
눅다	n u k̚ t͈ a̠	눅따
눈	n u n	눈
눈두덩	n u n d u d ʌ̹ ŋ	눈두덩
눈뜨다	n u n t͈ ɯ d a̠	눈뜨다
눈망울	n u n m a̠ ŋ u ɭ	눈망울
눈싸움	n u n s͈ a̠ u m	눈싸움
눈썰미	n u n s͈ ʌ̹ ɭ m i	눈썰미
눈썹먹	n u n s͈ ʌ̹ m m ʌ̹ k̚	눈썸먹
눈알	n u n a̠ ɭ	누날
눈팅	n u n tʰ i ŋ	눈팅
눋다	n uː t̚ t͈ a̠	눋따
눌	n u ɭ	눌
눕다	n uː p̚ t͈ a̠	눕따
눚다	n u t̚ t͈ a̠	눋따
눼	n w e̞	눼
뉘	n ɥ i	뉘
뉘우치다	n ɥ i u t͡ɕʰ i d a̠	뉘우치다
뉴	ɲ u	누
뉴멕시코	ɲ u m e̞ k ɕ͈ i kʰ o̞	누멕씨코
뉴브런즈윅	ɲ u b ɯ ɾ ʌ̹ ɲ d͡ʑ ɯ ɥ i k̚	누브런즈윅
뉴저지	ɲ u d͡ʑ ʌ̹ d͡ʑ i	누저지
뉵	ɲ u k̚	눅
느껴지다	n ɯ k͈ j ʌ̹ d͡ʑ i d a̠	느껴지다
느끼하다	n ɯ k͈ i ɦ a̠ d a̠	느끼하다
느닷없다	n ɯ d a̠ d ʌ̹ p̚ t͈ a̠	느다덥따
느시	n ɯ ɕʰ i	느시
늘	n ɯ ɭ	늘
늘푸르다	n ɯ ɭ pʰ u ɾ ɯ d a̠	늘푸르다
능	n ɯ ŋ	능
능가하다	n ɯ ŋ ɡ a̠ ɦ a̠ d a̠	능가하다
능격	n ɯ ŋ k͈ j ʌ̹ k̚	능껵
능선	n ɯ ŋ sʰ ʌ̹ n	능선
능숙하다	n ɯ ŋ sʰ u kʰ a̠ d a̠	능수카다
늧	n ɯ t̚	늗
늪	n ɯ p̚	늡
늪살무사	n ɯ p s͈ a̠ ɭ m u sʰ a̠	늡쌀무사
니	n i	니
니아메	n i a̠ m e̞	니아메
니오비움	n i o̞ b i u m	니오비움
니케아	n i kʰ e̞ a̠	니케아
니코시아	n i kʰ o̞ ɕʰ i a̠	니코시아
니콜라스	n i kʰ o̞ ɭ ɭ a̠ sʰ ɯ	니콜라스
니힐리즘	n i ʝ i ʎ ʎ i d͡ʑ ɯ m	니힐리즘
닉	n i k̚	닉
닉스타말화	n i k s͈ ɯ tʰ a̠ m a̠ ɾ β w a̠	닉쓰타말화
닌진	n i ɲ d͡ʑ i n	닌진
닐	n i ɭ	닐
님	n i m	님
닝겐	n i ŋ ɡ e̞ n	닝겐
다	t a̠	다
다가	t a̠ k͈ a̠	다까
다가가다	t a̠ ɡ a̠ ɡ a̠ d a̠	다가가다
다거다	t a̠ ɡ ʌ̹ d a̠	다거다
다그다	t a̠ ɡ ɯ d a̠	다그다
다그치다	t a̠ ɡ ɯ t͡ɕʰ i d a̠	다그치다
다녀가다	t a̠ ɲ ʌ̹ ɡ a̠ d a̠	다너가다
다녀오다	t a̠ ɲ ʌ̹ o̞ d a̠	다너오다
다다르다	t a̠ d a̠ ɾ ɯ d a̠	다다르다
다도	t a̠ d o̞	다도
다락같다	t a̠ ɾ a̠ k̚ k͈ a̠ t̚ t͈ a̠	다락깓따
다름슈타튬	t a̠ ɾ ɯ m ɕʰ u tʰ a̠ tʰ j u m	다름수타튬
다리다	t a̠ ɾ i d a̠	다리다
다리미질	t a̠ ɾ i m i d͡ʑ i ɭ	다리미질
다리미판	t a̠ ɾ i m i pʰ a̠ n	다리미판
다림질하다	t a̠ ɾ i m d͡ʑ i ɾ ɦ a̠ d a̠	다림질하다
다마	t a̠ m a̠	다마
다묵장어	t a̠ m u k̚ t͡ɕ͈ a̠ ŋ ʌ̹	다묵짱어
다물다	t a̠ m u ɭ d a̠	다물다
다스리다	t a̠ sʰ ɯ ɾ i d a̠	다스리다
다슬다	t a̠ sʰ ɯ ɭ d a̠	다슬다
다시마	t a̠ ɕʰ i m a̠	다시마
다신론	t a̠ ɕʰ i n n o̞ n	다신논
다양화	t a̠ j a̠ ŋ β w a̠	다양화
다완	t a̠ w a̠ n	다완
다원화	t a̠ w ʌ̹ n β w a̠	다원화
다이어터	t a̠ i ʌ̹ tʰ ʌ̹	다이어터
다이제스트	t a̠ i d͡ʑ e̞ sʰ ɯ tʰ ɯ	다이제스트
다짐하다	t a̠ d͡ʑ i m ɦ a̠ d a̠	다짐하다
다차	t a̠ t͡ɕʰ a̠	다차
다카르	t a̠ kʰ a̠ ɾ ɯ	다카르
닥치다	t a̠ k̚ t͡ɕʰ i d a̠	닥치다
단	t a̠ n	단
단감자	t a̠ n ɡ a̠ m d͡ʑ a̠	단감자
단검	t a̠ː n ɡ ʌ̹ m	단검
단맛	t a̠ n m a̠ t̚	단맏
단모음	t a̠ n m o̞ ɯ m	단모음
단무지	t a̠ n m u d͡ʑ i	단무지
단묵	t a̠ n m u k̚	단묵
단물약	t a̠ n m u ʎ ʎ a̠ k̚	단물락
단발	t a̠ n b a̠ ɭ	단발
단봉낙타	t a̠ n b o̞ ŋ n a̠ k̚ tʰ a̠	단봉낙타
단소	t a̠ː n sʰ o̞	단소
단속	t a̠ n sʰ o̞ k̚	단속
단순어	t a̠ n sʰ u n ʌ̹	단수너
단순청상아리	t a̠ n sʰ u ɲ t͡ɕʰ ʌ̹ ŋ sʰ a̠ ŋ a̠ ɾ i	단순청상아리
단엽기	t a̠ ɲ ʌ̹ p̚ k͈ i	다넙끼
단일하다	t a̠ n i ɾ ɦ a̠ d a̠	다닐하다
단절	t a̠ː ɲ d͡ʑ ʌ̹ ɭ	단절
단점	t a̠ː ɲ t͡ɕ͈ ʌ̹ m	단쩜
닫다	t a̠ t̚ t͈ a̠	닫따
달	t a̠ ɭ	달
달고나	t a̠ ɭ ɡ o̞ n a̠	달고나
달다	t a̠ ɭ d a̠	달다
달돋이	t a̠ ɭ d o̞ d͡ʑ i	달도지
달라지다	t a̠ ɭ ɭ a̠ d͡ʑ i d a̠	달라지다
달려오다	t a̠ ʎ ʎ ʌ̹ o̞ d a̠	달러오다
달마	t a̠ ɭ m a̠	달마
달이다	t a̠ ɾ i d a̠	다리다
달필	t a̠ ɭ pʰ i ɭ	달필
닭	t a̠ k̚	닥
닭싸움	t a̠ k s͈ a̠ u m	닥싸움
닭쌈	t a̠ k s͈ a̠ m	닥쌈
닭알	t a̠ ɭ ɡ a̠ ɭ	달갈
닮음	t a̠ ɭ m ɯ m	달믐
담	t a̠ m	담
담기다	t a̠ m ɡ i d a̠	담기다
담력	t a̠ː m ɲ ʌ̹ k̚	담넉
담박	t a̠ m b a̠ k̚	담박
담박하다	t a̠ m b a̠ kʰ a̠ d a̠	담바카다
담보하다	t a̠ m b o̞ ɦ a̠ d a̠	담보하다
담비	t a̠ m b i	담비
담주	t a̠ː m t͡ɕ͈ u	담쭈
담화	t a̠ m β w a̠	담화
담황	t a̠ː m β w a̠ ŋ	담황
답	t a̠ p̚	답
답글	t a̠ p̚ k͈ ɯ ɭ	답끌
답습되다	t a̠ p s͈ ɯ p̚ t͈ w e̞ d a̠	답씁뙤다
답습하다	t a̠ p s͈ ɯ pʰ a̠ d a̠	답쓰파다
답신하다	t a̠ p ɕ͈ i n ɦ a̠ d a̠	답씬하다
답안	t a̠ b a̠ n	다반
답장하다	t a̠ p̚ t͡ɕ͈ a̠ ŋ ɦ a̠ d a̠	답짱하다
답하다	t a̠ pʰ a̠ d a̠	다파다
당	t a̠ ŋ	당
당고	t a̠ ŋ ɡ o̞	당고
당귀	t a̠ ŋ ɡ ɥ i	당귀
당기다	t a̠ ŋ ɡ i d a̠	당기다
당나라	t a̠ ŋ n a̠ ɾ a̠	당나라
당마크	t a̠ ŋ m a̠ k x ɯ	당마크
당멸치	t a̠ ŋ m j ʌ̹ ʎ t͡ɕʰ i	당멸치
당밀	t a̠ ŋ m i ɭ	당밀
당선	t a̠ ŋ sʰ ʌ̹ n	당선
당아지	t a̠ ŋ a̠ d͡ʑ i	당아지
당일	t a̠ ŋ i ɭ	당일
당첨	t a̠ ŋ t͡ɕʰ ʌ̹ m	당첨
당황하다	t a̠ ŋ β w a̠ ŋ ɦ a̠ d a̠	당황하다
대	t ɛː	대
대가	t ɛː k͈ a̠	대까
대공국	t ɛː ɡ o̞ ŋ ɡ u k̚	대공국
대교구	t ɛː ɡ j o ɡ u	대교구
대기만성	t ɛː ɡ i m a̠ n sʰ ʌ̹ ŋ	대기만성
대낮	t ɛː n a̠ t̚	대낟
대답하다	t ɛː d a̠ pʰ a̠ d a̠	대다파다
대두어	t ɛː d u ʌ̹	대두어
대둔근	t ɛː d u n ɡ ɯ n	대둔근
대로	t ɛː ɾ o̞	대로
대류	t ɛː ɾ j u	대류
대륙밭쥐	t ɛː ɾ j u k̚ p͈ a̠ t̚ t͡ɕ͈ ɥ i	대륙빧쮜
대륙사슴	t ɛː ɾ j u k s͈ a̠ sʰ ɯ m	대륙싸슴
대륙송사리	t ɛː ɾ j u k s͈ o̞ ŋ sʰ a̠ ɾ i	대륙쏭사리
대리자	t ɛː ɾ i d͡ʑ a̠	대리자
대망	t e̞ m a̠ ŋ	데망
대망하다	t ɛː m a̠ ŋ ɦ a̠ d a̠	대망하다
대머리	t ɛː m ʌ̹ ɾ i	대머리
대문자	t ɛː m u ɲ t͡ɕ͈ a̠	대문짜
대변보다	t ɛː b j ʌ̹ n b o̞ d a̠	대변보다
대변자	t ɛː b j ʌ̹ ɲ d͡ʑ a̠	대변자
대산	t ɛː sʰ a̠ n	대산
대상자	t ɛː sʰ a̠ ŋ d͡ʑ a̠	대상자
대수학	t ɛː sʰ u ɦ a̠ k̚	대수학
대신하다	t ɛː ɕʰ i n ɦ a̠ d a̠	대신하다
대안우파	t ɛː a̠ n uː pʰ a̠	대아누파
대역본	t ɛː j ʌ̹ k̚ p͈ o̞ n	대역뽄
대왕	t ɛː w a̠ ŋ	대왕
대원군	t ɛː w ʌ̹ n ɡ u n	대원군
대음순	t ɛː ɯ m sʰ u n	대음순
대인	t ɛː i n	대인
대자	t ɛː d͡ʑ a̠	대자
대장장이	t ɛː d͡ʑ a̠ ŋ d͡ʑ a̠ ŋ i	대장장이
대저	t ɛː d͡ʑ ʌ̹	대저
대전차포	t ɛː d͡ʑ ʌ̹ ɲ t͡ɕʰ a̠ pʰ o̞	대전차포
대천사	t ɛː t͡ɕʰ ʌ̹ n sʰ a̠	대천사
대추	t ɛː t͡ɕʰ u	대추
대치하다	t ɛː t͡ɕʰ i ɦ a̠ d a̠	대치하다
대퇴이두근	t ɛː tʰ w e̞ i d u ɡ ɯ n	대퇴이두근
대표하다	t ɛː pʰ j o ɦ a̠ d a̠	대표하다
대표훈	t ɛː pʰ j o β u n	대표훈
대화방	t ɛː β w a̠ b a̠ ŋ	대화방
대화하다	t ɛː β w a̠ ɦ a̠ d a̠	대화하다
대황어	t ɛː β w a̠ ŋ ʌ̹	대황어
더	t ʌ̹	더
더듬이다리	t ʌ̹ d ɯ m i d a̠ ɾ i	더드미다리
더브늄	t ʌ̹ b ɯ ɲ u m	더브눔
더블유	t͈ ʌ̹ b ɯ ʎ ʎ u	떠블루
더치페이	t ʌ̹ t͡ɕʰ i pʰ e̞ i	더치페이
더치페이하다	t ʌ̹ t͡ɕʰ i pʰ e̞ i ɦ a̠ d a̠	더치페이하다
더품	t ʌ̹ pʰ u m	더품
덕	t ʌ̹ k̚	덕
덕통	t ʌ̹ k̚ tʰ o̞ ŋ	덕통
덕통사고	t ʌ̹ k̚ tʰ o̞ ŋ sʰ a̠ ɡ o̞	덕통사고
덕후	t ʌ̹ kʰ u	더쿠
던지니스게	t ʌ̹ ɲ d͡ʑ i n i sʰ ɯ ɡ e̞	던지니스게
덜커덕	t ʌ̹ ɭ kʰ ʌ̹ d ʌ̹ k̚	덜커덕
덜컹이다	t ʌ̹ ɭ kʰ ʌ̹ ŋ i d a̠	덜컹이다
덤벙이다	t ʌ̹ m b ʌ̹ ŋ i d a̠	덤벙이다
덤불	t ʌ̹ m b u ɭ	덤불
덧	t ʌ̹ t̚	덛
덧니	t ʌ̹ n n i	던니
덧문	t ʌ̹ n m u n	던문
덧붙이다	t ʌ̹ t̚ p͈ u t͡ɕʰ i d a̠	덛뿌치다
덩굴	t ʌ̹ ŋ ɡ u ɭ	덩굴
덩굴옻나무	t ʌ̹ ŋ ɡ u ɾ o̞ n n a̠ m u	덩구론나무
덮다	t ʌ̹ p̚ t͈ a̠	덥따
덮밥	t ʌ̹ p̚ p͈ a̠ p̚	덥빱
데거	t e̞ ɡ ʌ̹	데거
데니스	t e̞ n i sʰ ɯ	데니스
데띠기	t e̞ t͈ i ɡ i	데띠기
데려가다	t e̞ ɾ j ʌ̹ ɡ a̠ d a̠	데려가다
데메테르	t e̞ m e̞ tʰ e̞ ɾ ɯ	데메테르
데모하다	t e̞ m o̞ ɦ a̠ d a̠	데모하다
데바나가리	t e̞ b a̠ n a̠ ɡ a̠ ɾ i	데바나가리
데오도란트	t e̞ o̞ d o̞ ɾ a̠ n tʰ ɯ	데오도란트
데이트하다	t e̞ i tʰ ɯ ɦ a̠ d a̠	데이트하다
데케인	t e̞ kʰ e̞ i n	데케인
데타	t e̞ tʰ a̠	데타
덱스트린	t e̞ k s͈ ɯ tʰ ɯ ɾ i n	덱쓰트린
덴푸라	t e̞ n pʰ u ɾ a̠	덴푸라
델라웨어	t e̞ ɭ ɭ a̠ w e̞ ʌ̹	델라웨어
델러웨어	t e̞ ɭ ɭ ʌ̹ w e̞ ʌ̹	델러웨어
도	t o̞	도
도검	t o̞ ɡ ʌ̹ m	도검
도공	t o̞ ɡ o̞ ŋ	도공
도덕경	t o̞ d ʌ̹ k̚ k͈ j ʌ̹ ŋ	도덕꼉
도록	t o̞ ɾ o̞ k̚	도록
도륙되다	t o̞ ɾ j u k̚ t͈ w e̞ d a̠	도륙뙤다
도륙하다	t o̞ ɾ j u kʰ a̠ d a̠	도류카다
도리	t o̞ ɾ i	도리
도막	t o̞ m a̠ k̚	도막
도망가다	t o̞ m a̠ ŋ ɡ a̠ d a̠	도망가다
도망자	t o̞ m a̠ ŋ d͡ʑ a̠	도망자
도망하다	t o̞ m a̠ ŋ ɦ a̠ d a̠	도망하다
도미	t o̞ m i	도미
도보	t o̞ b o̞	도보
도사	t o̞ sʰ a̠	도사
도사하다	t o̞ sʰ a̠ ɦ a̠ d a̠	도사하다
도삽	t o̞ sʰ a̠ p̚	도삽
도서	t o̞ sʰ ʌ̹	도서
도서관원	t o̞ sʰ ʌ̹ ɡ w a̠ n w ʌ̹ n	도서과눤
도시화	t o̞ ɕʰ i β w a̠	도시화
도야지	t o̞ j a̠ d͡ʑ i	도야지
도예가	t o̞ j e̞ ɡ a̠	도예가
도와주다	t o̞ w a̠ d͡ʑ u d a̠	도와주다
도움말	t o̞ u m m a̠ ɭ	도움말
도이	t o̞ i	도이
도이췰란드	t o̞ i t͡ɕʰ ɥ i ɭ ɭ a̠ n d ɯ	도이췰란드
도착하다	t o̞ː t͡ɕʰ a̠ kʰ a̠ d a̠	도차카다
도토리묵	t o̞ tʰ o̞ ɾ i m u k̚	도토리묵
독	t o̞ k̚	독
독고	t o̞ k̚ k͈ o̞	독꼬
독미나리	t o̞ ŋ m i n a̠ ɾ i	동미나리
독본	t o̞ k̚ p͈ o̞ n	독뽄
독불장군	t o̞ k̚ p͈ u ʎ d͡ʑ a̠ ŋ ɡ u n	독뿔장군
독서하다	t o̞ k s͈ ʌ̹ ɦ a̠ d a̠	독써하다
독어	t o̞ ɡ ʌ̹	도거
돈	t o̞ː n	돈
돈까스	t o̞ n k͈ a̠ sʰ ɯ	돈까스
돈닢	t o̞ n n i p̚	돈닙
돈벌레	t o̞ n p͈ ʌ̹ ɭ ɭ e̞	돈뻘레
돋우다	t o̞ d u d a̠	도두다
돌	t o̞ ɭ	돌
돌가자미	t o̞ ɭ ɡ a̠ d͡ʑ a̠ m i	돌가자미
돌격하다	t o̞ ɭ ɡ j ʌ̹ kʰ a̠ d a̠	돌겨카다
돌려주다	t o̞ ʎ ʎ ʌ̹ d͡ʑ u d a̠	돌러주다
돌마자	t o̞ ɭ m a̠ d͡ʑ a̠	돌마자
돌무화과나무	t o̞ ɭ m u β w a̠ ɡ w a̠ n a̠ m u	돌무화과나무
돌아보다	t o̞ ɾ a̠ b o̞ d a̠	도라보다
돌아서다	t o̞ ɾ a̠ sʰ ʌ̹ d a̠	도라서다
돌출	t o̞ ʎ t͡ɕʰ u ɭ	돌출
돌파되다	t o̞ ɭ pʰ a̠ d w e̞ d a̠	돌파되다
돌파하다	t o̞ ɭ pʰ a̠ ɦ a̠ d a̠	돌파하다
돐	t o̞ ɭ	돌
돔발상어	t o̞ m b a̠ ɭ sʰ a̠ ŋ ʌ̹	돔발상어
동	t o̞ ŋ	동
동거하다	t o̞ ŋ ɡ ʌ̹ ɦ a̠ d a̠	동거하다
동경하다	t o̞ː ŋ ɡ j ʌ̹ ŋ ɦ a̠ d a̠	동경하다
동계	t o̞ ŋ ɡ j e̞	동계
동궁	t o̞ ŋ ɡ u ŋ	동궁
동그랗다	t o̞ ŋ ɡ ɯ ɾ a̠ tʰ a̠	동그라타
동글동글	t o̞ ŋ ɡ ɯ ɭ d o̞ ŋ ɡ ɯ ɭ	동글동글
동녘	t o̞ ŋ ɲ ʌ̹ k̚	동넉
동독	t o̞ ŋ d o̞ k̚	동독
동등하다	t o̞ ŋ d ɯ ŋ ɦ a̠ d a̠	동등하다
동명사	t o̞ː ŋ m j ʌ̹ ŋ sʰ a̠	동명사
동명인	t o̞ ŋ m j ʌ̹ ŋ i n	동명인
동박꽃	t o̞ ŋ b a̠ k̚ k͈ o̞ t̚	동박꼳
동봉하다	t o̞ ŋ b o̞ ŋ ɦ a̠ d a̠	동봉하다
동북아	t o̞ ŋ b u ɡ a̠	동부가
동사하다	t o̞ː ŋ sʰ a̠ ɦ a̠ d a̠	동사하다
동상이몽	t o̞ ŋ sʰ a̠ ŋ i m o̞ ŋ	동상이몽
동서고금	t o̞ ŋ sʰ ʌ̹ ɡ o̞ ɡ ɯ m	동서고금
동성혼	t o̞ ŋ sʰ ʌ̹ ŋ β o̞ n	동성혼
동양학	t o̞ ŋ j a̠ ŋ ɦ a̠ k̚	동양학
동역학	t o̞ː ŋ ɲ ʌ̹ kʰ a̠ k̚	동너칵
동영상	t o̞ː ŋ ɲ ʌ̹ ŋ sʰ a̠ ŋ	동넝상
동원	t o̞ː ŋ w ʌ̹ n	동원
동원령	t o̞ː ŋ w ʌ̹ n ɲ ʌ̹ ŋ	동원넝
동음이의어	t o̞ ŋ ɯ m i ɰ i ʌ̹	동으미의어
동의하다	t o̞ ŋ ɰ i ɦ a̠ d a̠	동의하다
동자	t o̞ ŋ d͡ʑ a̠	동자
동작하다	t o̞ː ŋ d͡ʑ a̠ kʰ a̠ d a̠	동자카다
동정남	t o̞ː ŋ d͡ʑ ʌ̹ ŋ n a̠ m	동정남
동정녀	t o̞ː ŋ d͡ʑ ʌ̹ ŋ ɲ ʌ̹	동정너
동향	t o̞ː ŋ ʝ a̠ ŋ	동항
돛	t o̞ t̚	돋
되	t w e̞	되
되갈다	t w e̞ ɡ a̠ ɭ d a̠	되갈다
되감다	t w e̞ ɡ a̠ m t͈ a̠	되감따
되강오리	t w e̞ː ɡ a̠ ŋ o̞ ɾ i	되강오리
되뇌다	t w e̞ n w e̞ d a̠	되뇌다
되돌리다	t w e̞ d o̞ ʎ ʎ i d a̠	되돌리다
되살다	t w e̞ sʰ a̠ ɭ d a̠	되살다
되살리다	t w e̞ sʰ a̠ ʎ ʎ i d a̠	되살리다
되야지	t w e̞ j a̠ d͡ʑ i	되야지
되어	t w e̞ ʌ̹	되어
되지빠귀	t w e̞ː d͡ʑ i p͈ a̠ ɡ ɥ i	되지빠귀
된시옷	t w e̞ː n ɕʰ i o̞ t̚	된시옫
된지읒	t w e̞ ɲ d͡ʑ i ɯ t̚	된지읃
됭경모치	t w e̞ ŋ ɡ j ʌ̹ ŋ m o̞ t͡ɕʰ i	됭경모치
두	t uː	두
두덩	t u d ʌ̹ ŋ	두덩
두레	t u ɾ e̞	두레
두려워하다	t u ɾ j ʌ̹ w ʌ̹ ɦ a̠ d a̠	두려워하다
두루	t u ɾ u	두루
두루마기	t u ɾ u m a̠ ɡ i	두루마기
두루마리	t u ɾ u m a̠ ɾ i	두루마리
두루바리	t u ɾ u b a̠ ɾ i	두루바리
두릅	t u ɾ ɯ p̚	두릅
두릅나무	t u ɾ ɯ m n a̠ m u	두름나무
두리안	t u ɾ i a̠ n	두리안
두만가시고기	t u m a̠ n ɡ a̠ ɕʰ i ɡ o̞ ɡ i	두만가시고기
두문자	t u m u ɲ t͡ɕ͈ a̠	두문짜
두샨베	t u ɕʰ a̠ n b e̞	두산베
두셋	t u sʰ e̞ t̚	두섿
두어서넛	t u ʌ̹ sʰ ʌ̹ n ʌ̹ t̚	두어서넏
두절되다	t u d͡ʑ ʌ̹ ɭ d w e̞ d a̠	두절되다
두절하다	t u d͡ʑ ʌ̹ ɾ ɦ a̠ d a̠	두절하다
두티다	t u tʰ i d a̠	두티다
둑	t u k̚	둑
둔	t uː n	둔
둔갑	t uː n ɡ a̠ p̚	둔갑
둔갑법	t uː n ɡ a̠ p̚ p͈ ʌ̹ p̚	둔갑뻡
둔하다	t uː n ɦ a̠ d a̠	둔하다
둘	t uː ɭ	둘
둘레	t u ɭ ɭ e̞	둘레
둥간어	t u ŋ ɡ a̠ n ʌ̹	둥가너
둥글다	t u ŋ ɡ ɯ ɭ d a̠	둥글다
뒤	t ɥ iː	뒤
뒤꿈치	t ɥ i k͈ u m t͡ɕʰ i	뒤꿈치
뒤따르다	t ɥ iː t͈ a̠ ɾ ɯ d a̠	뒤따르다
뒤떨어지다	t ɥ iː t͈ ʌ̹ ɾ ʌ̹ d͡ʑ i d a̠	뒤떠러지다
뒤섞다	t ɥ i sʰ ʌ̹ k̚ t͈ a̠	뒤석따
뒤영벌	t ɥ i j ʌ̹ ŋ b ʌ̹ ɭ	뒤영벌
뒤쥐	t ɥ i d͡ʑ ɥ i	뒤쥐
뒷맛	t ɥ i n m a̠ t̚	뒨맏
뒷문	t ɥ iː n m u n	뒨문
뒷북	t ɥ i t̚ p͈ u k̚	뒫뿍
뒹굴다	t ɥ i ŋ ɡ u ɭ d a̠	뒹굴다
드가다	t ɯ ɡ a̠ d a̠	드가다
드뎌	t ɯ d j ʌ̹	드뎌
드라이기	t ɯ ɾ a̠ i ɡ i	드라이기
드러나다	t ɯ ɾ ʌ̹ n a̠ d a̠	드러나다
드렁허리	t ɯ ɾ ʌ̹ ŋ ɦ ʌ̹ ɾ i	드렁허리
드론	t ɯ ɾ o̞ n	드론
드르렁드르렁	t ɯ ɾ ɯ ɾ ʌ̹ ŋ d ɯ ɾ ɯ ɾ ʌ̹ ŋ	드르렁드르렁
드리다	t ɯ ɾ i d a̠	드리다
드리우다	t ɯ ɾ i u d a̠	드리우다
드링크	t ɯ ɾ i ŋ k x ɯ	드링크
드시다	t ɯ ɕʰ i d a̠	드시다
득	t ɯ k̚	득
득남하다	t ɯ ŋ n a̠ m ɦ a̠ d a̠	등남하다
득녀하다	t ɯ ŋ ɲ ʌ̹ ɦ a̠ d a̠	등너하다
득도	t ɯ k̚ t͈ o̞	득또
득도하다	t ɯ k̚ t͈ o̞ ɦ a̠ d a̠	득또하다
득의양양	t ɯ ɡ ɰ i j a̠ ŋ j a̠ ŋ	드긔양양
득의양양하다	t ɯ ɡ ɰ i j a̠ ŋ j a̠ ŋ ɦ a̠ d a̠	드긔양양하다
득점판	t ɯ k̚ t͡ɕ͈ ʌ̹ m pʰ a̠ n	득쩜판
득템	t ɯ k̚ tʰ e̞ m	득템
든	t ɯ n	든
들	t ɯː ɭ	들
들뜨다	t ɯ ɭ t͈ ɯ d a̠	들뜨다
들려오다	t ɯ ʎ ʎ ʌ̹ o̞ d a̠	들러오다
들리다	t ɯ ʎ ʎ i d a̠	들리다
들어올리다	t ɯ ɾ ʌ̹ o̞ ʎ ʎ i d a̠	드러올리다
들이마시다	t ɯ ɾ i m a̠ ɕʰ i d a̠	드리마시다
들이밀다	t ɯ ɾ i m i ɭ d a̠	드리밀다
들쥐	t ɯ ʎ d͡ʑ ɥ i	들쥐
들창	t ɯ ʎ t͡ɕʰ a̠ ŋ	들창
들창코	t ɯ ʎ t͡ɕʰ a̠ ŋ kʰ o̞	들창코
들창코원숭이	t ɯ ʎ t͡ɕʰ a̠ ŋ kʰ o̞ w ʌ̹ n sʰ u ŋ i	들창코원숭이
들치기	t ɯ ʎ t͡ɕʰ i ɡ i	들치기
듯	t ɯ t̚	듣
등	t ɯ ŋ	등
등걸	t ɯ ŋ ɡ ʌ̹ ɭ	등걸
등광	t ɯ ŋ ɡ w a̠ ŋ	등광
등굣길	t ɯ ŋ ɡ j o t̚ k͈ i ɭ	등굗낄
등기우편	t ɯ ŋ ɡ i u pʰ j ʌ̹ n	등기우편
등드름	t ɯ ŋ d ɯ ɾ ɯ m	등드름
등락	t ɯ ŋ n a̠ k̚	등낙
등락하다	t ɯ ŋ n a̠ kʰ a̠ d a̠	등나카다
등록기	t ɯ ŋ n o̞ k̚ k͈ i	등녹끼
등록하다	t ɯ ŋ n o̞ kʰ a̠ d a̠	등노카다
등롱	t ɯ ŋ n o̞ ŋ	등농
등산로	t ɯ ŋ sʰ a̠ n n o̞	등산노
등산하다	t ɯ ŋ sʰ a̠ n ɦ a̠ d a̠	등산하다
등송	t ɯ ŋ sʰ o̞ ŋ	등송
등송하다	t ɯ ŋ sʰ o̞ ŋ ɦ a̠ d a̠	등송하다
등식	t ɯ ŋ ɕʰ i k̚	등식
등잔	t ɯ ŋ d͡ʑ a̠ n	등잔
등장하다	t ɯ ŋ d͡ʑ a̠ ŋ ɦ a̠ d a̠	등장하다
등줄쥐	t ɯ ŋ d͡ʑ u ʎ d͡ʑ ɥ i	등줄쥐
등피	t ɯ ŋ pʰ i	등피
등허리	t ɯ ŋ ɦ ʌ̹ ɾ i	등허리
디	t i	디
디스프로슘	t i sʰ ɯ pʰ ɯ ɾ o̞ ɕʰ u m	디스프로숨
딜	t i ɭ	딜
딜리	t i ʎ ʎ i	딜리
딥톡	t i p̚ tʰ o̞ k̚	딥톡
딮	t i p̚	딥
따	t͈ a̠	따
따깐	t͈ a̠ k͈ a̠ n	따깐
따라오다	t͈ a̠ ɾ a̠ o̞ d a̠	따라오다
따오다	t͈ a̠ o̞ d a̠	따오다
딱	t͈ a̠ k̚	딱
딱다그르르딱다그르르하다	t͈ a̠ k̚ t͈ a̠ ɡ ɯ ɾ ɯ ɾ ɯ t͈ a̠ k̚ t͈ a̠ ɡ ɯ ɾ ɯ ɾ ɯ ɦ a̠ d a̠	딱따그르르딱따그르르하다
딱따구리	t͈ a̠ k̚ t͈ a̠ ɡ u ɾ i	딱따구리
딱정그리마	t͈ a̠ k̚ t͡ɕ͈ ʌ̹ ŋ ɡ ɯ ɾ i m a̠	딱쩡그리마
딴	t͈ a̠ n	딴
딸	t͈ a̠ ɭ	딸
딸감	t͈ a̠ ɭ k͈ a̠ m	딸깜
딸딸이	t͈ a̠ ɭ t͈ a̠ ɾ i	딸따리
딸아들	t͈ a̠ ɾ a̠ d ɯ ɭ	따라들
땀	t͈ a̠ m	땀
땃쥐	t͈ a̠ t̚ t͡ɕ͈ ɥ i	딷쮜
땅	t͈ a̠ ŋ	땅
땅감	t͈ a̠ ŋ ɡ a̠ m	땅감
땅거미	t͈ a̠ ŋ k͈ ʌ̹ m i	땅꺼미
땅벌	t͈ a̠ ŋ b ʌ̹ ɭ	땅벌
땅속길	t͈ a̠ ŋ s͈ o̞ k̚ k͈ i ɭ	땅쏙낄
땅이름	t͈ a̠ ŋ i ɾ ɯ m	땅이름
땅크	t͈ a̠ ŋ k x ɯ	땅크
땅흔들림	t͈ a̠ ŋ ɣ ɯ n d ɯ ʎ ʎ i m	땅흔들림
때다	t͈ ɛː d a̠	때다
땔나무	t͈ ɛː ɭ ɭ a̠ m u	땔라무
떠나가다	t͈ ʌ̹ n a̠ ɡ a̠ d a̠	떠나가다
떠벌리다	t͈ ʌ̹ b ʌ̹ ʎ ʎ i d a̠	떠벌리다
떠올리다	t͈ ʌ̹ o̞ ʎ ʎ i d a̠	떠올리다
떡	t͈ ʌ̹ k̚	떡
떡갈나무	t͈ ʌ̹ k̚ k͈ a̠ ɭ ɭ a̠ m u	떡깔라무
떡밥	t͈ ʌ̹ k̚ p͈ a̠ p̚	떡빱
떡붕어	t͈ ʌ̹ k̚ p͈ u ŋ ʌ̹	떡뿡어
떡치다	t͈ ʌ̹ k̚ t͡ɕʰ i d a̠	떡치다
떰치	t͈ ʌ̹ m t͡ɕʰ i	떰치
떼	t͈ e̞	떼
떼아트르	t͈ e̞ a̠ tʰ ɯ ɾ ɯ	떼아트르
떼짓다	t͈ e̞ d͡ʑ i t̚ t͈ a̠	떼짇따
떽	t͈ e̞ k̚	떽
뗀노	t͈ e̞ n n o̞	뗀노
또	t͈ o̞	또
똑	t͈ o̞ k̚	똑
똘똘이	t͈ o̞ ɭ t͈ o̞ ɾ i	똘또리
똠얌	t͈ o̞ m j a̠ m	또먐
똥	t͈ o̞ ŋ	똥
똥구멍	t͈ o̞ ŋ k͈ u m ʌ̹ ŋ	똥꾸멍
똥까시	t͈ o̞ ŋ k͈ a̠ ɕʰ i	똥까시
똥남아	t͈ o̞ ŋ n a̠ m a̠	똥나마
똥싸다	t͈ o̞ ŋ s͈ a̠ d a̠	똥싸다
똥양인	t͈ o̞ ŋ j a̠ ŋ i n	똥양인
똥차	t͈ o̞ ŋ t͡ɕʰ a̠	똥차
똬리	t͈ w a̠ ɾ i	똬리
뚊	t͈ j o m	뚐
뚝뚝하다	t͈ u k̚ t͈ u kʰ a̠ d a̠	뚝뚜카다
뚧다	t͈ uː ɭ t͈ a̠	뚤따
뚫리다	t͈ u ʎ ʎ i d a̠	뚤리다
뛰르끼예	t͈ ɥ i ɾ ɯ k͈ i j e̞	뛰르끼예
뛰어넘다	t͈ ɥ i ʌ̹ n ʌ̹ m t͈ a̠	뛰어넘따
뜨거워지다	t͈ ɯ ɡ ʌ̹ w ʌ̹ d͡ʑ i d a̠	뜨거워지다
뜨락또르	t͈ ɯ ɾ a̠ k̚ t͈ o̞ ɾ ɯ	뜨락또르
뜬금없다	t͈ ɯ n ɡ ɯ m ʌ̹ p̚ t͈ a̠	뜬그멉따
뜬금포	t͈ ɯ n ɡ ɯ m pʰ o̞	뜬금포
뜬소문	t͈ ɯ n sʰ o̞ m u n	뜬소문
뜰	t͈ ɯ ɭ	뜰
뜸씨	t͈ ɯ m ɕ͈ i	뜸씨
뜸팡이	t͈ ɯ m pʰ a̠ ŋ i	뜸팡이
뜻	t͈ ɯ t̚	뜯
띄다	t͈ iː d a̠	띠다
띄우다	t͈ i u d a̠	띠우다
띠	t͈ i	띠
띠걸이	t͈ i ɡ ʌ̹ ɾ i	띠거리
띠다	t͈ iː d a̠	띠다
띠앗	t͈ i a̠ t̚	띠앋
띵띵	t͈ i ŋ t͈ i ŋ	띵띵
라	ɾ a̠	라
라그나로크	ɾ a̠ ɡ ɯ n a̠ ɾ o̞ k x ɯ	라그나로크
라마야나	ɾ a̠ m a̠ j a̠ n a̠	라마야나
라비올리	ɾ a̠ b i o̞ ʎ ʎ i	라비올리
라선특별시	ɾ a̠ sʰ ʌ̹ n tʰ ɯ k̚ p͈ j ʌ̹ ɭ ɕʰ i	라선특뼐시
라오어	ɾ a̠ o̞ ʌ̹	라오어
라이터돌	ɾ a̠ i tʰ ʌ̹ d o̞ ɭ	라이터돌
라이트세이버	ɾ a̠ i tʰ ɯ sʰ e̞ i b ʌ̹	라이트세이버
라지에타	ɾ a̠ d͡ʑ i e̞ tʰ a̠	라지에타
라지오	ɾ a̠ d͡ʑ i o̞	라지오
라찰	ɾ a̠ t͡ɕʰ a̠ ɭ	라찰
라침반	ɾ a̠ t͡ɕʰ i m b a̠ n	라침반
라켓	ɾ a̠ kʰ e̞ t̚	라켇
라크로스	ɾ a̠ k x ɯ ɾ o̞ s͈ ɯ	라크로쓰
라틴화	ɾ a̠ tʰ i n β w a̠	라틴화
락	ɾ a̠ k̚	락
락다운	ɾ a̠ k̚ t͈ a̠ u n	락따운
락사	ɾ a̠ k s͈ a̠	락싸
란	ɾ a̠ n	란
란소	ɾ a̠ n sʰ o̞	란소
란타넘	ɾ a̠ n tʰ a̠ n ʌ̹ m	란타넘
람	ɾ a̠ m	람
랍	ɾ a̠ p̚	랍
랍치	ɾ a̠ p̚ t͡ɕʰ i	랍치
랑	ɾ a̠ ŋ	랑
래빈	ɾ ɛː b i n	래빈
랭장고	ɾ ɛː ŋ d͡ʑ a̠ ŋ ɡ o̞	랭장고
량	ɾ j a̠ ŋ	량
량반	ɾ j a̠ ŋ b a̠ n	량반
량서류	ɾ j a̠ː ŋ sʰ ʌ̹ ɾ j u	량서류
량심	ɾ j a̠ ŋ ɕʰ i m	량심
러	ɾ ʌ̹	러
러닝셔츠	ɾ ʌ̹ n i ŋ ɕʰ ʌ̹ t͡ɕʰ ɯ	러닝서츠
러더포듐	ɾ ʌ̹ d ʌ̹ pʰ o̞ d j u m	러더포듐
러브샷	ɾ ʌ̹ b ɯ ɕʰ a̠ t̚	러브삳
럼	ɾ ʌ̹ m	럼
레	ɾ e̞	레
레깅스	ɾ e̞ ɡ i ŋ s͈ ɯ	레깅쓰
레늄	ɾ e̞ ɲ u m	레눔
레닌	ɾ e̞ n i n	레닌
레루	ɾ e̞ː ɾ u	레루
레모네이드	ɾ e̞ m o̞ n e̞ i d ɯ	레모네이드
레악토르	ɾ e̞ a̠ k̚ tʰ o̞ ɾ ɯ	레악토르
레오	ɾ e̞ o̞	레오
레위기	ɾ e̞ ɥ i ɡ i	레위기
레이다	ɾ e̞ i d a̠	레이다
레전드	ɾ e̞ d͡ʑ ʌ̹ n d ɯ	레전드
레코더	ɾ e̞ kʰ o̞ d ʌ̹	레코더
렌더링	ɾ e̞ n d ʌ̹ ɾ i ŋ	렌더링
려	ɾ j ʌ̹	려
려권	ɾ j ʌ̹ ɡ w ʌ̹ n	려권
려단	ɾ j ʌ̹ d a̠ n	려단
력	ɾ j ʌ̹ k̚	력
력사	ɾ j ʌ̹ k s͈ a̠	력싸
련	ɾ j ʌ̹ n	련
련방	ɾ j ʌ̹ n b a̠ ŋ	련방
련속극	ɾ j ʌ̹ n sʰ o̞ k̚ k͈ ɯ k̚	련속끅
렬도	ɾ j ʌ̹ ɭ t͈ o̞	렬또
렬차	ɾ j ʌ̹ ʎ t͡ɕʰ a̠	렬차
렴	ɾ j ʌ̹ m	렴
령	ɾ j ʌ̹ ŋ	령
령동	ɾ j ʌ̹ ŋ d o̞ ŋ	령동
령사	ɾ j ʌ̹ ŋ sʰ a̠	령사
령서	ɾ j ʌ̹ ŋ sʰ ʌ̹	령서
례	ɾ j e̞	례
례절	ɾ j e̞ d͡ʑ ʌ̹ ɭ	례절
로	ɾ o̞	로
로그아웃	ɾ o̞ ɡ ɯ a̠ u t̚	로그아욷
로동계급	ɾ o̞ d o̞ ŋ ɡ j e̞ ɡ ɯ p̚	로동계급
로동자구	ɾ o̞ d o̞ ŋ d͡ʑ a̠ ɡ u	로동자구
로듐	ɾ o̞ d j u m	로듐
로마자화	ɾ o̞ m a̠ d͡ʑ a̠ β w a̠	로마자화
로메	ɾ o̞ m e̞	로메
로베르트	ɾ o̞ b e̞ ɾ ɯ tʰ ɯ	로베르트
로비	ɾ o̞ b i	로비
로사	ɾ o̞ː sʰ a̠	로사
로선	ɾ o̞ː sʰ ʌ̹ n	로선
로씨야말	ɾ o̞ ɕ͈ i j a̠ m a̠ ɭ	로씨야말
로조	ɾ o̞ d͡ʑ o̞	로조
로천	ɾ o̞ t͡ɕʰ ʌ̹ n	로천
로케트	ɾ o̞ kʰ e̞ tʰ ɯ	로케트
로테르담	ɾ o̞ tʰ e̞ ɾ ɯ d a̠ m	로테르담
로텔레	ɾ o̞ tʰ e̞ ɭ ɭ e̞	로텔레
로티니	ɾ o̞ tʰ i n i	로티니
록	ɾ o̞ k̚	록
론	ɾ o̞ n	론
론단	ɾ o̞ n d a̠ n	론단
론문	ɾ o̞ n m u n	론문
롤	ɾ o̞ ɭ	롤
롬곡	ɾ o̞ m ɡ o̞ k̚	롬곡
롯	ɾ o̞ t̚	롣
롱담	ɾ o̞ː ŋ d a̠ m	롱담
뢰	ɾ w e̞	뢰
뢴트게늄	ɾ w e̞ n tʰ ɯ ɡ e̞ ɲ u m	뢴트게눔
료금	ɾ j oː ɡ ɯ m	료금
료리	ɾ j o ɾ i	료리
료리사	ɾ j o ɾ i sʰ a̠	료리사
료리하다	ɾ j o ɾ i ɦ a̠ d a̠	료리하다
룡	ɾ j o ŋ	룡
루	ɾ u	루
루멘	ɾ u m e̞ n	루멘
루므니야	ɾ u m ɯ n i j a̠	루므니야
루바슈카	ɾ u b a̠ ɕʰ u kʰ a̠	루바수카
루비	ɾ u b i	루비
루비듐	ɾ u b i d j u m	루비듐
루시퍼	ɾ u ɕʰ i pʰ ʌ̹	루시퍼
루안다	ɾ u a̠ n d a̠	루안다
루이	ɾ u i	루이
루이스	ɾ u i sʰ ɯ	루이스
루이지아나	ɾ u i d͡ʑ i a̠ n a̠	루이지아나
루페	ɾ u pʰ e̞	루페
룩	ɾ u k̚	룩
룸메이트	ɾ u m m e̞ i tʰ ɯ	룸메이트
류	ɾ j uː	류
류블랴나	ɾ j u b ɯ ʎ ʎ a̠ n a̠	류블라나
류혈	ɾ j u ʝ ʌ̹ ɭ	류헐
류형	ɾ j uː ʝ ʌ̹ ŋ	류헝
륙	ɾ j u k̚	륙
륙군	ɾ j u k̚ k͈ u n	륙꾼
륙십	ɾ j u k ɕ͈ i p̚	륙씹
륙진방언	ɾ j u k̚ t͡ɕ͈ i n b a̠ ŋ ʌ̹ n	륙찐방언
리	ɾ i	리
리가토니	ɾ i ɡ a̠ tʰ o̞ n i	리가토니
리두	ɾ iː d u	리두
리똬	ɾ i t͈ w a̠	리똬
리모넨	ɾ i m o̞ n e̞ n	리모넨
리브르빌	ɾ i b ɯ ɾ ɯ b i ɭ	리브르빌
리비도	ɾ i b i d o̞	리비도
리사이틀	ɾ i sʰ a̠ i tʰ ɯ ɭ	리사이틀
리을	ɾ i ɯ ɭ	리을
리자이나	ɾ i d͡ʑ a̠ i n a̠	리자이나
리투아니아어	ɾ i tʰ u a̠ n i a̠ ʌ̹	리투아니아어
린우드	ɾ i n u d ɯ	리누드
릴	ɾ i ɭ	릴
릴롱궤	ɾ i ɭ ɭ o̞ ŋ ɡ w e̞	릴롱궤
림	ɾ i m	림
립법	ɾ i p̚ p͈ ʌ̹ p̚	립뻡
립자	ɾ i p̚ t͡ɕ͈ a̠	립짜
링	ɾ i ŋ	링
마	m a̠	마
마감	m a̠ ɡ a̠ m	마감
마고	m a̠ ɡ o̞	마고
마고자	m a̠ː ɡ o̞ d͡ʑ a̠	마고자
마귀상어	m a̠ ɡ ɥ i sʰ a̠ ŋ ʌ̹	마귀상어
마귀할멈	m a̠ ɡ ɥ i ɦ a̠ ɭ m ʌ̹ m	마귀할멈
마노	m a̠ n o̞	마노
마누	m a̠ n u	마누
마니교	m a̠ n i ɡ j o	마니교
마니토바	m a̠ n i tʰ o̞ b a̠	마니토바
마님	m a̠ː n i m	마님
마당너구리	m a̠ d a̠ ŋ n ʌ̹ ɡ u ɾ i	마당너구리
마두금	m a̠ d u ɡ ɯ m	마두금
마련되다	m a̠ ɾ j ʌ̹ n d w e̞ d a̠	마련되다
마렵다	m a̠ ɾ j ʌ̹ p̚ t͈ a̠	마렵따
마르다	m a̠ ɾ ɯ d a̠	마르다
마른	m a̠ ɾ ɯ n	마른
마리아주	m a̠ ɾ i a̠ d͡ʑ u	마리아주
마리후아나	m a̠ ɾ i β u a̠ n a̠	마리후아나
마립간	m a̠ ɾ i p̚ k͈ a̠ n	마립깐
마마보이	m a̠ m a̠ b o̞ i	마마보이
마멀레이드	m a̠ m ʌ̹ ɭ ɭ e̞ i d ɯ	마멀레이드
마무리하다	m a̠ m u ɾ i ɦ a̠ d a̠	마무리하다
마사지하다	m a̠ sʰ a̠ d͡ʑ i ɦ a̠ d a̠	마사지하다
마선	m a̠ sʰ ʌ̹ n	마선
마세루	m a̠ sʰ e̞ ɾ u	마세루
마시나	m a̠ ɕʰ i n a̠	마시나
마실	m a̠ ɕʰ i ɭ	마실
마우자	m a̠ u d͡ʑ a̠	마우자
마육	m a̠ː j u k̚	마육
마음껏	m a̠ ɯ m k͈ ʌ̹ t̚	마음껃
마음성	m a̠ ɯ m s͈ ʌ̹ ŋ	마음썽
마음쓰다	m a̠ ɯ m s͈ ɯ d a̠	마음쓰다
마이크로버스	m a̠ i k x ɯ ɾ o̞ b ʌ̹ sʰ ɯ	마이크로버스
마이크로프로세서	m a̠ i k x ɯ ɾ o̞ pʰ ɯ ɾ o̞ s͈ e̞ s͈ ʌ̹	마이크로프로쎄써
마이트너륨	m a̠ i tʰ ɯ n ʌ̹ ɾ j u m	마이트너륨
마인어	m a̠ː i n ʌ̹	마이너
마쟈르	m a̠ d͡ʑ a̠ ɾ ɯ	마자르
마저	m a̠ d͡ʑ ʌ̹	마저
마주치다	m a̠ d͡ʑ u t͡ɕʰ i d a̠	마주치다
마중하다	m a̠ d͡ʑ u ŋ ɦ a̠ d a̠	마중하다
마찰되다	m a̠ t͡ɕʰ a̠ ɭ d w e̞ d a̠	마찰되다
마찰하다	m a̠ t͡ɕʰ a̠ ɾ ɦ a̠ d a̠	마찰하다
마취약	m a̠ t͡ɕʰ ɥ i j a̠ k̚	마취약
마취제	m a̠ t͡ɕʰ ɥ i d͡ʑ e̞	마취제
마치다	m a̠ t͡ɕʰ i d a̠	마치다
마케도니아어	m a̠ kʰ e̞ d o̞ n i a̠ ʌ̹	마케도니아어
마티아	m a̠ tʰ i a̠	마티아
마파두부	m a̠ pʰ a̠ d u b u	마파두부
마파람	m a̠ pʰ a̠ ɾ a̠ m	마파람
마포	m a̠ pʰ o̞	마포
마하	m a̠ ɦ a̠	마하
마한	m a̠ː ɦ a̠ n	마한
막	m a̠ k̚	막
막돌	m a̠ k̚ t͈ o̞ ɭ	막똘
막상	m a̠ k s͈ a̠ ŋ	막쌍
만	m a̠ n	만
만국기	m a̠ː n ɡ u k̚ k͈ i	만국끼
만두국	m a̠ n d u k͈ u k̚	만두꾹
만루	m a̠ː ɭ ɭ u	말루
만리화	m a̠ ʎ ʎ i β w a̠	말리화
만만세	m a̠ː n m a̠ n sʰ e̞	만만세
만만하다	m a̠ n m a̠ n ɦ a̠ d a̠	만만하다
만발하다	m a̠ː n b a̠ ɾ ɦ a̠ d a̠	만발하다
만성적	m a̠ n sʰ ʌ̹ ŋ t͡ɕ͈ ʌ̹ k̚	만성쩍
만수르	m a̠ n s͈ u ɾ ɯ	만쑤르
만신	m a̠ː n ɕʰ i n	만신
만신창이	m a̠ː n ɕʰ i ɲ t͡ɕʰ a̠ ŋ i	만신창이
만억	m a̠ː n ʌ̹ k̚	마넉
만연체	m a̠ ɲ ʌ̹ ɲ t͡ɕʰ e̞	마넌체
만연하다	m a̠ ɲ ʌ̹ n ɦ a̠ d a̠	마넌하다
만엽집	m a̠ː ɲ ʌ̹ p̚ t͡ɕ͈ i p̚	마넙찝
만우절	m a̠ː n u d͡ʑ ʌ̹ ɭ	마누절
만유하다	m a̠ː ɲ u ɦ a̠ d a̠	마누하다
만이	m a̠ n i	마니
만장일치	m a̠ː ɲ d͡ʑ a̠ ŋ i ʎ t͡ɕʰ i	만장일치
만족하다	m a̠ ɲ d͡ʑ o̞ kʰ a̠ d a̠	만조카다
만주어	m a̠ ɲ d͡ʑ u ʌ̹	만주어
만포	m a̠ː n pʰ o̞	만포
만포장이다	m a̠ n pʰ o̞ d͡ʑ a̠ ŋ i d a̠	만포장이다
만화영화	m a̠ː n β w a̠ j ʌ̹ ŋ β w a̠	만화영화
만회	m a̠ n β w e̞	만회
만회되다	m a̠ n β w e̞ d w e̞ d a̠	만회되다
만회하다	m a̠ n β w e̞ ɦ a̠ d a̠	만회하다
말	m a̠ ɭ	말
말갛다	m a̠ː ɭ ɡ a̠ tʰ a̠	말가타
말거머리	m a̠ ɭ ɡ ʌ̹ m ʌ̹ ɾ i	말거머리
말다	m a̠ ɭ d a̠	말다
말똥구리	m a̠ ɭ t͈ o̞ ŋ ɡ u ɾ i	말똥구리
말라빠지다	m a̠ ɭ ɭ a̠ p͈ a̠ d͡ʑ i d a̠	말라빠지다
말레이	m a̠ ɭ ɭ e̞ i	말레이
말리다	m a̠ ʎ ʎ i d a̠	말리다
말미암다	m a̠ ɭ m i a̠ m t͈ a̠	말미암따
말뿌리	m a̠ː ɭ p͈ u ɾ i	말뿌리
말씨	m a̠ː ɭ ɕ͈ i	말씨
말차	m a̠ ʎ t͡ɕʰ a̠	말차
말코손바닥사슴	m a̠ ɭ kʰ o̞ sʰ o̞ n b a̠ d a̠ k s͈ a̠ sʰ ɯ m	말코손바닥싸슴
말투	m a̠ː ɭ tʰ u	말투
맘	m a̠ː m	맘
맘마	m a̠ m m a̠	맘마
맘마통	m a̠ m m a̠ tʰ o̞ ŋ	맘마통
맘속	m a̠ː m s͈ o̞ k̚	맘쏙
맘카페	m a̠ m kʰ a̠ pʰ e̞	맘카페
맙소사	m a̠ː p s͈ o̞ sʰ a̠	맙쏘사
맛	m a̠ t̚	맏
망	m a̠ ŋ	망
망나니	m a̠ ŋ n a̠ n i	망나니
망루	m a̠ː ŋ n u	망누
망신	m a̠ ŋ ɕʰ i n	망신
망아지	m a̠ ŋ a̠ d͡ʑ i	망아지
망연	m a̠ ŋ j ʌ̹ n	망연
망연하다	m a̠ ŋ j ʌ̹ n ɦ a̠ d a̠	망연하다
망울	m a̠ ŋ u ɭ	망울
망초	m a̠ ŋ t͡ɕʰ o̞	망초
맞이하다	m a̠ d͡ʑ i ɦ a̠ d a̠	마지하다
매	m ɛː	매
매달다	m ɛː d a̠ ɭ d a̠	매달다
매도	m ɛː d o̞	매도
매도하다	m ɛː d o̞ ɦ a̠ d a̠	매도하다
매물	m ɛː m u ɭ	매물
매음굴	m ɛː ɯ m ɡ u ɭ	매음굴
매이다	m ɛː i d a̠	매이다
맨	m ɛː n	맨
맹비난하다	m ɛː ŋ b i n a̠ n ɦ a̠ d a̠	맹비난하다
맹세하다	m ɛː ŋ sʰ e̞ ɦ a̠ d a̠	맹세하다
먄	m j a̠ː n	먄
머가리	m ʌ̹ ɡ a̠ ɾ i	머가리
머구	m ʌ̹ ɡ u	머구
머금다	m ʌ̹ ɡ ɯ m t͈ a̠	머금따
머리글	m ʌ̹ ɾ i ɡ ɯ ɭ	머리글
머리끝	m ʌ̹ ɾ i k͈ ɯ t̚	머리끋
머리맡	m ʌ̹ ɾ i m a̠ t̚	머리맏
머리하다	m ʌ̹ ɾ i ɦ a̠ d a̠	머리하다
머릿결	m ʌ̹ ɾ i t̚ k͈ j ʌ̹ ɭ	머릳껼
머신	m ʌ̹ ɕʰ i n	머신
머위	m ʌ̹ ɥ i	머위
머전	m ʌ̹ d͡ʑ ʌ̹ n	머전
머플러	m ʌ̹ pʰ ɯ ɭ ɭ ʌ̹	머플러
머피	m ʌ̹ pʰ i	머피
먹	m ʌ̹ k̚	먹
먹기	m ʌ̹ k̚ k͈ i	먹끼
먹방	m ʌ̹ k̚ p͈ a̠ ŋ	먹빵
먹사	m ʌ̹ k s͈ a̠	먹싸
먹이그물	m ʌ̹ ɡ i ɡ ɯ m u ɭ	머기그물
먼데기	m ʌ̹ n d e̞ ɡ i	먼데기
먼점	m ʌ̹ ɲ d͡ʑ ʌ̹ m	먼점
멈춤	m ʌ̹ m t͡ɕʰ u m	멈춤
멈칫	m ʌ̹ m t͡ɕʰ i t̚	멈칟
멋	m ʌ̹ t̚	먿
멍게	m ʌ̹ ŋ ɡ e̞	멍게
멍멍	m ʌ̹ ŋ m ʌ̹ ŋ	멍멍
멎다	m ʌ̹ t̚ t͈ a̠	먿따
메	m e̞	메
메기다	m e̞ ɡ i d a̠	메기다
메꽃	m e̞ k͈ o̞ t̚	메꼳
메노라	m e̞ n o̞ ɾ a̠	메노라
메다	m e̞ d a̠	메다
메디케어	m e̞ d i kʰ e̞ ʌ̹	메디케어
메르헨	m e̞ ɾ ɯ ɦ e̞ n	메르헨
메쏘드	m e̞ s͈ o̞ d ɯ	메쏘드
메이	m e̞ i	메이
메이크업	m e̞ i k x ɯ ʌ̹ p̚	메이크업
메인	m e̞ i n	메인
메인트	m e̞ i n tʰ ɯ	메인트
메주	m e̞ d͡ʑ u	메주
메추라기	m e̞ t͡ɕʰ u ɾ a̠ ɡ i	메추라기
메탐페타민	m e̞ tʰ a̠ m pʰ e̞ tʰ a̠ m i n	메탐페타민
메테인	m e̞ tʰ e̞ i n	메테인
멕이다	m e̞ ɡ i d a̠	메기다
멘델레븀	m e̞ n d e̞ ɭ ɭ e̞ b j u m	멘델레븀
멘붕	m e̞ n b u ŋ	멘붕
멜번	m e̞ ɭ b ʌ̹ n	멜번
멥쌀	m e̞ p s͈ a̠ ɭ	멥쌀
멧도요	m e̞ t̚ t͈ o̞ j o	멛또요
멧박쥐	m e̞ t̚ p͈ a̠ k̚ t͡ɕ͈ ɥ i	멛빡쮜
멧밭쥐	m e̞ t̚ p͈ a̠ t̚ t͡ɕ͈ ɥ i	멛빧쮜
멧비둘기	m e̞ t̚ p͈ i d u ɭ ɡ i	멛삐둘기
멧토끼	m e̞ t̚ tʰ o̞ k͈ i	멛토끼
멩이	m e̞ ŋ i	멩이
멱	m j ʌ̹ k̚	멱
멱자구	m j ʌ̹ k̚ t͡ɕ͈ a̠ ɡ u	멱짜구
면	m j ʌ̹ n	면
면들레	m j ʌ̹ n d ɯ ɭ ɭ e̞	면들레
면사	m j ʌ̹ n sʰ a̠	면사
면실유	m j ʌ̹ n ɕʰ i ɾ j u	면시류
면양	m j ʌ̹ ɲ a̠ ŋ	며낭
면포	m j ʌ̹ n pʰ o̞	면포
멸	m j ʌ̹ ɭ	멸
명	m j ʌ̹ ŋ	명
명금	m j ʌ̹ ŋ ɡ ɯ m	명금
명료	m j ʌ̹ ŋ ɲ o	명뇨
명료하다	m j ʌ̹ ŋ ɲ o ɦ a̠ d a̠	명뇨하다
명민하다	m j ʌ̹ ŋ m i n ɦ a̠ d a̠	명민하다
명분	m j ʌ̹ ŋ b u n	명분
명사화	m j ʌ̹ ŋ sʰ a̠ β w a̠	명사화
명아주	m j ʌ̹ ŋ a̠ d͡ʑ u	명아주
명자	m j ʌ̹ ŋ t͡ɕ͈ a̠	명짜
명자나무	m j ʌ̹ ŋ d͡ʑ a̠ n a̠ m u	명자나무
명조	m j ʌ̹ ŋ d͡ʑ o̞	명조
명조체	m j ʌ̹ ŋ d͡ʑ o̞ t͡ɕʰ e̞	명조체
명창	m j ʌ̹ ŋ t͡ɕʰ a̠ ŋ	명창
명철	m j ʌ̹ ŋ t͡ɕʰ ʌ̹ ɭ	명철
명철하다	m j ʌ̹ ŋ t͡ɕʰ ʌ̹ ɾ ɦ a̠ d a̠	명철하다
몇	m j ʌ̹ t̚	멷
몌별	m j e̞ b j ʌ̹ ɭ	몌별
모	m o̞	모
모감주나무	m o̞ ɡ a̠ m d͡ʑ u n a̠ m u	모감주나무
모냥	m o̞ ɲ a̠ ŋ	모낭
모녀	m o̞ː ɲ ʌ̹	모너
모다	m o̞ː d a̠	모다
모둠	m o̞ d u m	모둠
모르폴린	m o̞ ɾ ɯ pʰ o̞ ʎ ʎ i n	모르폴린
모밀잣밤나무	m o̞ m i ʎ d͡ʑ a̠ t̚ p͈ a̠ m n a̠ m u	모밀잗빰나무
모반	m o̞ː b a̠ n	모반
모방하다	m o̞ b a̠ ŋ ɦ a̠ d a̠	모방하다
모범	m o̞ b ʌ̹ m	모범
모살	m o̞ sʰ a̠ ɭ	모살
모세	m o̞ sʰ e̞	모세
모솔	m o̞ː s͈ o̞ ɭ	모쏠
모시	m o̞ ɕʰ i	모시
모식	m o̞ ɕʰ i k̚	모식
모쏠	m o̞ː s͈ o̞ ɭ	모쏠
모욕하다	m o̞ː j o kʰ a̠ d a̠	모요카다
모용	m o̞ j o ŋ	모용
모자	m o̞ d͡ʑ a̠	모자
모자반	m o̞ d͡ʑ a̠ b a̠ n	모자반
모질다	m o̞ː d͡ʑ i ɭ d a̠	모질다
모충	m o̞ t͡ɕʰ u ŋ	모충
모친	m o̞ː t͡ɕʰ i n	모친
모페드	m o̞ pʰ e̞ d ɯ	모페드
목	m o̞ k̚	목
목격하다	m o̞ k̚ k͈ j ʌ̹ kʰ a̠ d a̠	목껴카다
목금	m o̞ k̚ k͈ ɯ m	목끔
목다리	m o̞ k̚ t͈ a̠ ɾ i	목따리
목마름	m o̞ ŋ m a̠ ɾ ɯ m	몽마름
목말	m o̞ ŋ m a̠ ɭ	몽말
목면	m o̞ ŋ m j ʌ̹ n	몽면
목욕실	m o̞ ɡ j o k ɕ͈ i ɭ	모굑씰
목욕하다	m o̞ ɡ j o kʰ a̠ d a̠	모교카다
목자	m o̞ k̚ t͡ɕ͈ a̠	목짜
목적론	m o̞ k̚ t͡ɕ͈ ʌ̹ ŋ n o̞ n	목쩡논
목적어	m o̞ k̚ t͡ɕ͈ ʌ̹ ɡ ʌ̹	목쩌거
목조	m o̞ k̚ t͡ɕ͈ o̞	목쪼
목축	m o̞ k̚ t͡ɕʰ u k̚	목축
목침	m o̞ k̚ t͡ɕʰ i m	목침
목탄	m o̞ k̚ tʰ a̠ n	목탄
목통	m o̞ k̚ tʰ o̞ ŋ	목통
목포	m o̞ k̚ pʰ o̞	목포
목피	m o̞ k̚ pʰ i	목피
몫	m o̞ k̚	목
몬타나	m o̞ n tʰ a̠ n a̠	몬타나
몰	m o̞ ɭ	몰
몰다비아	m o̞ ɭ d a̠ b i a̠	몰다비아
몰락	m o̞ ɭ ɭ a̠ k̚	몰락
몰르다	m o̞ ɭ ɭ ɯ d a̠	몰르다
몰리다	m o̞ ʎ ʎ i d a̠	몰리다
몰리브데넘	m o̞ ʎ ʎ i b ɯ d e̞ n ʌ̹ m	몰리브데넘
몰약	m o̞ ɾ j a̠ k̚	모략
몰염치하다	m o̞ ɾ j ʌ̹ m t͡ɕʰ i ɦ a̠ d a̠	모렴치하다
몸	m o̞ m	몸
몸가짐	m o̞ m ɡ a̠ d͡ʑ i m	몸가짐
몸무게	m o̞ m m u ɡ e̞	몸무게
몸비누	m o̞ m b i n u	몸비누
몸빛깔	m o̞ m p͈ i t̚ k͈ a̠ ɭ	몸삗깔
몸집	m o̞ m t͡ɕ͈ i p̚	몸찝
못	m o̞ t̚	몯
못되다	m o̞ t̚ t͈ w e̞ d a̠	몯뙤다
못뽑이	m o̞ t̚ p͈ o̞ b i	몯뽀비
몽	m o̞ ŋ	몽
몽고메리	m o̞ ŋ ɡ o̞ m e̞ ɾ i	몽고메리
몽골반	m o̞ ŋ ɡ o̞ ɭ b a̠ n	몽골반
몽롱	m o̞ ŋ n o̞ ŋ	몽농
몽롱하다	m o̞ ŋ n o̞ ŋ ɦ a̠ d a̠	몽농하다
몽시리	m o̞ː ŋ ɕʰ i ɾ i	몽시리
뫼	m w e̞ː	뫼
뫼다	m w e̞ː d a̠	뫼다
묏자리	m w e̞ t̚ t͡ɕ͈ a̠ ɾ i	묃짜리
묘	m j oː	묘
묘약	m j oː j a̠ k̚	묘약
묘연	m j o j ʌ̹ n	묘연
묘연하다	m j o j ʌ̹ n ɦ a̠ d a̠	묘연하다
묘원	m j oː w ʌ̹ n	묘원
묘향산	m j oː ʝ a̠ ŋ sʰ a̠ n	묘항산
묘호	m j o β o̞	묘호
묠니르	m j o ʎ ʎ i ɾ ɯ	묠리르
무	m u	무
무교병	m u ɡ j o b j ʌ̹ ŋ	무교병
무기	m u ɡ i	무기
무꾸	m u k͈ u	무꾸
무끼	m u k͈ i	무끼
무녀	m uː ɲ ʌ̹	무너
무능력자	m u n ɯ ŋ ɲ ʌ̹ k̚ t͡ɕ͈ a̠	무능넉짜
무늬망둑	m u n i m a̠ ŋ d u k̚	무니망둑
무단	m u d a̠ n	무단
무두붉나무	m u d u b u ŋ n a̠ m u	무두붕나무
무력하다	m u ɾ j ʌ̹ kʰ a̠ d a̠	무려카다
무릎께	m u ɾ ɯ p̚ k͈ e̞	무릅께
무분별하다	m u b u n b j ʌ̹ ɾ ɦ a̠ d a̠	무분별하다
무사	m u sʰ a̠	무사
무사도	m uː sʰ a̠ d o̞	무사도
무산쇠족제비	m uː sʰ a̠ n sʰ w e̞ d͡ʑ o̞ k̚ t͡ɕ͈ e̞ b i	무산쇠족쩨비
무서워하다	m u sʰ ʌ̹ w ʌ̹ ɦ a̠ d a̠	무서워하다
무선호출기	m u sʰ ʌ̹ n β o̞ t͡ɕʰ u ɭ ɡ i	무선호출기
무수	m u sʰ u	무수
무수히	m u sʰ u ʝ i	무수히
무시	m u ɕʰ i	무시
무신	m u ɕʰ i n	무신
무신론자	m u ɕʰ i ɭ ɭ o̞ ɲ d͡ʑ a̠	무실론자
무쌍하다	m u s͈ a̠ ŋ ɦ a̠ d a̠	무쌍하다
무아	m u a̠	무아
무엇이든	m u ʌ̹ ɕʰ i d ɯ n	무어시든
무엇하다	m u ʌ̹ tʰ a̠ d a̠	무어타다
무용	m u j o ŋ	무용
무우	m u u	무우
무유	m u j u	무유
무익하다	m u i kʰ a̠ d a̠	무이카다
무인항공기	m u i n ɦ a̠ ŋ ɡ o̞ ŋ ɡ i	무인항공기
무작위	m u d͡ʑ a̠ ɡ ɥ i	무자귀
무정부	m u d͡ʑ ʌ̹ ŋ b u	무정부
무차별	m u t͡ɕʰ a̠ b j ʌ̹ ɭ	무차별
무투	m u tʰ u	무투
무화과나무	m u β w a̠ ɡ w a̠ n a̠ m u	무화과나무
무효하다	m u ʝ o ɦ a̠ d a̠	무효하다
묵	m u k̚	묵
묵고	m u k̚ k͈ o̞	묵꼬
묵납자루	m u ŋ n a̠ p̚ t͡ɕ͈ a̠ ɾ u	뭉납짜루
묵념	m u ŋ ɲ ʌ̹ m	뭉넘
묵다	m u k̚ t͈ a̠	묵따
묵살	m u k s͈ a̠ ɭ	묵쌀
묵인	m u ɡ i n	무긴
묵주	m u k̚ t͡ɕ͈ u	묵쭈
묶다	m u k̚ t͈ a̠	묵따
문	m u n	문
문경	m u n ɡ j ʌ̹ ŋ	문경
문답	m uː n d a̠ p̚	문답
문도	m u n d o̞	문도
문둥이박쥐	m u n d u ŋ i b a̠ k̚ t͡ɕ͈ ɥ i	문둥이박쮜
문드러지다	m u n d ɯ ɾ ʌ̹ d͡ʑ i d a̠	문드러지다
문묘	m u n m j o	문묘
문선	m u n sʰ ʌ̹ n	문선
문손잡이	m u n sʰ o̞ ɲ d͡ʑ a̠ b i	문손자비
문외한	m u n w e̞ ɦ a̠ n	무뇌한
문자반	m u ɲ t͡ɕ͈ a̠ b a̠ n	문짜반
문절망둑	m u ɲ d͡ʑ ʌ̹ ɭ m a̠ ŋ d u k̚	문절망둑
문지르다	m u ɲ d͡ʑ i ɾ ɯ d a̠	문지르다
문지방	m u ɲ t͡ɕ͈ i b a̠ ŋ	문찌방
문집	m u ɲ d͡ʑ i p̚	문집
문찐	m u ɲ t͡ɕ͈ i n	문찐
문천	m u ɲ t͡ɕʰ ʌ̹ n	문천
묻다	m u t̚ t͈ a̠	묻따
물	m u ɭ	물
물고기떡	m u ɭ ɡ o̞ ɡ i t͈ ʌ̹ k̚	물고기떡
물공원	m u ɭ ɡ o̞ ŋ w ʌ̹ n	물공원
물굽이	m u ɭ ɡ u b i	물구비
물꿩	m u ɭ k͈ w ʌ̹ ŋ	물꿩
물다	m u ɭ d a̠	물다
물두꺼비	m u ɭ d u k͈ ʌ̹ b i	물두꺼비
물똥	m u ɭ t͈ o̞ ŋ	물똥
물레나물	m u ɭ ɭ e̞ n a̠ m u ɭ	물레나물
물려받다	m u ʎ ʎ ʌ̹ b a̠ t̚ t͈ a̠	물러받따
물론입니다	m u ɭ ɭ o̞ n i m n i d a̠	물로님니다
물리치다	m u ʎ ʎ i t͡ɕʰ i d a̠	물리치다
물메기	m u ɭ m e̞ ɡ i	물메기
물박달나무	m u ɭ b a̠ k̚ t͈ a̠ ɭ ɭ a̠ m u	물박딸라무
물씨	m u ɭ ɕ͈ i	물씨
물어떼다	m u ɾ ʌ̹ t͈ e̞ d a̠	무러떼다
물에네르기	m u ɾ e̞ n e̞ ɾ ɯ ɡ i	무레네르기
물엿	m u ɾ j ʌ̹ t̚	무렫
물외	m u ɾ w e̞	무뢰
물음표	m u ɾ ɯ m pʰ j o	무름표
물자체	m u ʎ d͡ʑ a̠ t͡ɕʰ e̞	물자체
물타기	m u ɭ tʰ a̠ ɡ i	물타기
물텀벙이	m u ɭ tʰ ʌ̹ m b ʌ̹ ŋ i	물텀벙이
물품	m u ɭ pʰ u m	물품
뭉클하다	m u ŋ k x ɯ ɾ ɦ a̠ d a̠	뭉클하다
뭍	m u t̚	묻
뮈슬리	m ɥ i sʰ ɯ ʎ ʎ i	뮈슬리
뮤직	m j u d͡ʑ i k̚	뮤직
미	m i	미
미강유	m i ɡ a̠ ŋ j u	미강유
미국화	m i ɡ u kʰ w a̠	미구콰
미국화하다	m i ɡ u kʰ w a̠ ɦ a̠ d a̠	미구콰하다
미궁	m iː ɡ u ŋ	미궁
미기후	m i ɡ i β u	미기후
미꾸리	m i k͈ u ɾ i	미꾸리
미끄러지다	m i k͈ ɯ ɾ ʌ̹ d͡ʑ i d a̠	미끄러지다
미끄럼	m i k͈ ɯ ɾ ʌ̹ m	미끄럼
미끈망둑	m i k͈ ɯ n m a̠ ŋ d u k̚	미끈망둑
미끼샤	m i k͈ i ɕʰ a̠	미끼사
미네소타	m i n e̞ sʰ o̞ tʰ a̠	미네소타
미다	m iː d a̠	미다
미닫이문	m iː d a̠ d͡ʑ i m u n	미다지문
미동	m i d o̞ ŋ	미동
미드	m i d ɯ	미드
미러	m i ɾ ʌ̹	미러
미뢰	m i ɾ w e̞	미뢰
미류	m i ɾ j u	미류
미류하다	m i ɾ j u ɦ a̠ d a̠	미류하다
미륵보살	m i ɾ ɯ k̚ p͈ o̞ sʰ a̠ ɭ	미륵뽀살
미리견	m i ɾ i ɡ j ʌ̹ n	미리견
미미	m i m i	미미
미미하다	m i m i ɦ a̠ d a̠	미미하다
미분몫	m i b u n m o̞ k̚	미분목
미분법	m i b u n p͈ ʌ̹ p̚	미분뻡
미섭다	m i sʰ ʌ̹ p̚ t͈ a̠	미섭따
미성년	m i sʰ ʌ̹ ŋ ɲ ʌ̹ n	미성넌
미성년자	m iː sʰ ʌ̹ ŋ ɲ ʌ̹ ɲ d͡ʑ a̠	미성넌자
미시간	m i ɕʰ i ɡ a̠ n	미시간
미시건	m i ɕʰ i ɡ ʌ̹ n	미시건
미시사가	m i ɕ͈ i sʰ a̠ ɡ a̠	미씨사가
미시소가	m i ɕ͈ i sʰ o̞ ɡ a̠	미씨소가
미시소거	m i ɕ͈ i sʰ o̞ ɡ ʌ̹	미씨소거
미시시피	m i ɕ͈ i ɕʰ i pʰ i	미씨시피
미식축구	m i ɕʰ i k̚ t͡ɕʰ u k̚ k͈ u	미식축꾸
미싱	m i ɕʰ i ŋ	미싱
미싸일	m i s͈ a̠ i ɭ	미싸일
미어터지다	m i ʌ̹ tʰ ʌ̹ d͡ʑ i d a̠	미어터지다
미우	m i u	미우
미워하다	m i w ʌ̹ ɦ a̠ d a̠	미워하다
미융모	m i j u ŋ m o̞	미융모
미인계	m iː i n ɡ j e̞	미인계
미적	m i d͡ʑ ʌ̹ k̚	미적
미제	m i d͡ʑ e̞	미제
미주리	m i d͡ʑ u ɾ i	미주리
미친놈	m i t͡ɕʰ i n n o̞ m	미친놈
미크로네시아	m i k x ɯ ɾ o̞ n e̞ ɕʰ i a̠	미크로네시아
미투리	m i tʰ u ɾ i	미투리
미화	m i β w a̠	미화
미확인	m iː β w a̠ ɡ i n	미화긴
미흡하다	m iː ɣ ɯ pʰ a̠ d a̠	미흐파다
민	m i n	민
민가	m i n ɡ a̠	민가
민망초	m i n m a̠ ŋ t͡ɕʰ o̞	민망초
민물가마우지	m i n m u ɭ ɡ a̠ m a̠ u d͡ʑ i	민물가마우지
민물검정망둑	m i n m u ɭ ɡ ʌ̹ m d͡ʑ ʌ̹ ŋ m a̠ ŋ d u k̚	민물검정망둑
민사	m i n sʰ a̠	민사
민수기	m i n sʰ u ɡ i	민수기
민스크	m i n sʰ ɯ k x ɯ	민스크
민영화	m i ɲ ʌ̹ ŋ β w a̠	미넝화
민영화하다	m i ɲ ʌ̹ ŋ β w a̠ ɦ a̠ d a̠	미넝화하다
민주사회주의	m i ɲ d͡ʑ u sʰ a̠ β w e̞ d͡ʑ u ɰ i	민주사회주의
민주적	m i ɲ d͡ʑ u d͡ʑ ʌ̹ k̚	민주적
민주주의자	m i ɲ d͡ʑ u d͡ʑ u ɰ i d͡ʑ a̠	민주주의자
민폐	m i n pʰ j e̞	민폐
밀	m i ɭ	밀
밀감	m i ɭ ɡ a̠ m	밀감
밀당	m i ɭ t͈ a̠ ŋ	밀땅
밀덕	m i ɭ d ʌ̹ k̚	밀덕
밀물	m i ɭ m u ɭ	밀물
밀접하다	m i ʎ t͡ɕ͈ ʌ̹ pʰ a̠ d a̠	밀쩌파다
밀집되다	m i ʎ d͡ʑ i p̚ t͈ w e̞ d a̠	밀집뙤다
밀집하다	m i ʎ d͡ʑ i pʰ a̠ d a̠	밀지파다
밀회	m i ɾ β w e̞	밀회
밈	m i m	밈
밋밋하다	m i n m i tʰ a̠ d a̠	민미타다
및	m i t̚	믿
밑	m i t̚	믿
밑줄	m i t̚ t͡ɕ͈ u ɭ	믿쭐
밑지다	m i t̚ t͡ɕ͈ i d a̠	믿찌다
바	p a̠	바
바꼬락	p a̠ k͈ o̞ ɾ a̠ k̚	바꼬락
바꾸이다	p a̠ k͈ u i d a̠	바꾸이다
바냐	p a̠ ɲ a̠	바나
바늘꼬리도요	p a̠ n ɯ ɭ k͈ o̞ ɾ i d o̞ j o	바늘꼬리도요
바다꿩	p a̠ d a̠ k͈ w ʌ̹ ŋ	바다꿩
바다말	p a̠ d a̠ m a̠ ɭ	바다말
바다제비	p a̠ d a̠ d͡ʑ e̞ b i	바다제비
바닷길	p a̠ d a̠ t̚ k͈ i ɭ	바닫낄
바닷물고기	p a̠ d a̠ n m u ɭ ɡ o̞ ɡ i	바단물고기
바당	p a̠ d a̠ ŋ	바당
바두쯔	p a̠ d u t͡ɕ͈ ɯ	바두쯔
바듯하다	p a̠ d ɯ tʰ a̠ d a̠	바드타다
바른	p a̠ ɾ ɯ n	바른
바름감	p a̠ ɾ ɯ m ɡ a̠ m	바름감
바보스럽다	p a̠ː b o̞ sʰ ɯ ɾ ʌ̹ p̚ t͈ a̠	바보스럽따
바사삭	p a̠ sʰ a̠ sʰ a̠ k̚	바사삭
바삭	p a̠ sʰ a̠ k̚	바삭
바삭과자	p a̠ sʰ a̠ k̚ k͈ w a̠ d͡ʑ a̠	바삭꽈자
바삭바삭	p a̠ sʰ a̠ k̚ p͈ a̠ sʰ a̠ k̚	바삭빠삭
바삭바삭하다	p a̠ sʰ a̠ k̚ p͈ a̠ sʰ a̠ kʰ a̠ d a̠	바삭빠사카다
바스락	p a̠ sʰ ɯ ɾ a̠ k̚	바스락
바스스카프	p a̠ sʰ ɯ sʰ ɯ kʰ a̠ pʰ ɯ	바스스카프
바스테르	p a̠ sʰ ɯ tʰ e̞ ɾ ɯ	바스테르
바슬바슬	p a̠ sʰ ɯ ɭ b a̠ sʰ ɯ ɭ	바슬바슬
바우	p a̠ u	바우
바위담비	p a̠ ɥ i d a̠ m b i	바위담비
바위비둘기	p a̠ ɥ i b i d u ɭ ɡ i	바위비둘기
바이오폴리머	p a̠ i o̞ pʰ o̞ ʎ ʎ i m ʌ̹	바이오폴리머
바자르	p a̠ d͡ʑ a̠ ɾ ɯ	바자르
바장조	p a̠ d͡ʑ a̠ ŋ d͡ʑ o̞	바장조
바치다	p a̠ t͡ɕʰ i d a̠	바치다
바코드	p a̠ kʰ o̞ d ɯ	바코드
바퀴살	p a̠ kʰ ɥ i sʰ a̠ ɭ	바퀴살
박	p a̠ k̚	박
박ㄹ혜	p a̠ k̚ k͈ ɯ n ʝ e̞	박끈헤
박다	p a̠ k̚ t͈ a̠	박따
박달나무	p a̠ k̚ t͈ a̠ ɭ ɭ a̠ m u	박딸라무
박멸	p a̠ ŋ m j ʌ̹ ɭ	방멸
박명	p a̠ ŋ m j ʌ̹ ŋ	방명
박수하다	p a̠ k s͈ u ɦ a̠ d a̠	박쑤하다
박엽지	p a̠ ɡ j ʌ̹ p̚ t͡ɕ͈ i	바겹찌
박자	p a̠ k̚ t͡ɕ͈ a̠	박짜
밖	p a̠ k̚	박
반	p a̠ n	반
반가	p a̠ː n k͈ a̠	반까
반감	p a̠ n ɡ a̠ m	반감
반값	p a̠ n k͈ a̠ p̚	반깝
반격	p a̠ː n ɡ j ʌ̹ k̚	반격
반공일	p a̠ː n ɡ o̞ ŋ i ɭ	반공일
반기다	p a̠ n ɡ i d a̠	반기다
반다르세리베가완	p a̠ n d a̠ ɾ ɯ sʰ e̞ ɾ i b e̞ ɡ a̠ w a̠ n	반다르세리베가완
반달	p a̠ n d a̠ ɭ	반달
반달가슴곰	p a̠ː n d a̠ ɭ ɡ a̠ sʰ ɯ m ɡ o̞ m	반달가슴곰
반달리즘	p a̠ n d a̠ ʎ ʎ i d͡ʑ ɯ m	반달리즘
반동분자	p a̠ː n d o̞ ŋ b u ɲ d͡ʑ a̠	반동분자
반려견	p a̠ː ʎ ʎ ʌ̹ ɡ j ʌ̹ n	발러견
반려동물	p a̠ː ʎ ʎ ʌ̹ d o̞ ŋ m u ɭ	발러동물
반려묘	p a̠ː ʎ ʎ ʌ̹ m j o	발러묘
반려자	p a̠ː ʎ ʎ ʌ̹ d͡ʑ a̠	발러자
반려조	p a̠ː ʎ ʎ ʌ̹ d͡ʑ o̞	발러조
반미	p a̠ː n m i	반미
반시간	p a̠ n ɕʰ i ɡ a̠ n	반시간
반신반의	p a̠ː n ɕʰ i n b a̠ː n ɰ i	반신바늬
반열반	p a̠ ɲ ʌ̹ ɭ b a̠ n	바널반
반영웅	p a̠ː ɲ ʌ̹ ŋ u ŋ	바넝웅
반입자	p a̠ː n i p̚ t͡ɕ͈ a̠	바닙짜
반자동	p a̠ː ɲ d͡ʑ a̠ d o̞ ŋ	반자동
반점	p a̠ ɲ d͡ʑ ʌ̹ m	반점
반죽하다	p a̠ ɲ d͡ʑ u kʰ a̠ d a̠	반주카다
반줄	p a̠ ɲ d͡ʑ u ɭ	반줄
반증	p a̠ː ɲ d͡ʑ ɯ ŋ	반증
반침	p a̠ː ɲ t͡ɕʰ i m	반침
반하다	p a̠ː n ɦ a̠ d a̠	반하다
반항	p a̠ː n ɦ a̠ ŋ	반항
반화석	p a̠ː n β w a̠ sʰ ʌ̹ k̚	반화석
받아쓰다	p a̠ d a̠ s͈ ɯ d a̠	바다쓰다
받치다	p a̠ t̚ t͡ɕʰ i d a̠	받치다
받침법	p a̠ t̚ t͡ɕʰ i m b ʌ̹ p̚	받침법
발	p a̠ ɭ	발
발가벗다	p a̠ ɭ ɡ a̠ b ʌ̹ t̚ t͈ a̠	발가벋따
발각	p a̠ ɭ ɡ a̠ k̚	발각
발간사	p a̠ ɭ ɡ a̠ n sʰ a̠	발간사
발간하다	p a̠ ɭ ɡ a̠ n ɦ a̠ d a̠	발간하다
발갛다	p a̠ː ɭ ɡ a̠ tʰ a̠	발가타
발광	p a̠ ɭ ɡ w a̠ ŋ	발광
발급	p a̠ ɭ ɡ ɯ p̚	발급
발기다	p a̠ ɭ ɡ i d a̠	발기다
발단	p a̠ ɭ t͈ a̠ n	발딴
발뒤꿈	p a̠ ɭ t͈ ɥ i k͈ u m	발뛰꿈
발등	p a̠ ɭ t͈ ɯ ŋ	발뜽
발딱	p a̠ ɭ t͈ a̠ k̚	발딱
발랄라이카	p a̠ ɭ ɭ a̠ ɭ ɭ a̠ i kʰ a̠	발랄라이카
발문	p a̠ ɭ m u n	발문
발바리차	p a̠ː ɭ b a̠ ɾ i t͡ɕʰ a̠	발바리차
발발	p a̠ ɭ b a̠ ɭ	발발
발보이다	p a̠ ɭ b o̞ i d a̠	발보이다
발상	p a̠ ɭ s͈ a̠ ŋ	발쌍
발상하다	p a̠ ɭ s͈ a̠ ŋ ɦ a̠ d a̠	발쌍하다
발소리	p a̠ ɭ s͈ o̞ ɾ i	발쏘리
발송자	p a̠ ɭ sʰ o̞ ŋ d͡ʑ a̠	발송자
발언	p a̠ ɾ ʌ̹ n	바런
발연기	p a̠ ɾ j ʌ̹ n ɡ i	바련기
발음기관	p a̠ ɾ ɯ m ɡ i ɡ w a̠ n	바름기관
발음법	p a̠ ɾ ɯ m p͈ ʌ̹ p̚	바름뻡
발표되다	p a̠ ɭ pʰ j o d w e̞ d a̠	발표되다
발표하다	p a̠ ɭ pʰ j o ɦ a̠ d a̠	발표하다
발휘	p a̠ ɾ ɦ ɥ i	발휘
밝을녘	p a̠ ɭ ɡ ɯ ʎ ʎ ʌ̹ k̚	발글럭
밝쥐	p a̠ k̚ t͡ɕ͈ ɥ i	박쮜
밟다	p a̠ː p̚ t͈ a̠	밥따
밤	p a̠ m	밤
밤나무	p a̠ m n a̠ m u	밤나무
밤낮없이	p a̠ m n a̠ d ʌ̹ p ɕ͈ i	밤나덥씨
밤참	p a̠ m t͡ɕʰ a̠ m	밤참
밥	p a̠ p̚	밥
밥길	p a̠ p̚ k͈ i ɭ	밥낄
방	p a̠ ŋ	방
방가면	p a̠ ŋ ɡ a̠ m j ʌ̹ n	방가면
방공	p a̠ ŋ ɡ o̞ ŋ	방공
방귀뀌다	p a̠ ŋ ɡ ɥ i k͈ ɥ i d a̠	방귀뀌다
방글라데슈	p a̠ ŋ ɡ ɯ ɭ ɭ a̠ d e̞ ɕʰ u	방글라데수
방긋	p a̠ ŋ ɡ ɯ t̚	방귿
방년	p a̠ ŋ ɲ ʌ̹ n	방넌
방동사니	p a̠ ŋ d o̞ ŋ sʰ a̠ n i	방동사니
방명	p a̠ ŋ m j ʌ̹ ŋ	방명
방목하다	p a̠ː ŋ m o̞ kʰ a̠ d a̠	방모카다
방문자	p a̠ː ŋ m u ɲ d͡ʑ a̠	방문자
방사성	p a̠ː ŋ sʰ a̠ s͈ ʌ̹ ŋ	방사썽
방송하다	p a̠ː ŋ sʰ o̞ ŋ ɦ a̠ d a̠	방송하다
방수	p a̠ ŋ sʰ u	방수
방수하다	p a̠ ŋ sʰ u ɦ a̠ d a̠	방수하다
방어율	p a̠ ŋ ʌ̹ j u ɭ	방어율
방역하다	p a̠ ŋ j ʌ̹ kʰ a̠ d a̠	방여카다
방위	p a̠ ŋ ɥ i	방위
방전	p a̠ ŋ d͡ʑ ʌ̹ n	방전
방접원	p a̠ ŋ d͡ʑ ʌ̹ b w ʌ̹ n	방저붠
방종	p a̠ ŋ d͡ʑ o̞ ŋ	방종
방죽	p a̠ ŋ d͡ʑ u k̚	방죽
방추	p a̠ ŋ t͡ɕʰ u	방추
방치하다	p a̠ː ŋ t͡ɕʰ i ɦ a̠ d a̠	방치하다
방플	p a̠ː ŋ pʰ ɯ ɭ	방플
방향족	p a̠ ŋ ʝ a̠ ŋ d͡ʑ o̞ k̚	방항족
방호	p a̠ ŋ β o̞	방호
방화	p a̠ ŋ β w a̠	방화
밭	p a̠ t̚	받
밭둑	p a̠ t̚ t͈ u k̚	받뚝
밭쥐	p a̠ t̚ t͡ɕ͈ ɥ i	받쮜
배	p ɛː	배
배관	p ɛː ɡ w a̠ n	배관
배급	p ɛː ɡ ɯ p̚	배급
배달하다	p ɛː d a̠ ɾ ɦ a̠ d a̠	배달하다
배분	p ɛː b u n	배분
배분하다	p ɛː b u n ɦ a̠ d a̠	배분하다
배역	p ɛː j ʌ̹ k̚	배역
배열	p ɛː j ʌ̹ ɭ	배열
배치	p ɛː t͡ɕʰ i	배치
배후	p ɛː β u	배후
뱀	p ɛː m	뱀
뱀밥	p ɛː m b a̠ p̚	뱀밥
뱡기	p j a̠ ŋ ɡ i	뱡기
버글버글	p ʌ̹ ɡ ɯ ɭ b ʌ̹ ɡ ɯ ɭ	버글버글
버금	p ʌ̹ ɡ ɯ m	버금
버들	p ʌ̹ d ɯ ɭ	버들
버마어	p ʌ̹ m a̠ ʌ̹	버마어
버몬트	p ʌ̹ m o̞ n tʰ ɯ	버몬트
버뮤다	p ʌ̹ m j u d a̠	버뮤다
버서석	p ʌ̹ sʰ ʌ̹ sʰ ʌ̹ k̚	버서석
버석	p ʌ̹ sʰ ʌ̹ k̚	버석
버석버석	p ʌ̹ sʰ ʌ̹ k̚ p͈ ʌ̹ sʰ ʌ̹ k̚	버석뻐석
버스럭	p ʌ̹ sʰ ɯ ɾ ʌ̹ k̚	버스럭
버스럭버스럭	p ʌ̹ sʰ ɯ ɾ ʌ̹ k̚ p͈ ʌ̹ sʰ ɯ ɾ ʌ̹ k̚	버스럭뻐스럭
버스스리	p ʌ̹ sʰ ɯ sʰ ɯ ɾ i	버스스리
버슬버슬	p ʌ̹ sʰ ɯ ɭ b ʌ̹ sʰ ɯ ɭ	버슬버슬
버썩	p ʌ̹ s͈ ʌ̹ k̚	버썩
버썩버썩	p ʌ̹ s͈ ʌ̹ k̚ p͈ ʌ̹ s͈ ʌ̹ k̚	버썩뻐썩
버찌	p ʌ̹ t͡ɕ͈ i	버찌
버클륨	p ʌ̹ k x ɯ ʎ ʎ u m	버클룸
버터밀크	p ʌ̹ tʰ ʌ̹ m i ɭ k x ɯ	버터밀크
버텅	p ʌ̹ tʰ ʌ̹ ŋ	버텅
벅벅이	p ʌ̹ k̚ p͈ ʌ̹ ɡ i	벅뻐기
번	p ʌ̹ n	번
번갈다	p ʌ̹ n ɡ a̠ ɭ d a̠	번갈다
번역자	p ʌ̹ ɲ ʌ̹ k̚ t͡ɕ͈ a̠	버넉짜
번역차용	p ʌ̹ ɲ ʌ̹ k̚ t͡ɕʰ a̠ j o ŋ	버넉차용
번역체	p ʌ̹ ɲ ʌ̹ k̚ t͡ɕʰ e̞	버넉체
번역하다	p ʌ̹ ɲ ʌ̹ kʰ a̠ d a̠	버너카다
번영하다	p ʌ̹ ɲ ʌ̹ ŋ ɦ a̠ d a̠	버넝하다
번체자	p ʌ̹ ɲ t͡ɕʰ e̞ d͡ʑ a̠	번체자
번트	p͈ ʌ̹ n tʰ ɯ	뻔트
번트하다	p͈ ʌ̹ n tʰ ɯ ɦ a̠ d a̠	뻔트하다
번호판	p ʌ̹ n β o̞ pʰ a̠ n	번호판
번화	p ʌ̹ n β w a̠	번화
벌	p ʌ̹ ɭ	벌
벌거지	p ʌ̹ ɭ ɡ ʌ̹ d͡ʑ i	벌거지
벌기	p ʌ̹ ɭ ɡ i	벌기
벌기다	p ʌ̹ ɭ ɡ i d a̠	벌기다
벌주다	p ʌ̹ ʎ d͡ʑ u d a̠	벌주다
벌하다	p ʌ̹ ɾ ɦ a̠ d a̠	벌하다
범이신론	p ʌ̹ m i ɕʰ i ɭ ɭ o̞ n	버미실론
범천	p ʌ̹ m t͡ɕʰ ʌ̹ n	범천
범퍼	p ʌ̹ m pʰ ʌ̹	범퍼
법	p ʌ̹ p̚	법
법계	p ʌ̹ p̚ k͈ j e̞	법꼐
법사	p ʌ̹ p s͈ a̠	법싸
법적	p ʌ̹ p̚ t͡ɕ͈ ʌ̹ k̚	법쩍
벗기다	p ʌ̹ t̚ k͈ i d a̠	벋끼다
벗다	p ʌ̹ t̚ t͈ a̠	벋따
벗방	p ʌ̹ t̚ p͈ a̠ ŋ	벋빵
벗풀	p ʌ̹ t̚ pʰ u ɭ	벋풀
벚	p ʌ̹ t̚	벋
벚나무	p ʌ̹ n n a̠ m u	번나무
베네딕토	p e̞ n e̞ d i k̚ tʰ o̞	베네딕토
베누스	p e̞ n u sʰ ɯ	베누스
베다	p e̞ː d a̠	베다
베달	p e̞ d a̠ ɭ	베달
베드신	p e̞ d ɯ ɕ͈ i n	베드씬
베레	p e̞ ɾ e̞	베레
베레모	p e̞ ɾ e̞ m o̞	베레모
베르미첼리	p e̞ ɾ ɯ m i t͡ɕʰ e̞ ʎ ʎ i	베르미첼리
베릴륨	p e̞ ɾ i ʎ ʎ u m	베릴룸
베어링	p e̞ ʌ̹ ɾ i ŋ	베어링
베어물다	p e̞ː ʌ̹ m u ɭ d a̠	베어물다
베이비시터	p e̞ i b i ɕ͈ i tʰ ʌ̹	베이비씨터
베이스	p e̞ i s͈ ɯ	베이쓰
베프	p e̞ pʰ ɯ	베프
벤또	p e̞ n t͈ o̞	벤또
벤소	p e̞ n sʰ o̞	벤소
벤졸	p e̞ ɲ d͡ʑ o̞ ɭ	벤졸
벤토	p e̞ n tʰ o̞	벤토
벨	p e̞ ɭ	벨
벨라루스어	p e̞ ɭ ɭ a̠ ɾ u sʰ ɯ ʌ̹	벨라루스어
벨라루씨	p e̞ ɭ ɭ a̠ ɾ u ɕ͈ i	벨라루씨
벨뷰	p e̞ ɭ b j u	벨뷰
벨지끄	p e̞ ʎ d͡ʑ i k͈ ɯ	벨지끄
벨튀	p e̞ ɭ tʰ ɥ i	벨튀
벳남	p e̞ n n a̠ m	벤남
벵골어	p e̞ ŋ ɡ o̞ ɾ ʌ̹	벵고러
벼	p j ʌ̹	벼
벼루	p j ʌ̹ ɾ u	벼루
벼룩	p j ʌ̹ ɾ u k̚	벼룩
벼룩시장	p j ʌ̹ ɾ u k ɕ͈ i d͡ʑ a̠ ŋ	벼룩씨장
벼룩이자리	p j ʌ̹ ɾ u ɡ i d͡ʑ a̠ ɾ i	벼루기자리
벼르다	p j ʌ̹ ɾ ɯ d a̠	벼르다
벽	p j ʌ̹ k̚	벽
벽난로	p j ʌ̹ ŋ n a̠ ɭ ɭ o̞	병날로
벽력	p j ʌ̹ ŋ ɲ ʌ̹ k̚	병넉
벽지	p j ʌ̹ k̚ t͡ɕ͈ i	벽찌
변	p j ʌ̹ n	변
변또	p j ʌ̹ n t͈ o̞	변또
별	p j ʌ̹ ɭ	별
별장	p j ʌ̹ ʎ t͡ɕ͈ a̠ ŋ	별짱
별칭	p j ʌ̹ ʎ t͡ɕʰ i ŋ	별칭
병	p j ʌ̹ ŋ	병
병기	p j ʌ̹ ŋ ɡ i	병기
병기창	p j ʌ̹ ŋ ɡ i t͡ɕʰ a̠ ŋ	병기창
병리	p j ʌ̹ ŋ n i	병니
병먹금	p j ʌ̹ ŋ m ʌ̹ k̚ k͈ ɯ m	병먹끔
병음	p j ʌ̹ ŋ ɯ m	병음
볕	p j ʌ̹ t̚	볃
보	p o̞	보
보고자	p o̞ː ɡ o̞ d͡ʑ a̠	보고자
보관소	p o̞ː ɡ w a̠ n sʰ o̞	보관소
보관인	p o̞ː ɡ w a̠ n i n	보과닌
보관하다	p o̞ː ɡ w a̠ n ɦ a̠ d a̠	보관하다
보금자리	p o̞ ɡ ɯ m d͡ʑ a̠ ɾ i	보금자리
보꾹	p o̞ k͈ u k̚	보꾹
보도자료	p o̞ː d o̞ d͡ʑ a̠ ɾ j o	보도자료
보드게임	p o̞ d ɯ k͈ e̞ i m	보드께임
보디가드	p o̞ d i ɡ a̠ d ɯ	보디가드
보류하다	p o̞ː ɾ j u ɦ a̠ d a̠	보류하다
보르시	p o̞ ɾ ɯ ɕʰ i	보르시
보사삭보사삭	p o̞ sʰ a̠ sʰ a̠ k̚ p͈ o̞ sʰ a̠ sʰ a̠ k̚	보사삭뽀사삭
보삭	p o̞ sʰ a̠ k̚	보삭
보삭보삭	p o̞ sʰ a̠ k̚ p͈ o̞ sʰ a̠ k̚	보삭뽀삭
보수	p o̞ː sʰ u	보수
보숭이	p o̞ sʰ u ŋ i	보숭이
보스락	p o̞ sʰ ɯ ɾ a̠ k̚	보스락
보스전	p o̞ s͈ ɯ d͡ʑ ʌ̹ n	보쓰전
보싹	p o̞ s͈ a̠ k̚	보싹
보싹보싹	p o̞ s͈ a̠ k̚ p͈ o̞ s͈ a̠ k̚	보싹뽀싹
보안관	p o̞ː a̠ n ɡ w a̠ n	보안관
보양탕	p o̞ː j a̠ ŋ tʰ a̠ ŋ	보양탕
보이차	p o̞ː i t͡ɕʰ a̠	보이차
보임틀	p o̞ː i m tʰ ɯ ɭ	보임틀
보자기	p o̞ d͡ʑ a̠ ɡ i	보자기
보장하다	p o̞ː d͡ʑ a̠ ŋ ɦ a̠ d a̠	보장하다
보조사	p o̞ː d͡ʑ o̞ sʰ a̠	보조사
보증하다	p o̞ d͡ʑ ɯ ŋ ɦ a̠ d a̠	보증하다
보지하다	p o̞ː d͡ʑ i ɦ a̠ d a̠	보지하다
보청기	p o̞ː t͡ɕʰ ʌ̹ ŋ ɡ i	보청기
보체	p o̞ t͡ɕʰ e̞	보체
보충	p o̞ t͡ɕʰ u ŋ	보충
보통화	p o̞ː tʰ o̞ ŋ β w a̠	보통화
보트	p o̞ tʰ ɯ	보트
보풀	p o̞ pʰ u ɭ	보풀
보필	p o̞ː pʰ i ɭ	보필
보필하다	p o̞ː pʰ i ɾ ɦ a̠ d a̠	보필하다
보학	p o̞ː ɦ a̠ k̚	보학
보호무역	p o̞ː β o̞ m u j ʌ̹ k̚	보호무역
보호자	p o̞ː β o̞ d͡ʑ a̠	보호자
보호주의	p o̞ː β o̞ d͡ʑ u ɰ i	보호주의
복	p o̞ k̚	복
복굴절	p o̞ k̚ k͈ u ʎ d͡ʑ ʌ̹ ɭ	복꿀절
복귀	p o̞ k̚ k͈ ɥ i	복뀌
복모음	p o̞ ŋ m o̞ ɯ m	봉모음
복받치다	p o̞ k̚ p͈ a̠ t̚ t͡ɕʰ i d a̠	복빧치다
복분자	p o̞ k̚ p͈ u ɲ d͡ʑ a̠	복뿐자
복분자딸기	p o̞ k̚ p͈ u ɲ d͡ʑ a̠ t͈ a̠ ɭ ɡ i	복뿐자딸기
복붙	p o̞ k̚ p͈ u t̚	복뿓
복붙하다	p o̞ k̚ p͈ u tʰ a̠ d a̠	복뿌타다
복사나무	p o̞ k s͈ a̠ n a̠ m u	복싸나무
복사하다	p o̞ k s͈ a̠ ɦ a̠ d a̠	복싸하다
복습하다	p o̞ k s͈ ɯ pʰ a̠ d a̠	복쓰파다
복어	p o̞ ɡ ʌ̹	보거
복용량	p o̞ ɡ j o ŋ ɲ a̠ ŋ	보굥낭
복종	p o̞ k̚ t͡ɕ͈ o̞ ŋ	복쫑
복종하다	p o̞ k̚ t͡ɕ͈ o̞ ŋ ɦ a̠ d a̠	복쫑하다
복직근	p o̞ k̚ t͡ɕ͈ i k̚ k͈ ɯ n	복찍끈
복합어	p o̞ kʰ a̠ b ʌ̹	보카버
볶음	p o̞ k͈ ɯ m	보끔
볶음밥	p o̞ k͈ ɯ m b a̠ p̚	보끔밥
볶이	p o̞ k͈ i	보끼
본	p o̞ n	본
본고	p o̞ n ɡ o̞	본고
본드	p o̞ n d ɯ	본드
본디	p o̞ n d i	본디
본받다	p o̞ n b a̠ t̚ t͈ a̠	본받따
본선	p o̞ n sʰ ʌ̹ n	본선
본연	p o̞ ɲ ʌ̹ n	보넌
본음	p o̞ n ɯ m	보늠
본인	p o̞ n i n	보닌
본좌	p o̞ ɲ d͡ʑ w a̠	본좌
볼	p o̞ ɭ	볼
볼기	p o̞ː ɭ ɡ i	볼기
볼끈	p o̞ ɭ k͈ ɯ n	볼끈
볼똑	p o̞ ɭ t͈ o̞ k̚	볼똑
봄	p o̞ m	봄
봄비	p o̞ m p͈ i	봄삐
봇	p o̞ t̚	볻
봇짐	p o̞ t̚ t͡ɕ͈ i m	볻찜
봉랍	p o̞ ŋ n a̠ p̚	봉납
봉사기	p o̞ ŋ sʰ a̠ ɡ i	봉사기
봉술	p o̞ ŋ sʰ u ɭ	봉술
봐	p w a̠	봐
뵈다	p w e̞ː d a̠	뵈다
뵙다	p w e̞ː p̚ t͈ a̠	뵙따
부	p u	부
부귀영화	p uː ɡ ɥ i j ʌ̹ ŋ β w a̠	부귀영화
부그르르	p u ɡ ɯ ɾ ɯ ɾ ɯ	부그르르
부꾸미	p u k͈ u m i	부꾸미
부끄럼	p u k͈ ɯ ɾ ʌ̹ m	부끄럼
부끄부끄	p u k͈ ɯ b u k͈ ɯ	부끄부끄
부남	p u n a̠ m	부남
부녀	p u ɲ ʌ̹	부너
부녀자	p uː ɲ ʌ̹ d͡ʑ a̠	부너자
부닥치다	p u d a̠ k̚ t͡ɕʰ i d a̠	부닥치다
부덕의	p u d ʌ̹ ɡ ɰ i	부더긔
부도	p u d o̞	부도
부도덕	p u d o̞ d ʌ̹ k̚	부도덕
부도덕하다	p u d o̞ d ʌ̹ kʰ a̠ d a̠	부도더카다
부등식	p u d ɯ ŋ ɕʰ i k̚	부등식
부딪치다	p u d i t̚ t͡ɕʰ i d a̠	부딛치다
부딪히다	p u d i t͡ɕʰ i d a̠	부디치다
부뚜막	p u t͈ u m a̠ k̚	부뚜막
부러지다	p u ɾ ʌ̹ d͡ʑ i d a̠	부러지다
부럼	p u ɾ ʌ̹ m	부럼
부레	p u ɾ e̞	부레
부루퉁이	p u ɾ u tʰ u ŋ i	부루퉁이
부상	p u sʰ a̠ ŋ	부상
부상하다	p uː sʰ a̠ ŋ ɦ a̠ d a̠	부상하다
부서석부서석	p u sʰ ʌ̹ sʰ ʌ̹ k̚ p͈ u sʰ ʌ̹ sʰ ʌ̹ k̚	부서석뿌서석
부석부석	p u sʰ ʌ̹ k̚ p͈ u sʰ ʌ̹ k̚	부석뿌석
부수다	p u sʰ u d a̠	부수다
부스럭	p u sʰ ɯ ɾ ʌ̹ k̚	부스럭
부시다	p u ɕʰ i d a̠	부시다
부시리	p u ɕʰ i ɾ i	부시리
부신피질	p u ɕʰ i n pʰ i d͡ʑ i ɭ	부신피질
부양하다	p u j a̠ ŋ ɦ a̠ d a̠	부양하다
부음	p u ɯ m	부음
부인	p u i n	부인
부인과	p u i n k͈ w a̠	부인꽈
부자	p u d͡ʑ a̠	부자
부적절	p u d͡ʑ ʌ̹ k̚ t͡ɕ͈ ʌ̹ ɭ	부적쩔
부적절하다	p u d͡ʑ ʌ̹ k̚ t͡ɕ͈ ʌ̹ ɾ ɦ a̠ d a̠	부적쩔하다
부전령	p uː d͡ʑ ʌ̹ ʎ ʎ ʌ̹ ŋ	부절렁
부젓가락	p u d͡ʑ ʌ̹ t̚ k͈ a̠ ɾ a̠ k̚	부젇까락
부정	p u d͡ʑ ʌ̹ ŋ	부정
부정사	p u d͡ʑ ʌ̹ ŋ sʰ a̠	부정사
부정하다	p u d͡ʑ ʌ̹ ŋ ɦ a̠ d a̠	부정하다
부줌부라	p u d͡ʑ u m b u ɾ a̠	부줌부라
부지기수	p u d͡ʑ i ɡ i sʰ u	부지기수
부지런	p u d͡ʑ i ɾ ʌ̹ n	부지런
부지런하다	p u d͡ʑ i ɾ ʌ̹ n ɦ a̠ d a̠	부지런하다
부지불식간	p u d͡ʑ i b u ɭ ɕʰ i k̚ k͈ a̠ n	부지불식깐
부착되다	p u t͡ɕʰ a̠ k̚ t͈ w e̞ d a̠	부착뙤다
부처꽃	p u t͡ɕʰ ʌ̹ k͈ o̞ t̚	부처꼳
부총리	p u t͡ɕʰ o̞ ŋ n i	부총니
부추기다	p uː t͡ɕʰ u ɡ i d a̠	부추기다
부치	p u t͡ɕʰ i	부치
부치다	p u t͡ɕʰ i d a̠	부치다
부친	p u t͡ɕʰ i n	부친
부카티니	p u kʰ a̠ tʰ i n i	부카티니
부풀다	p u pʰ u ɭ d a̠	부풀다
부풀음감	p u pʰ u ɾ ɯ m ɡ a̠ m	부푸름감
부하	p u ɦ a̠	부하
부활주일	p uː β w a̠ ɭ t͡ɕ u i ɭ	부활주일
부흥	p uː ɣ ɯ ŋ	부흥
북	p u k̚	북
북극여우	p u k̚ k͈ ɯ ɡ j ʌ̹ u	북끄겨우
북방중고기	p u k̚ p͈ a̠ ŋ d͡ʑ u ŋ ɡ o̞ ɡ i	북빵중고기
북방토끼	p u k̚ p͈ a̠ ŋ tʰ o̞ k͈ i	북빵토끼
북벌	p u k̚ p͈ ʌ̹ ɭ	북뻘
북빙양	p u k̚ p͈ i ŋ ɲ a̠ ŋ	북삥낭
북쩡	p u k̚ t͡ɕ͈ ʌ̹ ŋ	북쩡
북풍	p u k̚ pʰ u ŋ	북풍
분	p u n	분
분광학	p u n ɡ w a̠ ŋ ɦ a̠ k̚	분광학
분납	p u n n a̠ p̚	분납
분납하다	p u n n a̠ pʰ a̠ d a̠	분나파다
분류학	p u ʎ ʎ u ɦ a̠ k̚	불루학
분만	p u n m a̠ n	분만
분방	p u n b a̠ ŋ	분방
분별	p u n b j ʌ̹ ɭ	분별
분별되다	p u n b j ʌ̹ ɭ d w e̞ d a̠	분별되다
분별하다	p u n b j ʌ̹ ɾ ɦ a̠ d a̠	분별하다
분수	p u n s͈ u	분쑤
분열	p u ɲ ʌ̹ ɭ	부널
분열하다	p u ɲ ʌ̹ ɾ ɦ a̠ d a̠	부널하다
분탕질	p u n tʰ a̠ ŋ d͡ʑ i ɭ	분탕질
분할	p u n ɦ a̠ ɭ	분할
불	p u ɭ	불
불가리아어	p u ɭ ɡ a̠ ɾ i a̠ ʌ̹	불가리아어
불가지론	p u ɭ ɡ a̠ d͡ʑ i ɾ o̞ n	불가지론
불거지다	p u ɭ ɡ ʌ̹ d͡ʑ i d a̠	불거지다
불곰	p u ɭ ɡ o̞ m	불곰
불공평	p u ɭ ɡ o̞ ŋ pʰ j ʌ̹ ŋ	불공평
불교도	p u ɭ ɡ j o d o̞	불교도
불굴	p u ɭ ɡ u ɭ	불굴
불규칙하다	p u ɭ ɡ j u t͡ɕʰ i kʰ a̠ d a̠	불규치카다
불길	p u ɭ k͈ i ɭ	불낄
불길하다	p u ɭ ɡ i ɾ ɦ a̠ d a̠	불길하다
불까다	p u ɭ k͈ a̠ d a̠	불까다
불라	p u ɭ ɭ a̠	불라
불란서	p u ɭ ɭ a̠ n sʰ ʌ̹	불란서
불란서어	p u ɭ ɭ a̠ n sʰ ʌ̹ ʌ̹	불란서어
불량자	p u ʎ ʎ a̠ ŋ d͡ʑ a̠	불랑자
불문율	p u ɭ m u n ɲ u ɭ	불문눌
불복하다	p u ɭ b o̞ kʰ a̠ d a̠	불보카다
불쌍놈	p uː ɭ s͈ a̠ ŋ n o̞ m	불쌍놈
불안정	p u ɾ a̠ ɲ d͡ʑ ʌ̹ ŋ	부란정
불알친구	p u ɾ a̠ ʎ t͡ɕʰ i n ɡ u	부랄친구
불임	p u ɾ i m	부림
불전	p u ʎ d͡ʑ ʌ̹ n	불전
불지르다	p u ʎ d͡ʑ i ɾ ɯ d a̠	불지르다
불청불탁	p u ʎ t͡ɕʰ ʌ̹ ŋ b u ɭ tʰ a̠ k̚	불청불탁
불펌	p u ɭ pʰ ʌ̹ m	불펌
불평등	p u ɭ pʰ j ʌ̹ ŋ d ɯ ŋ	불평등
불한당	p u ɾ ɦ a̠ n d a̠ ŋ	불한당
불협화음	p u ɾ ʝ ʌ̹ pʰ w a̠ ɯ m	불허퐈음
붉가시나무	p u ɭ k͈ a̠ ɕʰ i n a̠ m u	불까시나무
붉나무	p u ŋ n a̠ m u	붕나무
붉다	p u k̚ t͈ a̠	북따
붉은	p u ɭ ɡ ɯ n	불근
붉은가슴흰죽지	p u ɭ ɡ ɯ n ɡ a̠ sʰ ɯ m ʝ i ɲ d͡ʑ u k̚ t͡ɕ͈ i	불근가슴힌죽찌
붉은목지빠귀	p u ɭ ɡ ɯ n m o̞ k̚ t͡ɕ͈ i p͈ a̠ ɡ ɥ i	불근목찌빠귀
붉은부리흰죽지	p u ɭ ɡ ɯ n b u ɾ i ʝ i ɲ d͡ʑ u k̚ t͡ɕ͈ i	불근부리힌죽찌
붉은뺨가마우지	p u ɭ ɡ ɯ n p͈ j a̠ m ɡ a̠ m a̠ u d͡ʑ i	불근뺨가마우지
붉은사슴	p u ɭ ɡ ɯ n sʰ a̠ sʰ ɯ m	불근사슴
붉은오름	p u ɭ ɡ ɯ n o̞ ɾ ɯ m	불그노름
붉은피알	p u ɭ ɡ ɯ n pʰ i a̠ ɭ	불근피알
붉은피톨	p u ɭ ɡ ɯ n pʰ i tʰ o̞ ɭ	불근피톨
붐비다	p u m b i d a̠	붐비다
붓	p u t̚	붇
붓펜	p u t̚ pʰ e̞ n	붇펜
붕	p u ŋ	붕
붕가붕가	p u ŋ ɡ a̠ b u ŋ ɡ a̠	붕가붕가
붕괴	p u ŋ ɡ w e̞	붕괴
붙다	p u t̚ t͈ a̠	붇따
붙임표	p u t͡ɕʰ i m pʰ j o	부침표
붙잡다	p u t̚ t͡ɕ͈ a̠ p̚ t͈ a̠	붇짭따
붙잡히다	p u t̚ t͡ɕ͈ a̠ pʰ i d a̠	붇짜피다
뷁	p w e̞ k̚	붹
뷰	p j u	뷰
뷰테인	p j u tʰ e̞ i n	뷰테인
브라	p ɯ ɾ a̠	브라
브라자빌	p ɯ ɾ a̠ d͡ʑ a̠ b i ɭ	브라자빌
브로민	p ɯ ɾ o̞ m i n	브로민
브류쎌	p ɯ ɾ j u s͈ e̞ ɭ	브류쎌
브리지타운	p ɯ ɾ i d͡ʑ i tʰ a̠ u n	브리지타운
브리티시컬럼비아	p ɯ ɾ i tʰ i ɕʰ i kʰ ʌ̹ ɭ ɭ ʌ̹ m b i a̠	브리티시컬럼비아
블라인드	p ɯ ɭ ɭ a̠ i n d ɯ	블라인드
블로거	p ɯ ɭ ɭ o̞ ɡ ʌ̹	블로거
블록버스터	p ɯ ɭ ɭ o̞ k̚ p͈ ʌ̹ sʰ ɯ tʰ ʌ̹	블록뻐스터
블루진	p ɯ ɭ ɭ u d͡ʑ i n	블루진
블룸폰테인	p ɯ ɭ ɭ u m pʰ o̞ n tʰ e̞ i n	블룸폰테인
비	p i	비
비겁	p iː ɡ ʌ̹ p̚	비겁
비결	p i ɡ j ʌ̹ ɭ	비결
비계	p i ɡ j e̞	비계
비골리	p i ɡ o̞ ʎ ʎ i	비골리
비관	p iː ɡ w a̠ n	비관
비금비금	p i ɡ ɯ m b i ɡ ɯ m	비금비금
비김	p iː ɡ i m	비김
비끼다	p i k͈ i d a̠	비끼다
비날론	p i n a̠ ɭ ɭ o̞ n	비날론
비네거	p i n e̞ ɡ ʌ̹	비네거
비녀	p i ɲ ʌ̹	비너
비늘흰발망둑	p i n ɯ ɾ ʝ i n b a̠ ɭ m a̠ ŋ d u k̚	비늘힌발망둑
비니	p i n i	비니
비니루	p i n i ɾ u	비니루
비닉	p iː n i k̚	비닉
비단	p i d a̠ n	비단
비단잉어	p i d a̠ n i ŋ ʌ̹	비다닝어
비단털들쥐	p i d a̠ n tʰ ʌ̹ ɭ d ɯ ʎ d͡ʑ ɥ i	비단털들쥐
비단털등줄쥐	p i d a̠ n tʰ ʌ̹ ɭ d ɯ ŋ d͡ʑ u ʎ d͡ʑ ɥ i	비단털등줄쥐
비단털쥐	p i d a̠ n tʰ ʌ̹ ʎ d͡ʑ ɥ i	비단털쥐
비둘기조롱이	p i d u ɭ ɡ i d͡ʑ o̞ ɾ o̞ ŋ i	비둘기조롱이
비뚤다	p i t͈ u ɭ d a̠	비뚤다
비뚤어지다	p i t͈ u ɾ ʌ̹ d͡ʑ i d a̠	비뚜러지다
비롯하다	p i ɾ o̞ tʰ a̠ d a̠	비로타다
비루스	p i ɾ u sʰ ɯ	비루스
비르	p i ɾ ɯ	비르
비름	p i ɾ ɯ m	비름
비리다	p i ɾ i d a̠	비리다
비만	p iː m a̠ n	비만
비명	p iː m j ʌ̹ ŋ	비명
비박	p i b a̠ k̚	비박
비빔	p i b i m	비빔
비상	p i sʰ a̠ ŋ	비상
비속어	p iː sʰ o̞ ɡ ʌ̹	비소거
비스무트	p i sʰ ɯ m u tʰ ɯ	비스무트
비어	p iː ʌ̹	비어
비엔티안	p i e̞ n tʰ i a̠ n	비엔티안
비역	p i j ʌ̹ k̚	비역
비염	p iː j ʌ̹ m	비염
비옥하다	p iː o̞ kʰ a̠ d a̠	비오카다
비웃다	p iː u t̚ t͈ a̠	비욷따
비읍	p i ɯ p̚	비읍
비자나무	p i d͡ʑ a̠ n a̠ m u	비자나무
비적	p iː d͡ʑ ʌ̹ k̚	비적
비주얼노벨	p i d͡ʑ u ʌ̹ ɭ ɭ o̞ b e̞ ɭ	비주얼로벨
비참	p i t͡ɕʰ a̠ m	비참
비치다	p i t͡ɕʰ i d a̠	비치다
비틀거리다	p i tʰ ɯ ɭ ɡ ʌ̹ ɾ i d a̠	비틀거리다
비폭력	p i pʰ o̞ ŋ ɲ ʌ̹ k̚	비퐁넉
비휴	p i ʝ u	비후
빅토르	p i k̚ tʰ o̞ ɾ ɯ	빅토르
빈	p i n	빈
빈땅	p i n t͈ a̠ ŋ	빈땅
빈민굴	p i n m i n ɡ u ɭ	빈민굴
빈방	p iː n b a̠ ŋ	빈방
빈약	p i ɲ a̠ k̚	비낙
빈유	p i ɲ u	비누
빈지문	p i ɲ d͡ʑ i m u n	빈지문
빈지워칭	p i ɲ d͡ʑ i w ʌ̹ t͡ɕʰ i ŋ	빈지워칭
빈터	p iː n tʰ ʌ̹	빈터
빌다	p iː ɭ d a̠	빌다
빌리다	p i ʎ ʎ i d a̠	빌리다
빌미	p i ɭ m i	빌미
빗	p i t̚	빋
빗기다	p i t̚ k͈ i d a̠	빋끼다
빗다	p i t̚ t͈ a̠	빋따
빗치	p i t̚ t͡ɕʰ i	빋치
빙	p i ŋ	빙
빙결	p i ŋ ɡ j ʌ̹ ɭ	빙결
빙과	p i ŋ ɡ w a̠	빙과
빙글빙글	p i ŋ ɡ ɯ ɭ b i ŋ ɡ ɯ ɭ	빙글빙글
빙상무용	p i ŋ sʰ a̠ ŋ m u j o ŋ	빙상무용
빙어	p i ŋ ʌ̹	빙어
빙정	p i ŋ d͡ʑ ʌ̹ ŋ	빙정
빚	p i t̚	빋
빚음감	p i d͡ʑ ɯ m ɡ a̠ m	비즘감
빛	p i t̚	빋
빛알	p i t͡ɕʰ a̠ ɭ	비찰
빠가	p͈ a̠ ɡ a̠	빠가
빠그르르	p͈ a̠ ɡ ɯ ɾ ɯ ɾ ɯ	빠그르르
빠글빠글	p͈ a̠ ɡ ɯ ɭ p͈ a̠ ɡ ɯ ɭ	빠글빠글
빠따	p͈ a̠ t͈ a̠	빠따
빠뜨리다	p͈ a̠ː t͈ ɯ ɾ i d a̠	빠뜨리다
빠빠	p͈ a̠ p͈ a̠	빠빠
빠사삭	p͈ a̠ sʰ a̠ sʰ a̠ k̚	빠사삭
빠삭	p͈ a̠ sʰ a̠ k̚	빠삭
빠스락	p͈ a̠ sʰ ɯ ɾ a̠ k̚	빠스락
빠스락빠스락	p͈ a̠ sʰ ɯ ɾ a̠ k̚ p͈ a̠ sʰ ɯ ɾ a̠ k̚	빠스락빠스락
빠이빠이	p͈ a̠ i p͈ a̠ i	빠이빠이
빠져나가다	p͈ a̠ː d͡ʑ ʌ̹ n a̠ ɡ a̠ d a̠	빠저나가다
빡치다	p͈ a̠ k̚ t͡ɕʰ i d a̠	빡치다
빤스런	p͈ a̠ n sʰ ɯ ɾ ʌ̹ n	빤스런
빤짝빤짝	p͈ a̠ ɲ t͡ɕ͈ a̠ k̚ p͈ a̠ ɲ t͡ɕ͈ a̠ k̚	빤짝빤짝
빤쯔	p͈ a̠ ɲ t͡ɕ͈ ɯ	빤쯔
빨다	p͈ a̠ ɭ d a̠	빨다
빨딱	p͈ a̠ ɭ t͈ a̠ k̚	빨딱
빨리감다	p͈ a̠ ʎ ʎ i ɡ a̠ m t͈ a̠	빨리감따
빨찌산	p͈ a̠ ʎ t͡ɕ͈ i sʰ a̠ n	빨찌산
빵	p͈ a̠ ŋ	빵
빵가루	p͈ a̠ ŋ k͈ a̠ ɾ u	빵까루
빵나무	p͈ a̠ ŋ n a̠ m u	빵나무
빻다	p͈ a̠ː tʰ a̠	빠타
빼놓다	p͈ ɛː n o̞ tʰ a̠	빼노타
빼닫이	p͈ e̞ d a̠ d͡ʑ i	뻬다지
빼닮다	p͈ ɛː d a̠ m t͈ a̠	빼담따
뺏다	p͈ ɛː t̚ t͈ a̠	뺃따
뺨	p͈ j a̠ m	뺨
뻐그르르	p͈ ʌ̹ ɡ ɯ ɾ ɯ ɾ ɯ	뻐그르르
뻐글뻐글	p͈ ʌ̹ ɡ ɯ ɭ p͈ ʌ̹ ɡ ɯ ɭ	뻐글뻐글
뻐서석	p͈ ʌ̹ sʰ ʌ̹ sʰ ʌ̹ k̚	뻐서석
뻐석	p͈ ʌ̹ sʰ ʌ̹ k̚	뻐석
뻐석뻐석	p͈ ʌ̹ sʰ ʌ̹ k̚ p͈ ʌ̹ sʰ ʌ̹ k̚	뻐석뻐석
뻐스	p͈ ʌ̹ sʰ ɯ	뻐스
뻐스럭	p͈ ʌ̹ sʰ ɯ ɾ ʌ̹ k̚	뻐스럭
뻐스럭뻐스럭	p͈ ʌ̹ sʰ ɯ ɾ ʌ̹ k̚ p͈ ʌ̹ sʰ ɯ ɾ ʌ̹ k̚	뻐스럭뻐스럭
뻔뻔스럽다	p͈ ʌ̹ n p͈ ʌ̹ n sʰ ɯ ɾ ʌ̹ p̚ t͈ a̠	뻔뻔스럽따
뻔뻔하다	p͈ ʌ̹ n p͈ ʌ̹ n ɦ a̠ d a̠	뻔뻔하다
뻔쩍	p͈ ʌ̹ ɲ t͡ɕ͈ ʌ̹ k̚	뻔쩍
뻔하다	p͈ ʌ̹ n ɦ a̠ d a̠	뻔하다
뻘쭘	p͈ ʌ̹ ʎ t͡ɕ͈ u m	뻘쭘
뻘쭘하다	p͈ ʌ̹ ʎ t͡ɕ͈ u m ɦ a̠ d a̠	뻘쭘하다
뻥	p͈ ʌ̹ ŋ	뻥
뼈	p͈ j ʌ̹	뼈
뼈마디	p͈ j ʌ̹ m a̠ d i	뼈마디
뼈살촉	p͈ j ʌ̹ sʰ a̠ ʎ t͡ɕʰ o̞ k̚	뼈살촉
뼛골	p͈ j ʌ̹ t̚ k͈ o̞ ɭ	뼏꼴
뽀그르르	p͈ o̞ ɡ ɯ ɾ ɯ ɾ ɯ	뽀그르르
뽀글뽀글	p͈ o̞ ɡ ɯ ɭ p͈ o̞ ɡ ɯ ɭ	뽀글뽀글
뽀뽀하다	p͈ o̞ p͈ o̞ ɦ a̠ d a̠	뽀뽀하다
뽀사삭뽀사삭	p͈ o̞ sʰ a̠ sʰ a̠ k̚ p͈ o̞ sʰ a̠ sʰ a̠ k̚	뽀사삭뽀사삭
뽀삭	p͈ o̞ sʰ a̠ k̚	뽀삭
뽀삭뽀삭	p͈ o̞ sʰ a̠ k̚ p͈ o̞ sʰ a̠ k̚	뽀삭뽀삭
뽀스락뽀스락	p͈ o̞ sʰ ɯ ɾ a̠ k̚ p͈ o̞ sʰ ɯ ɾ a̠ k̚	뽀스락뽀스락
뽀얗다	p͈ o̞ː j a̠ tʰ a̠	뽀야타
뽈스까	p͈ o̞ ɭ sʰ ɯ k͈ a̠	뽈스까
뽑히다	p͈ o̞ pʰ i d a̠	뽀피다
뽕	p͈ o̞ ŋ	뽕
뽕나무	p͈ o̞ ŋ n a̠ m u	뽕나무
뿌그르르	p͈ u ɡ ɯ ɾ ɯ ɾ ɯ	뿌그르르
뿌석뿌석	p͈ u sʰ ʌ̹ k̚ p͈ u sʰ ʌ̹ k̚	뿌석뿌석
뿌스럭	p͈ u sʰ ɯ ɾ ʌ̹ k̚	뿌스럭
뿌스럭뿌스럭	p͈ u sʰ ɯ ɾ ʌ̹ k̚ p͈ u sʰ ɯ ɾ ʌ̹ k̚	뿌스럭뿌스럭
뿌시다	p͈ u ɕʰ i d a̠	뿌시다
뿐	p͈ u n	뿐
뿔	p͈ u ɭ	뿔
뿔종다리	p͈ u ʎ d͡ʑ o̞ ŋ d a̠ ɾ i	뿔종다리
쁠류스	p͈ ɯ ʎ ʎ u sʰ ɯ	쁠루스
삐까삐까	p͈ i k͈ a̠ p͈ i k͈ a̠	삐까삐까
삐다	p͈ iː d a̠	삐다
삐뚤다	p͈ i t͈ u ɭ d a̠	삐뚤다
삘	p͈ i ɭ	삘
삥	p͈ i ŋ	삥
삥샹	p͈ i ŋ ɕʰ a̠ ŋ	삥상
사	sʰ a̠	사
사고	sʰ a̠ ɡ o̞	사고
사과	sʰ a̠ ɡ w a̠	사과
사과나무	sʰ a̠ ɡ w a̠ n a̠ m u	사과나무
사과주	sʰ a̠ ɡ w a̠ d͡ʑ u	사과주
사교	sʰ a̠ ɡ j o	사교
사귀	sʰ a̠ ɡ ɥ i	사귀
사극	sʰ a̠ː ɡ ɯ k̚	사극
사기	sʰ a̠ ɡ i	사기
사까시	sʰ a̠ k͈ a̠ ɕʰ i	사까시
사꾸라	sʰ a̠ k͈ u ɾ a̠	사꾸라
사납다	sʰ a̠ː n a̠ p̚ t͈ a̠	사납따
사냥하다	sʰ a̠ ɲ a̠ ŋ ɦ a̠ d a̠	사낭하다
사닥다리	sʰ a̠ d a̠ k̚ t͈ a̠ ɾ i	사닥따리
사담	sʰ a̠ d a̠ m	사담
사동사	sʰ a̠ː d o̞ ŋ sʰ a̠	사동사
사둘	sʰ a̠ d u ɭ	사둘
사라	sʰ a̠ ɾ a̠	사라
사람갈음이름씨	sʰ a̠ ɾ a̠ m ɡ a̠ ɾ ɯ m i ɾ ɯ m ɕ͈ i	사람가르미름씨
사람비김법	sʰ a̠ ɾ a̠ m b i ɡ i m b ʌ̹ p̚	사람비김법
사랍다	sʰ a̠ ɾ a̠ p̚ t͈ a̠	사랍따
사랑싸움	sʰ a̠ ɾ a̠ ŋ s͈ a̠ u m	사랑싸움
사랑하다	sʰ a̠ ɾ a̠ ŋ ɦ a̠ d a̠	사랑하다
사략선	sʰ a̠ ɾ j a̠ k s͈ ʌ̹ n	사략썬
사뢰다	sʰ a̠ ɾ w e̞ d a̠	사뢰다
사료	sʰ a̠ ɾ j o	사료
사루기	sʰ a̠ ɾ u ɡ i	사루기
사륜차	sʰ a̠ː ɾ j u ɲ t͡ɕʰ a̠	사륜차
사리	sʰ a̠ ɾ i	사리
사리사욕	sʰ a̠ ɾ i sʰ a̠ j o k̚	사리사욕
사망하다	sʰ a̠ m a̠ ŋ ɦ a̠ d a̠	사망하다
사모바르	sʰ a̠ m o̞ b a̠ ɾ ɯ	사모바르
사모뿔	sʰ a̠ m o̞ p͈ u ɭ	사모뿔
사물놀이	sʰ a̠ m u ɭ ɭ o̞ ɾ i	사물로리
사바사	sʰ a̠ː b a̠ sʰ a̠	사바사
사발	sʰ a̠ b a̠ ɭ	사발
사방치기	sʰ a̠ b a̠ ŋ t͡ɕʰ i ɡ i	사방치기
사방팔방	sʰ a̠ː b a̠ ŋ pʰ a̠ ɭ b a̠ ŋ	사방팔방
사보타주	sʰ a̠ b o̞ tʰ a̠ d͡ʑ u	사보타주
사사롭다	sʰ a̠ sʰ a̠ ɾ o̞ p̚ t͈ a̠	사사롭따
사사오입	sʰ a̠ sʰ a̠ o̞ i p̚	사사오입
사서	sʰ a̠ sʰ ʌ̹	사서
사서오경	sʰ a̠ː sʰ ʌ̹ o̞ ɡ j ʌ̹ ŋ	사서오경
사성음	sʰ a̠ː sʰ ʌ̹ ŋ ɯ m	사성음
사소하다	sʰ a̠ sʰ o̞ ɦ a̠ d a̠	사소하다
사수	sʰ a̠ sʰ u	사수
사실은	sʰ a̠ ɕʰ i ɾ ɯ n	사시른
사심	sʰ a̠ ɕʰ i m	사심
사십	sʰ a̠ː ɕʰ i p̚	사십
사양하다	sʰ a̠ j a̠ ŋ ɦ a̠ d a̠	사양하다
사역원	sʰ a̠ j ʌ̹ ɡ w ʌ̹ n	사여권
사우스다코타	sʰ a̠ u s͈ ɯ d a̠ kʰ o̞ tʰ a̠	사우쓰다코타
사유	sʰ a̠ j u	사유
사육제	sʰ a̠ː j u k̚ t͡ɕ͈ e̞	사육쩨
사이버불링	s͈ a̠ i b ʌ̹ b u ʎ ʎ i ŋ	싸이버불링
사이시옷	sʰ a̠ i ɕʰ i o̞ t̚	사이시옫
사이폰	s͈ a̠ i pʰ o̞ n	싸이폰
사인	sʰ a̠ i n	사인
사인하다	sʰ a̠ i n ɦ a̠ d a̠	사인하다
사자	sʰ a̠ d͡ʑ a̠	사자
사전	sʰ a̠ d͡ʑ ʌ̹ n	사전
사정	sʰ a̠ d͡ʑ ʌ̹ ŋ	사정
사족	sʰ a̠ d͡ʑ o̞ k̚	사족
사종	sʰ a̠ d͡ʑ o̞ ŋ	사종
사지	sʰ a̠ d͡ʑ i	사지
사진빨	sʰ a̠ d͡ʑ i n p͈ a̠ ɭ	사진빨
사진첩	sʰ a̠ d͡ʑ i ɲ t͡ɕʰ ʌ̹ p̚	사진첩
사체	sʰ a̠ː t͡ɕʰ e̞	사체
사초	sʰ a̠ t͡ɕʰ o̞	사초
사춘	sʰ a̠ t͡ɕʰ u n	사춘
사칭	sʰ a̠ t͡ɕʰ i ŋ	사칭
사탄교	sʰ a̠ tʰ a̠ n ɡ j o	사탄교
사통	sʰ a̠ tʰ o̞ ŋ	사통
사투르누스	sʰ a̠ tʰ u ɾ ɯ n u sʰ ɯ	사투르누스
사튀로스	sʰ a̠ tʰ ɥ i ɾ o̞ sʰ ɯ	사튀로스
사팔뜨기	sʰ a̠ː pʰ a̠ ɭ t͈ ɯ ɡ i	사팔뜨기
사푼	sʰ a̠ pʰ u n	사푼
사푼사푼	sʰ a̠ pʰ u n sʰ a̠ pʰ u n	사푼사푼
사향고양이	sʰ a̠ ʝ a̠ ŋ ɡ o̞ j a̠ ŋ i	사항고양이
사향노루	sʰ a̠ː ʝ a̠ ŋ n o̞ ɾ u	사항노루
사향땃쥐	sʰ a̠ ʝ a̠ ŋ t͈ a̠ t̚ t͡ɕ͈ ɥ i	사항딷쮜
사향소	sʰ a̠ ʝ a̠ ŋ sʰ o̞	사항소
사향쥐	sʰ a̠ ʝ a̠ ŋ d͡ʑ ɥ i	사항쥐
사화산	sʰ a̠ː β w a̠ sʰ a̠ n	사화산
삭	sʰ a̠ k̚	삭
삭이다	sʰ a̠ ɡ i d a̠	사기다
삭제	sʰ a̠ k̚ t͡ɕ͈ e̞	삭쩨
삭제하다	sʰ a̠ k̚ t͡ɕ͈ e̞ ɦ a̠ d a̠	삭쩨하다
삯	sʰ a̠ k̚	삭
산	sʰ a̠ n	산
산꿩의밥	sʰ a̠ n k͈ w ʌ̹ ŋ ɰ i b a̠ p̚	산꿩의밥
산달	sʰ a̠ n d a̠ ɭ	산달
산당화	sʰ a̠ n d a̠ ŋ β w a̠	산당화
산등성이	sʰ a̠ n t͈ ɯ ŋ sʰ ʌ̹ ŋ i	산뜽성이
산딸기	sʰ a̠ n t͈ a̠ ɭ ɡ i	산딸기
산딸나무	sʰ a̠ n t͈ a̠ ɭ ɭ a̠ m u	산딸라무
산뽕나무	sʰ a̠ n p͈ o̞ ŋ n a̠ m u	산뽕나무
산스크리트어	sʰ a̠ n sʰ ɯ k x ɯ ɾ i tʰ ɯ ʌ̹	산스크리트어
산신각	sʰ a̠ n ɕʰ i n ɡ a̠ k̚	산신각
산아	sʰ a̠ː n a̠	사나
산업화	sʰ a̠ː n ʌ̹ pʰ w a̠	사너퐈
산주인	sʰ a̠ ɲ d͡ʑ u i n	산주인
산초	sʰ a̠ ɲ t͡ɕʰ o̞	산초
산초나무	sʰ a̠ ɲ t͡ɕʰ o̞ n a̠ m u	산초나무
산토도밍고	sʰ a̠ n tʰ o̞ d o̞ m i ŋ ɡ o̞	산토도밍고
산판	sʰ a̠ː n pʰ a̠ n	산판
산호세	sʰ a̠ n β o̞ sʰ e̞	산호세
산화물	sʰ a̠ n β w a̠ m u ɭ	산화물
살갗	sʰ a̠ ɭ ɡ a̠ t̚	살갇
살결	sʰ a̠ ɭ ɡ j ʌ̹ ɭ	살결
살균	sʰ a̠ ɭ ɡ j u n	살균
살까기	sʰ a̠ ɭ k͈ a̠ ɡ i	살까기
살무사	sʰ a̠ ɭ m u sʰ a̠	살무사
살별	sʰ a̠ ɭ b j ʌ̹ ɭ	살별
살살하다	sʰ a̠ː ɭ sʰ a̠ ɾ ɦ a̠ d a̠	살살하다
살아남다	sʰ a̠ ɾ a̠ n a̠ m t͈ a̠	사라남따
살육	sʰ a̠ ɾ j u k̚	사륙
살찌다	sʰ a̠ ʎ t͡ɕ͈ i d a̠	살찌다
살찌우다	sʰ a̠ ʎ t͡ɕ͈ i u d a̠	살찌우다
살찐	sʰ a̠ ʎ t͡ɕ͈ i n	살찐
살처분	sʰ a̠ ʎ t͡ɕʰ ʌ̹ b u n	살처분
살푸시	sʰ a̠ ɭ pʰ u ɕʰ i	살푸시
살풍경	sʰ a̠ ɭ pʰ u ŋ ɡ j ʌ̹ ŋ	살풍경
살피	sʰ a̠ ɭ pʰ i	살피
삵	sʰ a̠ k̚	삭
삶	sʰ a̠ː m	삼
삼	sʰ a̠ m	삼
삼공	sʰ a̠ m ɡ o̞ ŋ	삼공
삼광	sʰ a̠ m ɡ w a̠ ŋ	삼광
삼나라	sʰ a̠ m n a̠ ɾ a̠	삼나라
삼단논법	sʰ a̠ m d a̠ n n o̞ n p͈ ʌ̹ p̚	삼단논뻡
삼동	sʰ a̠ m d o̞ ŋ	삼동
삼라만상	sʰ a̠ m n a̠ m a̠ n sʰ a̠ ŋ	삼나만상
삼륜차	sʰ a̠ m ɲ u ɲ t͡ɕʰ a̠	삼눈차
삼선	sʰ a̠ m sʰ ʌ̹ n	삼선
삼엽기	sʰ a̠ m j ʌ̹ p̚ k͈ i	사몁끼
삼위일체	sʰ a̠ m ɥ i i ʎ t͡ɕʰ e̞	사뮈일체
삼인칭	sʰ a̠ m i ɲ t͡ɕʰ i ŋ	사민칭
삼줄	sʰ a̠ m d͡ʑ u ɭ	삼줄
삼진	sʰ a̠ m d͡ʑ i n	삼진
삼차원	sʰ a̠ m t͡ɕʰ a̠ w ʌ̹ n	삼차원
삼척	sʰ a̠ m t͡ɕʰ ʌ̹ k̚	삼척
삼초	sʰ a̠ m t͡ɕʰ o̞	삼초
삽	sʰ a̠ p̚	삽
삽신	sʰ a̠ p ɕ͈ i n	삽씬
삽화	sʰ a̠ pʰ w a̠	사퐈
상	sʰ a̠ ŋ	상
상간	sʰ a̠ ŋ ɡ a̠ n	상간
상관	sʰ a̠ ŋ ɡ w a̠ n	상관
상관하다	sʰ a̠ ŋ ɡ w a̠ n ɦ a̠ d a̠	상관하다
상권	sʰ a̠ ŋ k͈ w ʌ̹ n	상꿘
상급	sʰ a̠ ŋ ɡ ɯ p̚	상급
상냥하다	sʰ a̠ ŋ ɲ a̠ ŋ ɦ a̠ d a̠	상낭하다
상륙	sʰ a̠ː ŋ ɲ u k̚	상눅
상무	sʰ a̠ ŋ m u	상무
상반신	sʰ a̠ː ŋ b a̠ n ɕʰ i n	상반신
상사	sʰ a̠ ŋ sʰ a̠	상사
상상하다	sʰ a̠ː ŋ sʰ a̠ ŋ ɦ a̠ d a̠	상상하다
상선벌악	sʰ a̠ ŋ sʰ ʌ̹ n b ʌ̹ ɾ a̠ k̚	상선버락
상수리	sʰ a̠ ŋ sʰ u ɾ i	상수리
상수리나무	sʰ a̠ ŋ sʰ u ɾ i n a̠ m u	상수리나무
상스럽다	sʰ a̠ ŋ s͈ ɯ ɾ ʌ̹ p̚ t͈ a̠	상쓰럽따
상아탑	sʰ a̠ ŋ a̠ tʰ a̠ p̚	상아탑
상여	sʰ a̠ ŋ j ʌ̹	상여
상완삼두근	sʰ a̠ː ŋ w a̠ n sʰ a̠ m d u ɡ ɯ n	상완삼두근
상완이두근	sʰ a̠ː ŋ w a̠ n i d u ɡ ɯ n	상와니두근
상원의원	sʰ a̠ː ŋ w ʌ̹ n ɰ i w ʌ̹ n	상워늬원
상위어	sʰ a̠ː ŋ ɥ i ʌ̹	상위어
상의하다	sʰ a̠ ŋ ɰ i ɦ a̠ d a̠	상의하다
상임	sʰ a̠ ŋ i m	상임
상징	sʰ a̠ ŋ d͡ʑ i ŋ	상징
상징하다	sʰ a̠ ŋ d͡ʑ i ŋ ɦ a̠ d a̠	상징하다
상체	sʰ a̠ː ŋ t͡ɕʰ e̞	상체
상하이어	sʰ a̠ ŋ ɦ a̠ i ʌ̹	상하이어
상형	sʰ a̠ ŋ ʝ ʌ̹ ŋ	상헝
샅	sʰ a̠ t̚	삳
새	sʰ ɛː	새
새가슴	sʰ ɛː ɡ a̠ sʰ ɯ m	새가슴
새다	sʰ ɛː d a̠	새다
새똥	sʰ ɛː t͈ o̞ ŋ	새똥
새집	sʰ ɛː d͡ʑ i p̚	새집
새치기	sʰ ɛː t͡ɕʰ i ɡ i	새치기
새호리기	sʰ ɛː β o̞ ɾ i ɡ i	새호리기
새홀리기	sʰ ɛː β o̞ ʎ ʎ i ɡ i	새홀리기
샘	sʰ ɛː m	샘
샛길	sʰ ɛː t̚ k͈ i ɭ	샏낄
생	sʰ ɛː ŋ	생
샤먼	ɕʰ a̠ m ʌ̹ n	사먼
샤쯔	ɕʰ a̠ t͡ɕ͈ ɯ	사쯔
샤타	ɕʰ a̠ tʰ a̠	사타
샤프펜실	ɕʰ a̠ pʰ ɯ pʰ e̞ n ɕʰ i ɭ	사프펜실
샬럿타운	ɕʰ a̠ ɭ ɭ ʌ̹ t̚ tʰ a̠ u n	살럳타운
샹차이	ɕʰ a̠ ŋ t͡ɕʰ a̠ i	상차이
서	sʰ ʌ̹	서
서경	sʰ ʌ̹ ɡ j ʌ̹ ŋ	서경
서과	sʰ ʌ̹ ɡ w a̠	서과
서늘하다	sʰ ʌ̹ n ɯ ɾ ɦ a̠ d a̠	서늘하다
서도	sʰ ʌ̹ d o̞	서도
서독	sʰ ʌ̹ d o̞ k̚	서독
서라벌	sʰ ʌ̹ ɾ a̠ b ʌ̹ ɭ	서라벌
서류가방	sʰ ʌ̹ ɾ j u ɡ a̠ b a̠ ŋ	서류가방
서류철	sʰ ʌ̹ ɾ j u t͡ɕʰ ʌ̹ ɭ	서류철
서반아	sʰ ʌ̹ b a̠ n a̠	서바나
서발	sʰ ʌ̹ b a̠ ɭ	서발
서부극	sʰ ʌ̹ b u ɡ ɯ k̚	서부극
서브컬처	s͈ ʌ̹ b ɯ kʰ ʌ̹ ʎ t͡ɕʰ ʌ̹	써브컬처
서뿐	sʰ ʌ̹ p͈ u n	서뿐
서사하라	sʰ ʌ̹ sʰ a̠ ɦ a̠ ɾ a̠	서사하라
서슴다	sʰ ʌ̹ sʰ ɯ m d a̠	서슴다
서식	sʰ ʌ̹ ɕʰ i k̚	서식
서양갈까마귀	sʰ ʌ̹ j a̠ ŋ ɡ a̠ ɭ k͈ a̠ m a̠ ɡ ɥ i	서양갈까마귀
서양메꽃	sʰ ʌ̹ j a̠ ŋ m e̞ k͈ o̞ t̚	서양메꼳
서양화	sʰ ʌ̹ j a̠ ŋ β w a̠	서양화
서어나무	sʰ ʌ̹ ʌ̹ n a̠ m u	서어나무
서왕모	sʰ ʌ̹ w a̠ ŋ m o̞	서왕모
서운하다	sʰ ʌ̹ u n ɦ a̠ d a̠	서운하다
서울공화국	sʰ ʌ̹ u ɭ k o̞ː ŋ β w a̠ ɡ u k̚	서울공화국
서이	sʰ ʌ̹ i	서이
서인	sʰ ʌ̹ i n	서인
서진	sʰ ʌ̹ d͡ʑ i n	서진
서평	sʰ ʌ̹ pʰ j ʌ̹ ŋ	서평
서푼서푼	sʰ ʌ̹ pʰ u n sʰ ʌ̹ pʰ u n	서푼서푼
서하	sʰ ʌ̹ ɦ a̠	서하
석	sʰ ʌ̹ k̚	석
석가	sʰ ʌ̹ k̚ k͈ a̠	석까
석감	sʰ ʌ̹ k̚ k͈ a̠ m	석깜
석거	sʰ ʌ̹ k̚ k͈ ʌ̹	석꺼
석고	sʰ ʌ̹ k̚ k͈ o̞	석꼬
석고판	sʰ ʌ̹ k̚ k͈ o̞ pʰ a̠ n	석꼬판
석궁	sʰ ʌ̹ k̚ k͈ u ŋ	석꿍
석다	sʰ ʌ̹ k̚ t͈ a̠	석따
석랍	sʰ ʌ̹ ŋ n a̠ p̚	성납
석류나무	sʰ ʌ̹ ŋ ɲ u n a̠ m u	성누나무
석방하다	sʰ ʌ̹ k̚ p͈ a̠ ŋ ɦ a̠ d a̠	석빵하다
석임	sʰ ʌ̹ ɡ i m	서김
석존	sʰ ʌ̹ k̚ t͡ɕ͈ o̞ n	석쫀
섞이다	sʰ ʌ̹ k͈ i d a̠	서끼다
선고	sʰ ʌ̹ n ɡ o̞	선고
선고하다	sʰ ʌ̹ n ɡ o̞ ɦ a̠ d a̠	선고하다
선군	sʰ ʌ̹ n ɡ u n	선군
선그림	sʰ ʌ̹ n ɡ ɯ ɾ i m	선그림
선명	sʰ ʌ̹ n m j ʌ̹ ŋ	선명
선반공	sʰ ʌ̹ n b a̠ n ɡ o̞ ŋ	선반공
선서	sʰ ʌ̹ n sʰ ʌ̹	선서
선슨아	sʰ ʌ̹ n sʰ ɯ n a̠	선스나
선심	sʰ ʌ̹ n ɕʰ i m	선심
선약	sʰ ʌ̹ ɲ a̠ k̚	서낙
선언하다	sʰ ʌ̹ n ʌ̹ n ɦ a̠ d a̠	서넌하다
선입견	sʰ ʌ̹ n i p̚ k͈ j ʌ̹ n	서닙껸
선입관	sʰ ʌ̹ n i p̚ k͈ w a̠ n	서닙꽌
선입선출	sʰ ʌ̹ n i p s͈ ʌ̹ ɲ t͡ɕʰ u ɭ	서닙썬출
선잠	sʰ ʌ̹ ɲ d͡ʑ a̠ m	선잠
선전	sʰ ʌ̹ ɲ d͡ʑ ʌ̹ n	선전
선체	sʰ ʌ̹ ɲ t͡ɕʰ e̞	선체
선혈	sʰ ʌ̹ n ʝ ʌ̹ ɭ	선헐
선형동물	sʰ ʌ̹ n ʝ ʌ̹ ŋ d o̞ ŋ m u ɭ	선헝동물
설	sʰ ʌ̹ ɭ	설
설농탕	sʰ ʌ̹ ɭ ɭ o̞ ŋ tʰ a̠ ŋ	설롱탕
설레다	sʰ ʌ̹ ɭ ɭ e̞ d a̠	설레다
설령	sʰ ʌ̹ ʎ ʎ ʌ̹ ŋ	설렁
설립자	sʰ ʌ̹ ʎ ʎ i p̚ t͡ɕ͈ a̠	설립짜
설명	sʰ ʌ̹ ɭ m j ʌ̹ ŋ	설명
설상가상	sʰ ʌ̹ ɭ s͈ a̠ ŋ ɡ a̠ sʰ a̠ ŋ	설쌍가상
설인	sʰ ʌ̹ ɾ i n	서린
설전	sʰ ʌ̹ ʎ t͡ɕ͈ ʌ̹ n	설쩐
설치되다	sʰ ʌ̹ ʎ t͡ɕʰ i d w e̞ d a̠	설치되다
설탕단풍나무	sʰ ʌ̹ ɭ tʰ a̠ ŋ d a̠ n pʰ u ŋ n a̠ m u	설탕단풍나무
설프히드릴기	sʰ ʌ̹ ɭ pʰ ɯ ʝ i d ɯ ɾ i ɭ ɡ i	설프히드릴기
설하다	sʰ ʌ̹ ɾ ɦ a̠ d a̠	설하다
섥	sʰ ʌ̹ k̚	석
섬광	sʰ ʌ̹ m ɡ w a̠ ŋ	섬광
섬기다	sʰ ʌ̹ m ɡ i d a̠	섬기다
섬돌	sʰ ʌ̹ m t͈ o̞ ɭ	섬똘
섬망	sʰ ʌ̹ m m a̠ ŋ	섬망
섬멸	sʰ ʌ̹ m m j ʌ̹ ɭ	섬멸
섬서	sʰ ʌ̹ m sʰ ʌ̹	섬서
섬섬옥수	sʰ ʌ̹ m sʰ ʌ̹ m o̞ k s͈ u	섬서목쑤
섬유	sʰ ʌ̹ m j u	서뮤
섭취	sʰ ʌ̹ p̚ t͡ɕʰ ɥ i	섭취
섯	sʰ ʌ̹ t̚	섣
성	sʰ ʌ̹ ŋ	성
성가시다	sʰ ʌ̹ ŋ ɡ a̠ ɕʰ i d a̠	성가시다
성공하다	sʰ ʌ̹ ŋ ɡ o̞ ŋ ɦ a̠ d a̠	성공하다
성구	sʰ ʌ̹ ŋ k͈ u	성꾸
성군	sʰ ʌ̹ ŋ ɡ u n	성군
성녀	sʰ ʌ̹ ŋ ɲ ʌ̹	성너
성능	sʰ ʌ̹ ŋ n ɯ ŋ	성능
성독	sʰ ʌ̹ ŋ d o̞ k̚	성독
성립되다	sʰ ʌ̹ ŋ n i p̚ t͈ w e̞ d a̠	성닙뙤다
성망	sʰ ʌ̹ ŋ m a̠ ŋ	성망
성명서	sʰ ʌ̹ ŋ m j ʌ̹ ŋ sʰ ʌ̹	성명서
성벽	sʰ ʌ̹ ŋ b j ʌ̹ k̚	성벽
성에	sʰ ʌ̹ ŋ e̞	성에
성인	sʰ ʌ̹ ŋ i n	성인
성적	sʰ ʌ̹ ŋ d͡ʑ ʌ̹ k̚	성적
성좌	sʰ ʌ̹ ŋ d͡ʑ w a̠	성좌
섶	sʰ ʌ̹ p̚	섭
세	sʰ e̞ː	세
세가락메추라기	sʰ e̞ː ɡ a̠ ɾ a̠ ŋ m e̞ t͡ɕʰ u ɾ a̠ ɡ i	세가랑메추라기
세계어	sʰ e̞ː ɡ j e̞ ʌ̹	세계어
세계화	sʰ e̞ː ɡ j e̞ β w a̠	세계화
세꼬	sʰ e̞ k͈ o̞	세꼬
세련되다	sʰ e̞ ɾ j ʌ̹ n d w e̞ d a̠	세련되다
세륨	sʰ e̞ ɾ j u m	세륨
세르보크로아트어	sʰ e̞ ɾ ɯ b o̞ k x ɯ ɾ o̞ a̠ tʰ ɯ ʌ̹	세르보크로아트어
세르비아어	sʰ e̞ ɾ ɯ b i a̠ ʌ̹	세르비아어
세멘트	sʰ e̞ m e̞ n tʰ ɯ	세멘트
세면	sʰ e̞ː m j ʌ̹ n	세면
세벌식	sʰ e̞ b ʌ̹ ɭ ɕʰ i k̚	세벌식
세슘	sʰ e̞ ɕʰ u m	세숨
세습무	sʰ e̞ː sʰ ɯ m m u	세슴무
세이셸	s͈ e̞ i ɕʰ e̞ ɭ	쎄이셀
세인트루시아	sʰ e̞ i n tʰ ɯ ɾ u ɕʰ i a̠	세인트루시아
세인트조지스	sʰ e̞ i n tʰ ɯ d͡ʑ o̞ d͡ʑ i sʰ ɯ	세인트조지스
세인트존스	s͈ e̞ i n tʰ ɯ d͡ʑ o̞ n sʰ ɯ	쎄인트존스
세젤귀	sʰ e̞ d͡ʑ e̞ ɭ ɡ ɥ i	세젤귀
세존	sʰ e̞ː d͡ʑ o̞ n	세존
세지다	sʰ e̞ː d͡ʑ i d a̠	세지다
섹시	sʰ e̞ k ɕ͈ i	섹씨
셀레나	sʰ e̞ ɭ ɭ e̞ n a̠	셀레나
셀룰로이드	sʰ e̞ ɭ ɭ u ɭ ɭ o̞ i d ɯ	셀룰로이드
셈	sʰ e̞ː m	셈
셈틀	sʰ e̞ː m tʰ ɯ ɭ	셈틀
셈판	sʰ e̞ː m pʰ a̠ n	셈판
셋	sʰ e̞ː t̚	섿
셔틀	ɕʰ ʌ̹ tʰ ɯ ɭ	서틀
셸	ɕʰ e̞ ɭ	셀
소	sʰ o̞	소
소곰	sʰ o̞ ɡ o̞ m	소곰
소굴	sʰ o̞ ɡ u ɭ	소굴
소급	sʰ o̞ ɡ ɯ p̚	소급
소꿉	sʰ o̞ k͈ u p̚	소꿉
소꿉동무	sʰ o̞ k͈ u p̚ t͈ o̞ ŋ m u	소꿉똥무
소꿉친구	sʰ o̞ k͈ u p̚ t͡ɕʰ i n ɡ u	소꿉친구
소뇌	sʰ o̞ː n w e̞	소뇌
소다	sʰ o̞ d a̠	소다
소다빵	sʰ o̞ d a̠ p͈ a̠ ŋ	소다빵
소도구	sʰ o̞ː d o̞ ɡ u	소도구
소돔사과	sʰ o̞ d o̞ m sʰ a̠ ɡ w a̠	소돔사과
소두	sʰ o̞ː d u	소두
소라게	sʰ o̞ ɾ a̠ ɡ e̞	소라게
소리꾼	sʰ o̞ ɾ i k͈ u n	소리꾼
소리하다	sʰ o̞ ɾ i ɦ a̠ d a̠	소리하다
소멸하다	sʰ o̞ m j ʌ̹ ɾ ɦ a̠ d a̠	소멸하다
소문자	sʰ o̞ː m u ɲ t͡ɕ͈ a̠	소문짜
소반	sʰ o̞ː b a̠ n	소반
소수	sʰ o̞ s͈ u	소쑤
소슬	sʰ o̞ sʰ ɯ ɭ	소슬
소슬하다	sʰ o̞ sʰ ɯ ɾ ɦ a̠ d a̠	소슬하다
소심하다	sʰ o̞ː ɕʰ i m ɦ a̠ d a̠	소심하다
소아	sʰ o̞ː a̠	소아
소아과	sʰ o̞ː a̠ k͈ w a̠	소아꽈
소외	sʰ o̞ w e̞	소외
소원	sʰ o̞ w ʌ̹ n	소원
소원하다	sʰ o̞ː w ʌ̹ n ɦ a̠ d a̠	소원하다
소유물	sʰ o̞ː j u m u ɭ	소유물
소자	sʰ o̞ː d͡ʑ a̠	소자
소제하다	sʰ o̞ː d͡ʑ e̞ ɦ a̠ d a̠	소제하다
소좌	sʰ o̞ː d͡ʑ w a̠	소좌
소지하다	sʰ o̞ d͡ʑ i ɦ a̠ d a̠	소지하다
소질	sʰ o̞ d͡ʑ i ɭ	소질
소집하다	sʰ o̞ d͡ʑ i pʰ a̠ d a̠	소지파다
소치	sʰ o̞ː t͡ɕʰ i	소치
소포제	sʰ o̞ pʰ o̞ d͡ʑ e̞	소포제
소화하다	sʰ o̞ β w a̠ ɦ a̠ d a̠	소화하다
속	sʰ o̞ k̚	속
속구	sʰ o̞ k̚ k͈ u	속꾸
속궁합	sʰ o̞ː k̚ k͈ u ŋ ɦ a̠ p̚	속꿍합
속다	sʰ o̞ k̚ t͈ a̠	속따
속도위반	sʰ o̞ k̚ t͈ o̞ ɥ i b a̠ n	속또위반
속되다	sʰ o̞ k̚ t͈ w e̞ d a̠	속뙤다
속삭이다	sʰ o̞ k s͈ a̠ ɡ i d a̠	속싸기다
속성	sʰ o̞ k s͈ ʌ̹ ŋ	속썽
속성음식	sʰ o̞ k s͈ ʌ̹ ŋ ɯ m ɕʰ i k̚	속썽음식
속셈	sʰ o̞ː k s͈ e̞ m	속쎔
속음	sʰ o̞ ɡ ɯ m	소금
속임수	sʰ o̞ ɡ i m s͈ u	소김쑤
속전속결	sʰ o̞ k̚ t͡ɕ͈ ʌ̹ n sʰ o̞ k̚ k͈ j ʌ̹ ɭ	속쩐속껼
속편	sʰ o̞ k̚ pʰ j ʌ̹ n	속편
속하다	sʰ o̞ kʰ a̠ d a̠	소카다
손	sʰ o̞ n	손
손끝	sʰ o̞ n k͈ ɯ t̚	손끋
손님네	sʰ o̞ n n i m n e̞	손님네
손발톱	sʰ o̞ n b a̠ ɭ tʰ o̞ p̚	손발톱
손쉽다	sʰ o̞ n ʃʰ ɥ i p̚ t͈ a̠	손쉽따
손실	sʰ o̞ː n ɕʰ i ɭ	손실
손싸다	sʰ o̞ n s͈ a̠ d a̠	손싸다
손잡이	sʰ o̞ ɲ d͡ʑ a̠ b i	손자비
손질하다	sʰ o̞ ɲ d͡ʑ i ɾ ɦ a̠ d a̠	손질하다
손톱깎이	sʰ o̞ n tʰ o̞ p̚ k͈ a̠ k͈ i	손톱까끼
솔	sʰ o̞ ɭ	솔
솔나무	sʰ o̞ ɭ ɭ a̠ m u	솔라무
솔방울	sʰ o̞ ɭ p͈ a̠ ŋ u ɭ	솔빵울
솜	sʰ o̞ː m	솜
솜땀	sʰ o̞ m t͈ a̠ m	솜땀
솟다	sʰ o̞ t̚ t͈ a̠	솓따
송	sʰ o̞ ŋ	송
송곳	sʰ o̞ː ŋ ɡ o̞ t̚	송곧
송금	sʰ o̞ ŋ ɡ ɯ m	송금
송자	sʰ o̞ ŋ d͡ʑ a̠	송자
송장	sʰ o̞ː ŋ d͡ʑ a̠ ŋ	송장
송쿠	sʰ o̞ ŋ kʰ u	송쿠
솥	sʰ o̞ t̚	솓
쇄도	sʰ w ɛː d o̞	쇄도
쇠	sʰ w e̞	쇠
쇠기름	sʰ w e̞ː ɡ i ɾ ɯ m	쇠기름
쇠뇌	sʰ w e̞ n w e̞	쇠뇌
쇠뒤쥐	sʰ w e̞ d ɥ i d͡ʑ ɥ i	쇠뒤쥐
쇠똥	sʰ w e̞ t͈ o̞ ŋ	쇠똥
쇠뜨기	sʰ w e̞ t͈ ɯ ɡ i	쇠뜨기
쇠뼈	sʰ w e̞ p͈ j ʌ̹	쇠뼈
쇠뿔	sʰ w e̞ p͈ u ɭ	쇠뿔
쇠오리	sʰ w e̞ o̞ ɾ i	쇠오리
쇠퇴하다	sʰ w e̞ tʰ w e̞ ɦ a̠ d a̠	쇠퇴하다
쇠하다	sʰ w e̞ ɦ a̠ d a̠	쇠하다
쇠황조롱이	sʰ w e̞ β w a̠ ŋ d͡ʑ o̞ ɾ o̞ ŋ i	쇠황조롱이
쇼	ɕ͈ o	쑈
쇼라인	ɕʰ o ɾ a̠ i n	쇼라인
쇼비니즘	ɕʰ o b i n i d͡ʑ ɯ m	쇼비니즘
쇼어라인	ɕʰ o ʌ̹ ɾ a̠ i n	쇼어라인
쇼트	ɕʰ o tʰ ɯ	쇼트
쇼핑하다	ɕʰ o pʰ i ŋ ɦ a̠ d a̠	쇼핑하다
수	sʰ u	수
수감자	sʰ u ɡ a̠ m d͡ʑ a̠	수감자
수고하다	sʰ uː ɡ o̞ ɦ a̠ d a̠	수고하다
수구여병	sʰ u ɡ u j ʌ̹ b j ʌ̹ ŋ	수구여병
수권	sʰ u k͈ w ʌ̹ n	수꿘
수뇌상봉	sʰ u n w e̞ sʰ a̠ ŋ b o̞ ŋ	수뇌상봉
수뇨관	sʰ u ɲ o ɡ w a̠ n	수뇨관
수다떨다	sʰ u d a̠ t͈ ʌ̹ ɭ d a̠	수다떨다
수란	sʰ u ɾ a̠ n	수란
수리	sʰ u ɾ i	수리
수리아	sʰ u ɾ i a̠	수리아
수리하다	sʰ u ɾ i ɦ a̠ d a̠	수리하다
수많다	sʰ uː m a̠ n tʰ a̠	수만타
수모	sʰ u m o̞	수모
수비	sʰ u b i	수비
수사	sʰ u sʰ a̠	수사
수사관	sʰ u sʰ a̠ ɡ w a̠ n	수사관
수산기	sʰ u sʰ a̠ n ɡ i	수산기
수상자	sʰ u sʰ a̠ ŋ d͡ʑ a̠	수상자
수소탄	sʰ u sʰ o̞ tʰ a̠ n	수소탄
수수꽃다리	sʰ u sʰ u k͈ o̞ t̚ t͈ a̠ ɾ i	수수꼳따리
수습하다	sʰ u sʰ ɯ pʰ a̠ d a̠	수스파다
수신기	sʰ u ɕʰ i n ɡ i	수신기
수신인	sʰ u ɕʰ i n i n	수시닌
수양버들	sʰ u j a̠ ŋ b ʌ̹ d ɯ ɭ	수양버들
수어	sʰ u ʌ̹	수어
수영하다	sʰ u j ʌ̹ ŋ ɦ a̠ d a̠	수영하다
수오리	sʰ u o̞ ɾ i	수오리
수용소	sʰ u j o ŋ sʰ o̞	수용소
수장국	sʰ u d͡ʑ a̠ ŋ ɡ u k̚	수장국
수장룡	sʰ u d͡ʑ a̠ ŋ ɲ o ŋ	수장뇽
수정안	sʰ u d͡ʑ ʌ̹ ŋ a̠ n	수정안
수정주의	sʰ u d͡ʑ ʌ̹ ŋ d͡ʑ u ɰ i	수정주의
수제자	sʰ u d͡ʑ e̞ d͡ʑ a̠	수제자
수증기	sʰ u d͡ʑ ɯ ŋ ɡ i	수증기
수집	sʰ u d͡ʑ i p̚	수집
수청목	sʰ u t͡ɕʰ ʌ̹ ŋ m o̞ k̚	수청목
수취인	sʰ u t͡ɕʰ ɥ i i n	수취인
수코양이	sʰ u kʰ o̞ j a̠ ŋ i	수코양이
수탉	sʰ u tʰ a̠ k̚	수탁
수통	sʰ u tʰ o̞ ŋ	수통
수판	sʰ uː pʰ a̠ n	수판
수풍금	sʰ u pʰ u ŋ ɡ ɯ m	수풍금
수학	sʰ u ɦ a̠ k̚	수학
수효	sʰ uː ʝ o	수효
숙	sʰ u k̚	숙
숙녀	sʰ u ŋ ɲ ʌ̹	숭너
숙련자	sʰ u ŋ ɲ ʌ̹ ɲ d͡ʑ a̠	숭넌자
숙명론	sʰ u ŋ m j ʌ̹ ŋ n o̞ n	숭명논
숙박하다	sʰ u k̚ p͈ a̠ kʰ a̠ d a̠	숙빠카다
숙이다	sʰ u ɡ i d a̠	수기다
숙제하다	sʰ u k̚ t͡ɕ͈ e̞ ɦ a̠ d a̠	숙쩨하다
숙청	sʰ u k̚ t͡ɕʰ ʌ̹ ŋ	숙청
순무	sʰ u n m u	순무
순우리말	sʰ u n u ɾ i m a̠ ɭ	수누리말
순조	sʰ uː ɲ d͡ʑ o̞	순조
순진하다	sʰ u ɲ d͡ʑ i n ɦ a̠ d a̠	순진하다
순하다	sʰ uː n ɦ a̠ d a̠	순하다
술	sʰ u ɭ	술
술기운	sʰ u ɭ k͈ i u n	술끼운
술라쥐	sʰ u ɭ ɭ a̠ d͡ʑ ɥ i	술라쥐
술맛	sʰ u ɭ m a̠ t̚	술맏
술밑	sʰ u ɭ m i t̚	술믿
숨	sʰ uː m	숨
숨구멍	sʰ uː m k͈ u m ʌ̹ ŋ	숨꾸멍
숨다	sʰ uː m t͈ a̠	숨따
숫	sʰ u t̚	숟
숫처녀	sʰ u t̚ t͡ɕʰ ʌ̹ ɲ ʌ̹	숟처너
숭	sʰ u ŋ	숭
숭경	sʰ u ŋ ɡ j ʌ̹ ŋ	숭경
숭경하다	sʰ u ŋ ɡ j ʌ̹ ŋ ɦ a̠ d a̠	숭경하다
숭고	sʰ u ŋ ɡ o̞	숭고
숯	sʰ u t̚	숟
숱	sʰ u t̚	숟
숲	sʰ u p̚	숩
숲들쥐	sʰ u p̚ t͈ ɯ ʎ d͡ʑ ɥ i	숩뜰쥐
숲비둘기	sʰ u p̚ p͈ i d u ɭ ɡ i	숩삐둘기
숴	sʰ w ʌ̹	숴
쉐	sʰ w e̞	쉐
쉘	sʰ w e̞ ɭ	쉘
쉬	ʃʰ ɥ i	쉬
쉬리	ʃʰ ɥ i ɾ i	쉬리
쉰	ʃʰ ɥ iː n	쉰
쉴드치다	ʃʰ ɥ i ɭ d ɯ t͡ɕʰ i d a̠	쉴드치다
쉼	ʃʰ ɥ i m	쉼
슈	ɕʰ u	수
슈니첼	ɕʰ u n i t͡ɕʰ e̞ ɭ	수니첼
슈인	ɕʰ u i n	수인
슈트케이스	ɕʰ u tʰ ɯ kʰ e̞ i s͈ ɯ	수트케이쓰
슈퍼마케트	ɕʰ u pʰ ʌ̹ m a̠ kʰ e̞ tʰ ɯ	수퍼마케트
슈퍼모델	ɕʰ u pʰ ʌ̹ m o̞ d e̞ ɭ	수퍼모델
슛	ɕʰ u t̚	숟
스	sʰ ɯ	스
스께또	sʰ ɯ k͈ e̞ t͈ o̞	스께또
스드메	sʰ ɯ d ɯ m e̞	스드메
스무	sʰ ɯ m u	스무
스무날	sʰ ɯ m u n a̠ ɭ	스무날
스미다	sʰ ɯ m i d a̠	스미다
스빠게띠	sʰ ɯ p͈ a̠ ɡ e̞ t͈ i	스빠게띠
스시녀	sʰ ɯ ɕʰ i ɲ ʌ̹	스시너
스압	sʰ ɯ a̠ p̚	스압
스와질란드	sʰ ɯ w a̠ d͡ʑ i ɭ ɭ a̠ n d ɯ	스와질란드
스웨덴어	sʰ ɯ w e̞ d e̞ n ʌ̹	스웨데너
스치다	sʰ ɯ t͡ɕʰ i d a̠	스치다
스카	sʰ ɯ kʰ a̠	스카
스칸듐	sʰ ɯ kʰ a̠ n d j u m	스칸듐
스칸디나비아	sʰ ɯ kʰ a̠ n d i n a̠ b i a̠	스칸디나비아
스케트	sʰ ɯ kʰ e̞ tʰ ɯ	스케트
스코어보드	sʰ ɯ kʰ o̞ ʌ̹ b o̞ d ɯ	스코어보드
스코페	sʰ ɯ kʰ o̞ pʰ e̞	스코페
스크롤링	sʰ ɯ k x ɯ ɾ o̞ ʎ ʎ i ŋ	스크롤링
스타디오	sʰ ɯ tʰ a̠ d i o̞	스타디오
스테아르산	sʰ ɯ tʰ e̞ a̠ ɾ ɯ sʰ a̠ n	스테아르산
스토리	sʰ ɯ tʰ o̞ ɾ i	스토리
스토커	sʰ ɯ tʰ o̞ kʰ ʌ̹	스토커
스트레칭	sʰ ɯ tʰ ɯ ɾ e̞ t͡ɕʰ i ŋ	스트레칭
스틱	sʰ ɯ tʰ i k̚	스틱
스폰서	sʰ ɯ pʰ o̞ n s͈ ʌ̹	스폰써
스풀	sʰ ɯ pʰ u ɭ	스풀
스핑크스	sʰ ɯ pʰ i ŋ k x ɯ sʰ ɯ	스핑크스
슬	sʰ ɯ ɭ	슬
슬기롭다	sʰ ɯ ɭ ɡ i ɾ o̞ p̚ t͈ a̠	슬기롭따
슬라이드	sʰ ɯ ɭ ɭ a̠ i d ɯ	슬라이드
슬픔증	sʰ ɯ ɭ pʰ ɯ m t͡ɕ͈ ɯ ŋ	슬픔쯩
슴가	sʰ ɯ m ɡ a̠	슴가
습	sʰ ɯ p̚	습
습성	sʰ ɯ p s͈ ʌ̹ ŋ	습썽
승	sʰ ɯ ŋ	승
승리자	sʰ ɯ ŋ n i d͡ʑ a̠	승니자
승리하다	sʰ ɯ ŋ n i ɦ a̠ d a̠	승니하다
승방	sʰ ɯ ŋ b a̠ ŋ	승방
승복	sʰ ɯ ŋ b o̞ k̚	승복
승부조작	sʰ ɯ ŋ b u d͡ʑ o̞ d͡ʑ a̠ k̚	승부조작
승산	sʰ ɯ ŋ sʰ a̠ n	승산
승원	sʰ ɯ ŋ w ʌ̹ n	승원
승인	sʰ ɯ ŋ i n	승인
승인하다	sʰ ɯ ŋ i n ɦ a̠ d a̠	승인하다
승전	sʰ ɯ ŋ d͡ʑ ʌ̹ n	승전
승전하다	sʰ ɯ ŋ d͡ʑ ʌ̹ n ɦ a̠ d a̠	승전하다
승진되다	sʰ ɯ ŋ d͡ʑ i n d w e̞ d a̠	승진되다
승진하다	sʰ ɯ ŋ d͡ʑ i n ɦ a̠ d a̠	승진하다
승탑	sʰ ɯ ŋ tʰ a̠ p̚	승탑
승하	sʰ ɯ ŋ ɦ a̠	승하
승학연	sʰ ɯ ŋ ɦ a̠ ɡ j ʌ̹ n	승하견
시	ɕʰ i	시
시각	ɕʰ i ɡ a̠ k̚	시각
시골길	ɕʰ i ɡ o̞ ɭ ɡ i ɭ	시골길
시기	ɕʰ i ɡ i	시기
시나이	ɕʰ i n a̠ i	시나이
시더구	ɕʰ i d ʌ̹ ɡ u	시더구
시들다	ɕʰ i d ɯ ɭ d a̠	시들다
시무룩	ɕʰ i m u ɾ u k̚	시무룩
시무룩하다	ɕʰ i m u ɾ u kʰ a̠ d a̠	시무루카다
시발	ɕʰ i b a̠ ɭ	시발
시보귬	ɕʰ i b o̞ ɡ j u m	시보귬
시소	ɕʰ i sʰ o̞	시소
시숙	ɕʰ i sʰ u k̚	시숙
시시덕거리다	ɕʰ i ɕʰ i d ʌ̹ k̚ k͈ ʌ̹ ɾ i d a̠	시시덕꺼리다
시알코트	ɕʰ i a̠ ɭ kʰ o̞ tʰ ɯ	시알코트
시앗	ɕʰ i a̠ t̚	시앋
시옷	ɕʰ i o̞ t̚	시옫
시왕	ɕʰ i w a̠ ŋ	시왕
시유	ɕʰ iː j u	시유
시유하다	ɕʰ iː j u ɦ a̠ d a̠	시유하다
시음	ɕʰ iː ɯ m	시음
시인	ɕʰ i i n	시인
시작	ɕʰ i d͡ʑ a̠ k̚	시작
시장	ɕʰ i d͡ʑ a̠ ŋ	시장
시장하다	ɕʰ i d͡ʑ a̠ ŋ ɦ a̠ d a̠	시장하다
시조	ɕʰ i d͡ʑ o̞	시조
시조조	ɕʰ iː d͡ʑ o̞ d͡ʑ o̞	시조조
시집가다	ɕʰ i d͡ʑ i p̚ k͈ a̠ d a̠	시집까다
시차	ɕʰ i t͡ɕʰ a̠	시차
시큰	ɕʰ i k x ɯ n	시큰
시프다	ɕʰ i pʰ ɯ d a̠	시프다
시혜	ɕʰ iː ʝ e̞	시헤
시호	ɕʰ i β o̞	시호
식	ɕʰ i k̚	식
식단	ɕʰ i k̚ t͈ a̠ n	식딴
식료	ɕʰ i ŋ ɲ o	싱뇨
식민	ɕʰ i ŋ m i n	싱민
식민지화	ɕʰ i ŋ m i ɲ d͡ʑ i β w a̠	싱민지화
식사하다	ɕʰ i k s͈ a̠ ɦ a̠ d a̠	식싸하다
식성	ɕʰ i k s͈ ʌ̹ ŋ	식썽
식수	ɕʰ i k s͈ u	식쑤
식순	ɕʰ i k s͈ u n	식쑨
식인	ɕʰ i ɡ i n	시긴
식칼	ɕʰ i k̚ kʰ a̠ ɭ	식칼
신	ɕʰ i n	신
신강	ɕʰ i n ɡ a̠ ŋ	신강
신경언어학	ɕʰ i n ɡ j ʌ̹ ŋ ʌ̹ n ʌ̹ ɦ a̠ k̚	신경어너학
신경학	ɕʰ i n ɡ j ʌ̹ ŋ ɦ a̠ k̚	신경학
신고인	ɕʰ i n ɡ o̞ i n	신고인
신군부	ɕʰ i n ɡ u n b u	신군부
신나다	ɕʰ i n n a̠ d a̠	신나다
신년사	ɕʰ i n ɲ ʌ̹ n sʰ a̠	신넌사
신놀린	ɕʰ i n n o̞ ʎ ʎ i n	신놀린
신농	ɕʰ i n n o̞ ŋ	신농
신동	ɕʰ i n d o̞ ŋ	신동
신디케이트	ɕʰ i n d i kʰ e̞ i tʰ ɯ	신디케이트
신뢰하다	ɕʰ iː ɭ ɭ w e̞ ɦ a̠ d a̠	실뢰하다
신명기	ɕʰ i n m j ʌ̹ ŋ ɡ i	신명기
신물	ɕʰ i n m u ɭ	신물
신박하다	ɕʰ i n b a̠ kʰ a̠ d a̠	신바카다
신변잡기	ɕʰ i n b j ʌ̹ ɲ d͡ʑ a̠ p̚ k͈ i	신변잡끼
신병	ɕʰ i n b j ʌ̹ ŋ	신병
신부모	ɕʰ i n b u m o̞	신부모
신비하다	ɕʰ i n b i ɦ a̠ d a̠	신비하다
신빙성	ɕʰ iː n b i ŋ s͈ ʌ̹ ŋ	신빙썽
신성하다	ɕʰ i n sʰ ʌ̹ ŋ ɦ a̠ d a̠	신성하다
신자식	ɕʰ i ɲ d͡ʑ a̠ ɕʰ i k̚	신자식
신장	ɕʰ i ɲ d͡ʑ a̠ ŋ	신장
신점	ɕʰ i ɲ d͡ʑ ʌ̹ m	신점
신젖	ɕʰ i ɲ d͡ʑ ʌ̹ t̚	신젇
신천옹	ɕʰ iː ɲ t͡ɕʰ ʌ̹ n o̞ ŋ	신처농
신청하다	ɕʰ i ɲ t͡ɕʰ ʌ̹ ŋ ɦ a̠ d a̠	신청하다
신포	ɕʰ i n pʰ o̞	신포
신하	ɕʰ i n ɦ a̠	신하
싣다	ɕʰ iː t̚ t͈ a̠	싣따
실	ɕʰ i ɭ	실
실고기	ɕʰ iː ɭ ɡ o̞ ɡ i	실고기
실눈	ɕʰ iː ɭ ɭ u n	실룬
실뜨기	ɕʰ i ɭ t͈ ɯ ɡ i	실뜨기
실례하다	ɕʰ i ʎ ʎ e̞ ɦ a̠ d a̠	실레하다
실리다	ɕʰ i ʎ ʎ i d a̠	실리다
실리콘	ɕ͈ i ʎ ʎ i kʰ o̞ n	씰리콘
실솔	ɕʰ i ɭ s͈ o̞ ɭ	실쏠
실수하다	ɕʰ i ɭ s͈ u ɦ a̠ d a̠	실쑤하다
실시되다	ɕʰ i ɭ ɕʰ i d w e̞ d a̠	실시되다
실시하다	ɕʰ i ɭ ɕʰ i ɦ a̠ d a̠	실시하다
실연	ɕʰ i ɾ j ʌ̹ n	시련
실적	ɕʰ i ʎ t͡ɕ͈ ʌ̹ k̚	실쩍
실종되다	ɕʰ i ʎ d͡ʑ o̞ ŋ d w e̞ d a̠	실종되다
실천하다	ɕʰ i ʎ t͡ɕʰ ʌ̹ n ɦ a̠ d a̠	실천하다
실파	ɕʰ iː ɭ pʰ a̠	실파
실험실	ɕʰ i ɾ ɦ ʌ̹ m ɕʰ i ɭ	실험실
실험하다	ɕʰ i ɾ ɦ ʌ̹ m ɦ a̠ d a̠	실험하다
실현하다	ɕʰ i ɾ ʝ ʌ̹ n ɦ a̠ d a̠	실헌하다
심	ɕʰ i m	심
심려	ɕʰ i m ɲ ʌ̹	심너
심리학자	ɕʰ i m n i ɦ a̠ k̚ t͡ɕ͈ a̠	심니학짜
심문	ɕʰ i m m u n	심문
심문하다	ɕʰ i m m u n ɦ a̠ d a̠	심문하다
심박수	ɕʰ i m b a̠ k s͈ u	심박쑤
심방	ɕʰ i m b a̠ ŋ	심방
심벌즈	ɕ͈ i m b ʌ̹ ʎ d͡ʑ ɯ	씸벌즈
심부름하다	ɕʰ i m b u ɾ ɯ m ɦ a̠ d a̠	심부름하다
심산유곡	ɕʰ iː m sʰ a̠ n ɲ u ɡ o̞ k̚	심산누곡
심야	ɕʰ iː m j a̠	시먀
심인성	ɕʰ i m i n s͈ ʌ̹ ŋ	시민썽
심페로폴	ɕʰ i m pʰ e̞ ɾ o̞ pʰ o̞ ɭ	심페로폴
심호흡	ɕʰ iː m β o̞ ɣ ɯ p̚	심호흡
심혼	ɕʰ i m β o̞ n	심혼
심화	ɕʰ i m β w a̠	심화
십	ɕʰ i p̚	십
십구	ɕʰ i p̚ k͈ u	십꾸
십날	ɕʰ i m n a̠ ɭ	심날
십사	ɕʰ i p s͈ a̠	십싸
십육	ɕʰ i m ɲ u k̚	심눅
십일	ɕʰ i b i ɭ	시빌
십자고상	ɕʰ i p̚ t͡ɕ͈ a̠ ɡ o̞ sʰ a̠ ŋ	십짜고상
십진법	ɕʰ i p̚ t͡ɕ͈ i n p͈ ʌ̹ p̚	십찐뻡
십팔	ɕʰ i p̚ pʰ a̠ ɭ	십팔
싯	ɕʰ i t̚	싣
싱겁다	ɕʰ i ŋ ɡ ʌ̹ p̚ t͈ a̠	싱겁따
싱글	ɕʰ i ŋ ɡ ɯ ɭ	싱글
싱싱하다	ɕʰ i ŋ ɕʰ i ŋ ɦ a̠ d a̠	싱싱하다
싱어	ɕʰ i ŋ ʌ̹	싱어
싱어송라이터	ɕ͈ i ŋ ʌ̹ s͈ o̞ ŋ n a̠ i tʰ ʌ̹	씽어쏭나이터
싸	s͈ a̠	싸
싸게	s͈ a̠ ɡ e̞	싸게
싸불	s͈ a̠ b u ɭ	싸불
싸스	s͈ a̠ sʰ ɯ	싸스
싸울아비	s͈ a̠ u ɾ a̠ b i	싸우라비
싸움터	s͈ a̠ u m tʰ ʌ̹	싸움터
싸이다	s͈ a̠ i d a̠	싸이다
싸인펜	s͈ a̠ i n pʰ e̞ n	싸인펜
싹	s͈ a̠ k̚	싹
싼룬처	s͈ a̠ ɭ ɭ u ɲ t͡ɕʰ ʌ̹	쌀룬처
쌀	s͈ a̠ ɭ	쌀
쌈	s͈ a̠ m	쌈
쌍	s͈ a̠ ŋ	쌍
쌍곡선	s͈ a̠ ŋ ɡ o̞ k s͈ ʌ̹ n	쌍곡썬
쌍기역	s͈ a̠ ŋ ɡ i j ʌ̹ k̚	쌍기역
쌍동이	s͈ a̠ ŋ d o̞ ŋ i	쌍동이
쌍반점	s͈ a̠ ŋ b a̠ ɲ d͡ʑ ʌ̹ m	쌍반점
쌍발	s͈ a̠ ŋ b a̠ ɭ	쌍발
쌍봉낙타	s͈ a̠ ŋ b o̞ ŋ n a̠ k̚ tʰ a̠	쌍봉낙타
쌍비읍	s͈ a̠ ŋ b i ɯ p̚	쌍비읍
쌍살벌	s͈ a̠ ŋ sʰ a̠ ɭ b ʌ̹ ɭ	쌍살벌
쌍절곤	s͈ a̠ ŋ d͡ʑ ʌ̹ ɭ ɡ o̞ n	쌍절곤
쌍점	s͈ a̠ ŋ d͡ʑ ʌ̹ m	쌍점
쌍정	s͈ a̠ ŋ d͡ʑ ʌ̹ ŋ	쌍정
쌍지읒	s͈ a̠ ŋ d͡ʑ i ɯ t̚	쌍지읃
쌓이다	s͈ a̠ i d a̠	싸이다
쌤	s͈ ɛː m	쌤
쌤통	s͈ ɛː m tʰ o̞ ŋ	쌤통
써레	s͈ ʌ̹ ɾ e̞	써레
썩	s͈ ʌ̹ k̚	썩
썩다	s͈ ʌ̹ k̚ t͈ a̠	썩따
썩음썩음하다	s͈ ʌ̹ ɡ ɯ m s͈ ʌ̹ ɡ ɯ m ɦ a̠ d a̠	써금써금하다
썬글라스	s͈ ʌ̹ n ɡ ɯ ɭ ɭ a̠ sʰ ɯ	썬글라스
썰	s͈ ʌ̹ ɭ	썰
썰썰	s͈ ʌ̹ ɭ s͈ ʌ̹ ɭ	썰썰
썸	s͈ ʌ̹ m	썸
썸팅	s͈ ʌ̹ m tʰ i ŋ	썸팅
쎄다	s͈ e̞ː d a̠	쎄다
쏘련	s͈ o̞ ɾ j ʌ̹ n	쏘련
쏘비에트	s͈ o̞ b i e̞ tʰ ɯ	쏘비에트
쏘아보다	s͈ o̞ a̠ b o̞ d a̠	쏘아보다
쏙	s͈ o̞ k̚	쏙
쏟다	s͈ o̞ t̚ t͈ a̠	쏟따
쏠다	s͈ o̞ː ɭ d a̠	쏠다
쏠리다	s͈ o̞ ʎ ʎ i d a̠	쏠리다
쏼라쏼라	s͈ w a̠ ɭ ɭ a̠ s͈ w a̠ ɭ ɭ a̠	쏼라쏼라
쑥	s͈ u k̚	쑥
쒀이러우	s͈ w ʌ̹ i ɾ ʌ̹ u	쒀이러우
쓰나미	s͈ ɯ n a̠ m i	쓰나미
쓰똘	s͈ ɯ t͈ o̞ ɭ	쓰똘
쓰레받기	s͈ ɯ ɾ e̞ b a̠ t̚ k͈ i	쓰레받끼
쓰르라미	s͈ ɯ ɾ ɯ ɾ a̠ m i	쓰르라미
쓰봉	s͈ ɯ b o̞ ŋ	쓰봉
쓸다	s͈ ɯ ɭ d a̠	쓸다
쓸데없다	s͈ ɯ ɭ t͈ e̞ ʌ̹ p̚ t͈ a̠	쓸떼업따
쓸어일어나다	s͈ ɯ ɾ ʌ̹ i ɾ ʌ̹ n a̠ d a̠	쓰러이러나다
씨	ɕ͈ i	씨
씨뚜아찌야	ɕ͈ i t͈ u a̠ t͡ɕ͈ i j a̠	씨뚜아찌야
씨발	ɕ͈ i b a̠ ɭ	씨발
씨수	ɕ͈ i sʰ u	씨수
씨엄히	ɕ͈ iː ʌ̹ m ʝ i	씨엄히
씨족	ɕ͈ i d͡ʑ o̞ k̚	씨족
씨팔	ɕ͈ i pʰ a̠ ɭ	씨팔
씩	ɕ͈ i k̚	씩
씹	ɕ͈ i p̚	씹
씹두덩	ɕ͈ i p̚ t͈ u d ʌ̹ ŋ	씹뚜덩
씹하다	ɕ͈ i pʰ a̠ d a̠	씨파다
씻은듯이	ɕ͈ i sʰ ɯ n d ɯ ɕʰ i	씨슨드시
씽글	ɕ͈ i ŋ ɡ ɯ ɭ	씽글
씽글씽글	ɕ͈ i ŋ ɡ ɯ ɭ ɕ͈ i ŋ ɡ ɯ ɭ	씽글씽글
아	a̠	아
아가	a̠ ɡ a̠	아가
아교	a̠ ɡ j o	아교
아국	a̠ː ɡ u k̚	아국
아귀	a̠ ɡ ɥ i	아귀
아기미	a̠ ɡ i m i	아기미
아기집	a̠ ɡ i d͡ʑ i p̚	아기집
아끼다	a̠ k͈ i d a̠	아끼다
아나테마	a̠ n a̠ tʰ e̞ m a̠	아나테마
아뇰로티	a̠ ɲ o ɭ ɭ o̞ tʰ i	아뇰로티
아니꼽다	a̠ n i k͈ o̞ p̚ t͈ a̠	아니꼽따
아니라	a̠ n i ɾ a̠	아니라
아다	a̠ d a̠	아다
아도	a̠ d o̞	아도
아라비아인	a̠ ɾ a̠ b i a̠ i n	아라비아인
아라사	a̠ ɾ a̠ sʰ a̠	아라사
아락	a̠ ɾ a̠ k̚	아락
아람어	a̠ ɾ a̠ m ʌ̹	아라머
아레스	a̠ ɾ e̞ sʰ ɯ	아레스
아령	a̠ː ɾ j ʌ̹ ŋ	아령
아뢰다	a̠ ɾ w e̞ d a̠	아뢰다
아뢰야식	a̠ ɾ w e̞ j a̠ ɕʰ i k̚	아뢰야식
아르곤	a̠ ɾ ɯ ɡ o̞ n	아르곤
아르마딜로	a̠ ɾ ɯ m a̠ d i ɭ ɭ o̞	아르마딜로
아리땁다	a̠ ɾ i t͈ a̠ p̚ t͈ a̠	아리땁따
아리조나	a̠ ɾ i d͡ʑ o̞ n a̠	아리조나
아말감	a̠ m a̠ ɭ ɡ a̠ m	아말감
아메리슘	a̠ m e̞ ɾ i ɕʰ u m	아메리숨
아메리카너구리	a̠ m e̞ ɾ i kʰ a̠ n ʌ̹ ɡ u ɾ i	아메리카너구리
아메리카원앙	a̠ m e̞ ɾ i kʰ a̠ w ʌ̹ n a̠ ŋ	아메리카워낭
아메리카홍머리오리	a̠ m e̞ ɾ i kʰ a̠ β o̞ ŋ m ʌ̹ ɾ i o̞ ɾ i	아메리카홍머리오리
아무것	a̠ː m u ɡ ʌ̹ t̚	아무걷
아무렇다	a̠ː m u ɾ ʌ̹ tʰ a̠	아무러타
아물다	a̠ m u ɭ d a̠	아물다
아물리다	a̠ m u ʎ ʎ i d a̠	아물리다
아미노	a̠ m i n o̞	아미노
아미딘	a̠ m i d i n	아미딘
아바이	a̠ b a̠ i	아바이
아바지	a̠ b a̠ d͡ʑ i	아바지
아방궁	a̠ b a̠ ŋ ɡ u ŋ	아방궁
아베크	a̠ b e̞ k x ɯ	아베크
아부지	a̠ b u d͡ʑ i	아부지
아비달마	a̠ b i d a̠ ɭ m a̠	아비달마
아비장	a̠ b i d͡ʑ a̠ ŋ	아비장
아산	a̠ sʰ a̠ n	아산
아세나프텐	a̠ sʰ e̞ n a̠ pʰ ɯ tʰ e̞ n	아세나프텐
아스마라	a̠ sʰ ɯ m a̠ ɾ a̠	아스마라
아스콜빅산	a̠ sʰ ɯ kʰ o̞ ɭ b i k s͈ a̠ n	아스콜빅싼
아스테카	a̠ sʰ ɯ tʰ e̞ kʰ a̠	아스테카
아스팔트	a̠ sʰ ɯ pʰ a̠ ɭ tʰ ɯ	아스팔트
아스하바트	a̠ sʰ ɯ ɦ a̠ b a̠ tʰ ɯ	아스하바트
아실기	a̠ ɕʰ i ɭ ɡ i	아실기
아씨	a̠ː ɕ͈ i	아씨
아우르다	a̠ u ɾ ɯ d a̠	아우르다
아유르베다	a̠ j u ɾ ɯ b e̞ d a̠	아유르베다
아으	a̠ ɯ	아으
아이누어	a̠ i n u ʌ̹	아이누어
아이다호	a̠ i d a̠ β o̞	아이다호
아이띠	a̠ i t͈ i	아이띠
아이스케이크	a̠ i sʰ ɯ kʰ e̞ i k x ɯ	아이스케이크
아이슬란드어	a̠ i sʰ ɯ ɭ ɭ a̠ n d ɯ ʌ̹	아이슬란드어
아이오딘	a̠ i o̞ d i n	아이오딘
아이오와	a̠ i o̞ w a̠	아이오와
아인슈타이늄	a̠ i n ɕʰ u tʰ a̠ i ɲ u m	아인수타이눔
아전인수	a̠ː d͡ʑ ʌ̹ n i n sʰ u	아저닌수
아제르바이잔어	a̠ d͡ʑ e̞ ɾ ɯ b a̠ i d͡ʑ a̠ n ʌ̹	아제르바이자너
아즈텍	a̠ d͡ʑ ɯ tʰ e̞ k̚	아즈텍
아집	a̠ː d͡ʑ i p̚	아집
아첨	a̠ t͡ɕʰ ʌ̹ m	아첨
아첨꾼	a̠ t͡ɕʰ ʌ̹ m k͈ u n	아첨꾼
아칙	a̠ t͡ɕʰ i k̚	아칙
아침놀	a̠ t͡ɕʰ i m n o̞ ɭ	아침놀
아카이브	a̠ kʰ a̠ i b ɯ	아카이브
아칸소	a̠ kʰ a̠ n sʰ o̞	아칸소
아콰리움	a̠ kʰ w a̠ ɾ i u m	아콰리움
아테나	a̠ tʰ e̞ n a̠	아테나
아테지	a̠ tʰ e̞ d͡ʑ i	아테지
아틀란티스	a̠ tʰ ɯ ɭ ɭ a̠ n tʰ i sʰ ɯ	아틀란티스
아포스트로피	a̠ pʰ o̞ sʰ ɯ tʰ ɯ ɾ o̞ pʰ i	아포스트로피
아프리칸스어	a̠ pʰ ɯ ɾ i kʰ a̠ n sʰ ɯ ʌ̹	아프리칸스어
아피아	a̠ pʰ i a̠	아피아
악	a̠ k̚	악
악경	a̠ k̚ k͈ j ʌ̹ ŋ	악꼉
악귀	a̠ k̚ k͈ ɥ i	악뀌
악랄	a̠ ŋ n a̠ ɭ	앙날
악랄하다	a̠ ŋ n a̠ ɾ ɦ a̠ d a̠	앙날하다
악력계	a̠ ŋ ɲ ʌ̹ k̚ k͈ j e̞	앙넉꼐
악령	a̠ ŋ ɲ ʌ̹ ŋ	앙넝
악보	a̠ k̚ p͈ o̞	악뽀
악성비루스	a̠ k s͈ ʌ̹ ŋ b i ɾ u sʰ ɯ	악썽비루스
악센트	a̠ k s͈ e̞ n tʰ ɯ	악쎈트
악수하다	a̠ k s͈ u ɦ a̠ d a̠	악쑤하다
악역	a̠ ɡ j ʌ̹ k̚	아격
악티늄	a̠ k̚ tʰ i ɲ u m	악티눔
악하다	a̠ kʰ a̠ d a̠	아카다
악화	a̠ kʰ w a̠	아콰
악화되다	a̠ kʰ w a̠ d w e̞ d a̠	아콰되다
악화하다	a̠ kʰ w a̠ ɦ a̠ d a̠	아콰하다
안	a̠ n	안
안가	a̠ n ɡ a̠	안가
안기다	a̠ː n ɡ i d a̠	안기다
안남	a̠ n n a̠ m	안남
안녕하다	a̠ n ɲ ʌ̹ ŋ ɦ a̠ d a̠	안넝하다
안도라라베야	a̠ n d o̞ ɾ a̠ ɾ a̠ b e̞ j a̠	안도라라베야
안뜰	a̠ n t͈ ɯ ɭ	안뜰
안락	a̠ ɭ ɭ a̠ k̚	알락
안마당	a̠ n m a̠ d a̠ ŋ	안마당
안면	a̠ n m j ʌ̹ n	안면
안목	a̠ n m o̞ k̚	안목
안사람	a̠ n s͈ a̠ ɾ a̠ m	안싸람
안식일	a̠ n ɕʰ i ɡ i ɭ	안시길
안와	a̠ː n w a̠	아놔
안장	a̠ː ɲ d͡ʑ a̠ ŋ	안장
안전가옥	a̠ ɲ d͡ʑ ʌ̹ n ɡ a̠ o̞ k̚	안전가옥
안절부절하다	a̠ ɲ d͡ʑ ʌ̹ ɭ b u d͡ʑ ʌ̹ ɾ ɦ a̠ d a̠	안절부절하다
안직	a̠ ɲ d͡ʑ i k̚	안직
안초비	a̠ ɲ t͡ɕʰ o̞ b i	안초비
안트라센	a̠ n tʰ ɯ ɾ a̠ sʰ e̞ n	안트라센
안티모니	a̠ n tʰ i m o̞ n i	안티모니
앉다	a̠ n t͈ a̠	안따
앉은자리	a̠ ɲ d͡ʑ ɯ ɲ d͡ʑ a̠ ɾ i	안즌자리
알데하이드	a̠ ɭ d e̞ ɦ a̠ i d ɯ	알데하이드
알라바마	a̠ ɭ ɭ a̠ b a̠ m a̠	알라바마
알라신	a̠ ɭ ɭ a̠ ɕʰ i n	알라신
알락도요	a̠ ɭ ɭ a̠ k̚ t͈ o̞ j o	알락또요
알락오리	a̠ ɭ ɭ a̠ ɡ o̞ ɾ i	알라고리
알람	a̠ ɭ ɭ a̠ m	알람
알레고리	a̠ ɭ ɭ e̞ ɡ o̞ ɾ i	알레고리
알레르기성	a̠ ɭ ɭ e̞ ɾ ɯ ɡ i s͈ ʌ̹ ŋ	알레르기썽
알렉산더	a̠ ɭ ɭ e̞ k s͈ a̠ n d ʌ̹	알렉싼더
알리바바	a̠ ʎ ʎ i b a̠ b a̠	알리바바
알릴기	a̠ ʎ ʎ i ɭ ɡ i	알릴기
알못	a̠ː ɭ m o̞ t̚	알몯
알버타	a̠ ɭ b ʌ̹ tʰ a̠	알버타
알아차리다	a̠ ɾ a̠ t͡ɕʰ a̠ ɾ i d a̠	아라차리다
알카인	a̠ ɭ kʰ a̠ i n	알카인
앎	a̠ː m	암
앓아눕다	a̠ ɾ a̠ n u p̚ t͈ a̠	아라눕따
암	a̠ m	암
암기하다	a̠ː m ɡ i ɦ a̠ d a̠	암기하다
암묵	a̠ m m u k̚	암묵
암살자	a̠ː m sʰ a̠ ʎ t͡ɕ͈ a̠	암살짜
암순응	a̠ː m sʰ u n ɯ ŋ	암수능
암시하다	a̠ː m ɕʰ i ɦ a̠ d a̠	암시하다
암유	a̠ː m j u	아뮤
암페어	a̠ m pʰ e̞ ʌ̹	암페어
암표	a̠ː m pʰ j o	암표
암표상	a̠ː m pʰ j o sʰ a̠ ŋ	암표상
압	a̠ p̚	압
압권	a̠ p̚ k͈ w ʌ̹ n	압꿘
압록자그사니	a̠ m n o̞ k̚ t͡ɕ͈ a̠ ɡ ɯ sʰ a̠ n i	암녹짜그사니
압수	a̠ p s͈ u	압쑤
압운	a̠ b u n	아분
압제	a̠ p̚ t͡ɕ͈ e̞	압쩨
앗	a̠ t̚	앋
앗다	a̠ t̚ t͈ a̠	앋따
앙	a̠ ŋ	앙
앙까	a̠ ŋ k͈ a̠	앙까
앙등	a̠ː ŋ d ɯ ŋ	앙등
앞	a̠ p̚	압
앞당기다	a̠ p̚ t͈ a̠ ŋ ɡ i d a̠	압땅기다
앞두다	a̠ p̚ t͈ u d a̠	압뚜다
앞머리	a̠ m m ʌ̹ ɾ i	암머리
앞문	a̠ m m u n	암문
앞장서다	a̠ p̚ t͡ɕ͈ a̠ ŋ sʰ ʌ̹ d a̠	압짱서다
앞치마	a̠ p̚ t͡ɕʰ i m a̠	압치마
애	ɛː	애
애견	ɛː ɡ j ʌ̹ n	애견
애국	ɛː ɡ u k̚	애국
애국가	ɛː ɡ u k̚ k͈ a̠	애국까
애기망둑	ɛː ɡ i m a̠ ŋ d u k̚	애기망둑
애동제자	ɛː d o̞ ŋ d͡ʑ e̞ d͡ʑ a̠	애동제자
애란	ɛː ɾ a̠ n	애란
애묘	ɛː m j o	애묘
애무	ɛː m u	애무
애무하다	ɛː m u ɦ a̠ d a̠	애무하다
애삐리다	e̞ p͈ i ɾ i d a̠	에삐리다
애사심	ɛː sʰ a̠ ɕʰ i m	애사심
애완	ɛː w a̠ n	애완
애완견	ɛː w a̠ n ɡ j ʌ̹ n	애완견
애완묘	ɛː w a̠ n m j o	애완묘
애완조	ɛː w a̠ ɲ d͡ʑ o̞	애완조
애월하다	ɛː w ʌ̹ ɾ ɦ a̠ d a̠	애월하다
애조	ɛː d͡ʑ o̞	애조
애증	ɛː d͡ʑ ɯ ŋ	애증
애호자	ɛː β o̞ d͡ʑ a̠	애호자
앵기다	ɛː ŋ ɡ i d a̠	앵기다
야	j a̠ː	야
야곱	j a̠ ɡ o̞ p̚	야곱
야근	j a̠ː ɡ ɯ n	야근
야기하다	j a̠ː ɡ i ɦ a̠ d a̠	야기하다
야동	j a̠ː d o̞ ŋ	야동
야레	j a̠ ɾ e̞	야레
야릇하다	j a̠ ɾ ɯ tʰ a̠ d a̠	야르타다
야부리	j a̠ b u ɾ i	야부리
야비하다	j a̠ː b i ɦ a̠ d a̠	야비하다
야설	j a̠ː sʰ ʌ̹ ɭ	야설
야속하다	j a̠ː sʰ o̞ kʰ a̠ d a̠	야소카다
야수	j a̠ː sʰ u	야수
야옹	j a̠ o̞ ŋ	야옹
야외	j a̠ː w e̞	야외
야운데	j a̠ u n d e̞	야운데
야자유	j a̠ː d͡ʑ a̠ j u	야자유
야자집게	j a̠ d͡ʑ a̠ d͡ʑ i p̚ k͈ e̞	야자집께
야짤	j a̠ t͡ɕ͈ a̠ ɭ	야짤
야차	j a̠ t͡ɕʰ a̠	야차
야쿠츠크	j a̠ kʰ u t͡ɕʰ ɯ k x ɯ	야쿠츠크
야호	j a̠ː β o̞	야호
야회	j a̠ː β w e̞	야회
약	j a̠ k̚	약
약속하다	j a̠ k s͈ o̞ kʰ a̠ d a̠	약쏘카다
얄궂다	j a̠ ɭ ɡ u t̚ t͈ a̠	얄굳따
얌전하다	j a̠ m d͡ʑ ʌ̹ n ɦ a̠ d a̠	얌전하다
얌차	j a̠ m t͡ɕʰ a̠	얌차
양	j a̠ ŋ	양
양궁	j a̠ ŋ ɡ u ŋ	양궁
양봉가	j a̠ː ŋ b o̞ ŋ ɡ a̠	양봉가
양봉장	j a̠ː ŋ b o̞ ŋ d͡ʑ a̠ ŋ	양봉장
양산	j a̠ ŋ sʰ a̠ n	양산
양수	j a̠ ŋ sʰ u	양수
양우	j a̠ ŋ u	양우
양자화	j a̠ ŋ d͡ʑ a̠ β w a̠	양자화
양지	j a̠ː ŋ d͡ʑ i	양지
양질	j a̠ ŋ d͡ʑ i ɭ	양질
양치	j a̠ ŋ t͡ɕʰ i	양치
양치기	j a̠ ŋ t͡ɕʰ i ɡ i	양치기
양탄자	j a̠ ŋ tʰ a̠ ɲ d͡ʑ a̠	양탄자
양팔	j a̠ː ŋ pʰ a̠ ɭ	양팔
양하	j a̠ ŋ ɦ a̠	양하
양혜	j a̠ ŋ ʝ e̞	양헤
얕보다	j a̠ t̚ p͈ o̞ d a̠	얃뽀다
얕잡다	j a̠ t̚ t͡ɕ͈ a̠ p̚ t͈ a̠	얃짭따
어	ʌ̹	어
어귀	ʌ̹ ɡ ɥ i	어귀
어두워지다	ʌ̹ d u w ʌ̹ d͡ʑ i d a̠	어두워지다
어드메	ʌ̹ d ɯ m e̞	어드메
어디여	ʌ̹ d i j ʌ̹	어디여
어떠하다	ʌ̹ t͈ ʌ̹ ɦ a̠ d a̠	어떠하다
어룡	ʌ̹ ɾ j o ŋ	어룡
어리광	ʌ̹ ɾ i ɡ w a̠ ŋ	어리광
어마니	ʌ̹ m a̠ n i	어마니
어머이	ʌ̹ m ʌ̹ i	어머이
어미	ʌ̹ m i	어미
어벙하다	ʌ̹ b ʌ̹ ŋ ɦ a̠ d a̠	어벙하다
어븀	ʌ̹ b j u m	어븀
어사	ʌ̹ sʰ a̠	어사
어야	ʌ̹ j a̠	어야
어업	ʌ̹ ʌ̹ p̚	어업
어엿하다	ʌ̹ j ʌ̹ tʰ a̠ d a̠	어여타다
어우러지다	ʌ̹ u ɾ ʌ̹ d͡ʑ i d a̠	어우러지다
어우르다	ʌ̹ u ɾ ɯ d a̠	어우르다
어울림	ʌ̹ u ʎ ʎ i m	어울림
어의	ʌ̹ ɰ i	어의
어저귀	ʌ̹ d͡ʑ ʌ̹ ɡ ɥ i	어저귀
어저께	ʌ̹ d͡ʑ ʌ̹ k͈ e̞	어저께
어찌씨	ʌ̹ t͡ɕ͈ i ɕ͈ i	어찌씨
어찌하다	ʌ̹ t͡ɕ͈ i ɦ a̠ d a̠	어찌하다
어청이	ʌ̹ t͡ɕʰ ʌ̹ ŋ i	어청이
어케	ʌ̹ kʰ e̞	어케
어플	ʌ̹ pʰ ɯ ɭ	어플
어플리케이션	ʌ̹ pʰ ɯ ʎ ʎ i kʰ e̞ i ɕʰ ʌ̹ n	어플리케이선
억	ʌ̹ k̚	억
억강부약	ʌ̹ k̚ k͈ a̠ ŋ b u j a̠ k̚	억깡부약
억누르다	ʌ̹ ŋ n u ɾ ɯ d a̠	엉누르다
억류자	ʌ̹ ŋ ɲ u d͡ʑ a̠	엉누자
억수로	ʌ̹ k s͈ u ɾ o̞	억쑤로
억측	ʌ̹ k̚ t͡ɕʰ ɯ k̚	억측
언급하다	ʌ̹ n ɡ ɯ pʰ a̠ d a̠	언그파다
언닌	ʌ̹ n n i n	언닌
언론가	ʌ̹ ɭ ɭ o̞ n ɡ a̠	얼론가
언론인	ʌ̹ ɭ ɭ o̞ n i n	얼로닌
언제든지	ʌ̹ ɲ d͡ʑ e̞ d ɯ ɲ d͡ʑ i	언제든지
언짢다	ʌ̹ ɲ t͡ɕ͈ a̠ n tʰ a̠	언짠타
얹다	ʌ̹ n t͈ a̠	언따
얻다	ʌ̹ t̚ t͈ a̠	얻따
얼	ʌ̹ ɭ	얼
얼굴빛	ʌ̹ ɭ ɡ u ɭ p͈ i t̚	얼굴삗
얼룩동사리	ʌ̹ ɭ ɭ u k̚ t͈ o̞ ŋ sʰ a̠ ɾ i	얼룩똥사리
얼버무리다	ʌ̹ ɭ b ʌ̹ m u ɾ i d a̠	얼버무리다
얼씨구	ʌ̹ ɭ ɕ͈ i ɡ u	얼씨구
얼음꽃	ʌ̹ ɾ ɯ m k͈ o̞ t̚	어름꼳
얼음보숭이	ʌ̹ ɾ ɯ m b o̞ sʰ u ŋ i	어름보숭이
얼음차	ʌ̹ ɾ ɯ m t͡ɕʰ a̠	어름차
얼핑	ʌ̹ ɭ pʰ i ŋ	얼핑
얽다	ʌ̹ k̚ t͈ a̠	억따
엄	ʌ̹ m	엄
엄금	ʌ̹ m ɡ ɯ m	엄금
엄동	ʌ̹ m d o̞ ŋ	엄동
엄두	ʌ̹ m d u	엄두
엄친아	ʌ̹ m t͡ɕʰ i n a̠	엄치나
엄호	ʌ̹ m β o̞	엄호
업	ʌ̹ p̚	업
업둥이	ʌ̹ p̚ t͈ u ŋ i	업뚱이
업진살	ʌ̹ p̚ t͡ɕ͈ i n sʰ a̠ ɭ	업찐살
엇	ʌ̹ t̚	얻
엇더타	ʌ̹ t̚ t͈ ʌ̹ tʰ a̠	얻떠타
엉	ʌ̹ ŋ	엉
엉거주춤	ʌ̹ ŋ ɡ ʌ̹ d͡ʑ u t͡ɕʰ u m	엉거주춤
엎드리다	ʌ̹ p̚ t͈ ɯ ɾ i d a̠	업뜨리다
엎지르다	ʌ̹ p̚ t͡ɕ͈ i ɾ ɯ d a̠	업찌르다
에	e̞	에
에기	e̞ ɡ i	에기
에다	e̞ː d a̠	에다
에드먼턴	e̞ d ɯ m ʌ̹ n tʰ ʌ̹ n	에드먼턴
에든버러	e̞ d ɯ n b ʌ̹ ɾ ʌ̹	에든버러
에르븀	e̞ ɾ ɯ b j u m	에르븀
에모지	e̞ m o̞ d͡ʑ i	에모지
에미나이	e̞ m i n a̠ i	에미나이
에바	e̞ b a̠	에바
에스빠냐	e̞ sʰ ɯ p͈ a̠ ɲ a̠	에스빠나
에스체트	e̞ sʰ ɯ t͡ɕʰ e̞ tʰ ɯ	에스체트
에스테르	e̞ sʰ ɯ tʰ e̞ ɾ ɯ	에스테르
에스페란토	e̞ sʰ ɯ pʰ e̞ ɾ a̠ n tʰ o̞	에스페란토
에어쿠션	e̞ ʌ̹ kʰ u ɕʰ ʌ̹ n	에어쿠선
에우다	e̞ u d a̠	에우다
에취	e̞ t͡ɕʰ ɥ i	에취
에테인	e̞ tʰ e̞ i n	에테인
엔	e̞ n	엔
엔나	e̞ n n a̠	엔나
엔조이	e̞ ɲ d͡ʑ o̞ i	엔조이
엔지니어링	e̞ ɲ d͡ʑ i n i ʌ̹ ɾ i ŋ	엔지니어링
엘니노	e̞ ʎ ʎ i n o̞	엘리노
엘리자베스	e̞ ʎ ʎ i d͡ʑ a̠ b e̞ sʰ ɯ	엘리자베스
엘베	e̞ ɭ b e̞	엘베
여	j ʌ̹	여
여념	j ʌ̹ ɲ ʌ̹ m	여넘
여린히읗	j ʌ̹ ɾ i n ʝ i ɯ t̚	여린히읃
여사친	j ʌ̹ sʰ a̠ t͡ɕʰ i n	여사친
여성스럽다	j ʌ̹ sʰ ʌ̹ ŋ sʰ ɯ ɾ ʌ̹ p̚ t͈ a̠	여성스럽따
여성운동가	j ʌ̹ sʰ ʌ̹ ŋ u n d o̞ ŋ ɡ a̠	여성운동가
여성주의자	j ʌ̹ sʰ ʌ̹ ŋ d͡ʑ u ɰ i d͡ʑ a̠	여성주의자
여여	j ʌ̹ j ʌ̹	여여
여여하다	j ʌ̹ j ʌ̹ ɦ a̠ d a̠	여여하다
여우원숭이	j ʌ̹ u w ʌ̹ n sʰ u ŋ i	여우원숭이
여울마자	j ʌ̹ u ɭ m a̠ d͡ʑ a̠	여울마자
여위다	j ʌ̹ ɥ i d a̠	여위다
여의다	j ʌ̹ ɰ i d a̠	여의다
여의자	j ʌ̹ ɰ i d͡ʑ a̠	여의자
여인숙	j ʌ̹ i n sʰ u k̚	여인숙
여지	j ʌ̹ d͡ʑ i	여지
여차저차	j ʌ̹ t͡ɕʰ a̠ d͡ʑ ʌ̹ t͡ɕʰ a̠	여차저차
여포	j ʌ̹ pʰ o̞	여포
여호와	j ʌ̹ β o̞ w a̠	여호와
역	j ʌ̹ k̚	역
역력	j ʌ̹ ŋ ɲ ʌ̹ k̚	영넉
역력하다	j ʌ̹ ŋ ɲ ʌ̹ kʰ a̠ d a̠	영너카다
역원	j ʌ̹ ɡ w ʌ̹ n	여권
역정	j ʌ̹ k̚ t͡ɕ͈ ʌ̹ ŋ	역쩡
엮다	j ʌ̹ k̚ t͈ a̠	역따
연	j ʌ̹ n	연
연관공	j ʌ̹ n ɡ w a̠ n ɡ o̞ ŋ	연관공
연기	j ʌ̹ n ɡ i	연기
연길	j ʌ̹ n ɡ i ɭ	연길
연달다	j ʌ̹ n d a̠ ɭ d a̠	연달다
연락선	j ʌ̹ ɭ ɭ a̠ k s͈ ʌ̹ n	열락썬
연락하다	j ʌ̹ ɭ ɭ a̠ kʰ a̠ d a̠	열라카다
연립	j ʌ̹ ʎ ʎ i p̚	열립
연민	j ʌ̹ n m i n	연민
연뿌리	j ʌ̹ n p͈ u ɾ i	연뿌리
연석	j ʌ̹ n sʰ ʌ̹ k̚	연석
연소	j ʌ̹ n sʰ o̞	연소
연와	j ʌ̹ n w a̠	여놔
연와탕	j ʌ̹ n w a̠ tʰ a̠ ŋ	여놔탕
연잇다	j ʌ̹ n i t̚ t͈ a̠	여닏따
연준모치	j ʌ̹ ɲ d͡ʑ u n m o̞ t͡ɕʰ i	연준모치
연중무휴	j ʌ̹ ɲ d͡ʑ u ŋ m u ʝ u	연중무후
연평도	j ʌ̹ n pʰ j ʌ̹ ŋ d o̞	연평도
연호	j ʌ̹ n β o̞	연호
연흔	j ʌ̹ n ɣ ɯ n	연흔
열	j ʌ̹ ɭ	열
열광자	j ʌ̹ ɭ ɡ w a̠ ŋ d͡ʑ a̠	열광자
열넷	j ʌ̹ ɭ ɭ e̞ t̚	열렏
열람	j ʌ̹ ɭ ɭ a̠ m	열람
열량계	j ʌ̹ ʎ ʎ a̠ ŋ ɡ j e̞	열랑계
열렬	j ʌ̹ ʎ ʎ ʌ̹ ɭ	열럴
열렬하다	j ʌ̹ ʎ ʎ ʌ̹ ɾ ɦ a̠ d a̠	열럴하다
열변	j ʌ̹ ɭ b j ʌ̹ n	열변
열사	j ʌ̹ ɭ sʰ a̠	열사
열쇠글	j ʌ̹ ɭ sʰ w e̞ ɡ ɯ ɭ	열쇠글
열하나	j ʌ̹ ɾ ɦ a̠ n a̠	열하나
염	j ʌ̹ m	염
염라	j ʌ̹ m n a̠	염나
염불	j ʌ̹ m b u ɭ	염불
염주비둘기	j ʌ̹ m d͡ʑ u b i d u ɭ ɡ i	염주비둘기
염치	j ʌ̹ m t͡ɕʰ i	염치
엽	j ʌ̹ p̚	엽
엽궐련	j ʌ̹ p̚ k͈ w ʌ̹ ʎ ʎ ʌ̹ n	엽꿜런
엽란	j ʌ̹ m n a̠ n	염난
엽록체	j ʌ̹ m n o̞ k̚ t͡ɕʰ e̞	염녹체
엿	j ʌ̹ t̚	엳
영	j ʌ̹ ŋ	영
영감	j ʌ̹ ŋ ɡ a̠ m	영감
영검하다	j ʌ̹ ŋ ɡ ʌ̹ m ɦ a̠ d a̠	영검하다
영동	j ʌ̹ ŋ d o̞ ŋ	영동
영락	j ʌ̹ ŋ n a̠ k̚	영낙
영사기	j ʌ̹ ŋ sʰ a̠ ɡ i	영사기
영서	j ʌ̹ ŋ sʰ ʌ̹	영서
영양물	j ʌ̹ ŋ j a̠ ŋ m u ɭ	영양물
영양탕	j ʌ̹ ŋ j a̠ ŋ tʰ a̠ ŋ	영양탕
영연방	j ʌ̹ ŋ ɲ ʌ̹ n b a̠ ŋ	영넌방
영장	j ʌ̹ ŋ t͡ɕ͈ a̠ ŋ	영짱
영장류	j ʌ̹ ŋ d͡ʑ a̠ ŋ ɲ u	영장누
영포자	j ʌ̹ ŋ pʰ o̞ d͡ʑ a̠	영포자
영한	j ʌ̹ ŋ ɦ a̠ n	영한
영험	j ʌ̹ ŋ ɦ ʌ̹ m	영험
영험하다	j ʌ̹ ŋ ɦ ʌ̹ m ɦ a̠ d a̠	영험하다
옆	j ʌ̹ p̚	엽
예	j e̞	예
예구	j e̞ː k͈ u	예꾸
예기	j e̞ ɡ i	예기
예방접종	j e̞ b a̠ ŋ d͡ʑ ʌ̹ p̚ t͡ɕ͈ o̞ ŋ	예방접쫑
예보	j e̞ː b o̞	예보
예복	j e̞ b o̞ k̚	예복
예상되다	j e̞ː sʰ a̠ ŋ d w e̞ d a̠	예상되다
예언하다	j e̞ː ʌ̹ n ɦ a̠ d a̠	예언하다
예열	j e̞ː j ʌ̹ ɭ	예열
예절바르다	j e̞ d͡ʑ ʌ̹ ɭ b a̠ ɾ ɯ d a̠	예절바르다
예취기	j e̞ t͡ɕʰ ɥ i ɡ i	예취기
옐로나이프	j e̞ ɭ ɭ o̞ n a̠ i pʰ ɯ	옐로나이프
옛	j e̞ː t̚	옏
옛글	j e̞ t̚ k͈ ɯ ɭ	옏끌
옛이야기	j e̞ n n i j a̠ ɡ i	옌니야기
옛이응	j e̞ː n n i ɯ ŋ	옌니응
옛한글	j e̞ː tʰ a̠ n ɡ ɯ ɭ	예탄글
오	o̞	오
오곡	o̞ː ɡ o̞ k̚	오곡
오곡밥	o̞ ɡ o̞ k̚ p͈ a̠ p̚	오곡빱
오뉴월	o̞ː ɲ u w ʌ̹ ɭ	오누월
오늄	o̞ ɲ u m	오눔
오늬	o̞ n i	오니
오답하다	o̞ː d a̠ pʰ a̠ d a̠	오다파다
오덕후	o̞ d ʌ̹ kʰ u	오더쿠
오뎅	o̞ d e̞ ŋ	오뎅
오두막	o̞ d u m a̠ k̚	오두막
오두막집	o̞ d u m a̠ k̚ t͡ɕ͈ i p̚	오두막찝
오드투왈렛	o̞ d ɯ tʰ u w a̠ ɭ ɭ e̞ t̚	오드투왈렏
오등	o̞ d ɯ ŋ	오등
오라버니	o̞ ɾ a̠ b ʌ̹ n i	오라버니
오라비	o̞ ɾ a̠ b i	오라비
오레건	o̞ ɾ e̞ ɡ ʌ̹ n	오레건
오룔	o̞ ɾ j o ɭ	오룔
오룬손	o̞ ɾ u n sʰ o̞ n	오룬손
오륜	o̞ː ɾ j u n	오륜
오른손	o̞ ɾ ɯ n sʰ o̞ n	오른손
오리건	o̞ ɾ i ɡ ʌ̹ n	오리건
오린손	o̞ ɾ i n sʰ o̞ n	오린손
오마카세	o̞ m a̠ kʰ a̠ sʰ e̞	오마카세
오만	o̞ m a̠ n	오만
오만하다	o̞ː m a̠ n ɦ a̠ d a̠	오만하다
오명가명	o̞ m j ʌ̹ ŋ ɡ a̠ m j ʌ̹ ŋ	오명가명
오목하다	o̞ m o̞ kʰ a̠ d a̠	오모카다
오문	o̞ m u n	오문
오바마케어	o̞ b a̠ m a̠ kʰ e̞ ʌ̹	오바마케어
오밤	o̞ː b a̠ m	오밤
오보	o̞ː b o̞	오보
오보에	o̞ b o̞ e̞	오보에
오블라스티	o̞ b ɯ ɭ ɭ a̠ sʰ ɯ tʰ i	오블라스티
오사까	o̞ sʰ a̠ k͈ a̠	오사까
오삼춘	o̞ sʰ a̠ m t͡ɕʰ u n	오삼춘
오솔길	o̞ sʰ o̞ ɭ ɡ i ɭ	오솔길
오스만	o̞ sʰ ɯ m a̠ n	오스만
오스뮴	o̞ sʰ ɯ m j u m	오스뮴
오스트랄리아	o̞ sʰ ɯ tʰ ɯ ɾ a̠ ʎ ʎ i a̠	오스트랄리아
오심	o̞ː ɕʰ i m	오심
오얏	o̞ j a̠ t̚	오얃
오열	o̞ j ʌ̹ ɭ	오열
오욕	o̞ː j o k̚	오욕
오음	o̞ː ɯ m	오음
오인	o̞ i n	오인
오작동	o̞ː d͡ʑ a̠ k̚ t͈ o̞ ŋ	오작똥
오장육부	o̞ː d͡ʑ a̠ ŋ j u k̚ p͈ u	오장육뿌
오줌통	o̞ d͡ʑ u m tʰ o̞ ŋ	오줌통
오지리	o̞ d͡ʑ i ɾ i	오지리
오치레기	o̞ t͡ɕʰ i ɾ e̞ ɡ i	오치레기
오크로시카	o̞ k x ɯ ɾ o̞ ɕʰ i kʰ a̠	오크로시카
오클라호마	o̞ k x ɯ ɭ ɭ a̠ β o̞ m a̠	오클라호마
오토메이션	o̞ tʰ o̞ m e̞ i ɕʰ ʌ̹ n	오토메이선
오판	o̞ː pʰ a̠ n	오판
오프숄더	o̞ pʰ ɯ ɕʰ o ɭ d ʌ̹	오프숄더
오호	o̞ β o̞	오호
오환	o̞ β w a̠ n	오환
옥	o̞ k̚	옥
옥고	o̞ k̚ k͈ o̞	옥꼬
옥문	o̞ ŋ m u n	옹문
옥사	o̞ k s͈ a̠	옥싸
옥사졸	o̞ k s͈ a̠ d͡ʑ o̞ ɭ	옥싸졸
옥시기	o̞ k ɕ͈ i ɡ i	옥씨기
옥심	o̞ k ɕ͈ i m	옥씸
옥좌	o̞ k̚ t͡ɕ͈ w a̠	옥쫘
옥토	o̞ k̚ tʰ o̞	옥토
옥황상제	o̞ kʰ w a̠ ŋ sʰ a̠ ŋ d͡ʑ e̞	오쾅상제
온	o̞ n	온
온공일	o̞ː n ɡ o̞ ŋ i ɭ	온공일
온도계	o̞ n d o̞ ɡ j e̞	온도계
온돌방	o̞ n d o̞ ɭ p͈ a̠ ŋ	온돌빵
온전하다	o̞ː ɲ d͡ʑ ʌ̹ n ɦ a̠ d a̠	온전하다
온주밀감	o̞ ɲ d͡ʑ u m i ɭ ɡ a̠ m	온주밀감
온타리오	o̞ n tʰ a̠ ɾ i o̞	온타리오
온화하다	o̞ n β w a̠ ɦ a̠ d a̠	온화하다
올	o̞ ɭ	올
올리고당	o̞ ʎ ʎ i ɡ o̞ d a̠ ŋ	올리고당
옮다	o̞ː m t͈ a̠	옴따
옮아가다	o̞ ɭ m a̠ ɡ a̠ d a̠	올마가다
옮아오다	o̞ ɭ m a̠ o̞ d a̠	올마오다
옳바르다	o̞ ɭ b a̠ ɾ ɯ d a̠	올바르다
옴마이	o̞ m m a̠ i	옴마이
옴쌀	o̞ m s͈ a̠ ɭ	옴쌀
옵션	o̞ p ɕ͈ ʌ̹ n	옵썬
옷	o̞ t̚	옫
옹	o̞ ŋ	옹
옹기	o̞ː ŋ ɡ i	옹기
옹졸	o̞ː ŋ d͡ʑ o̞ ɭ	옹졸
옹졸하다	o̞ː ŋ d͡ʑ o̞ ɾ ɦ a̠ d a̠	옹졸하다
옹진	o̞ː ŋ d͡ʑ i n	옹진
옹호하다	o̞ː ŋ β o̞ ɦ a̠ d a̠	옹호하다
옻	o̞ t̚	옫
옻나무	o̞ n n a̠ m u	온나무
와	w a̠	와
와가두구	w a̠ ɡ a̠ d u ɡ u	와가두구
와꾸	w a̠ k͈ u	와꾸
와리가리	w a̠ ɾ i ɡ a̠ ɾ i	와리가리
와봐	w a̠ː b w a̠	와봐
와사삭	w a̠ sʰ a̠ sʰ a̠ k̚	와사삭
와사삭와사삭	w a̠ sʰ a̠ sʰ a̠ ɡ w a̠ sʰ a̠ sʰ a̠ k̚	와사사과사삭
와삭	w a̠ sʰ a̠ k̚	와삭
와삭바삭	w a̠ sʰ a̠ k̚ p͈ a̠ sʰ a̠ k̚	와삭빠삭
와삭와삭	w a̠ sʰ a̠ ɡ w a̠ sʰ a̠ k̚	와사과삭
와셔	w a̠ ɕʰ ʌ̹	와서
와싹	w a̠ s͈ a̠ k̚	와싹
와싹와싹	w a̠ s͈ a̠ ɡ w a̠ s͈ a̠ k̚	와싸과싹
와이오밍	w a̠ i o̞ m i ŋ	와이오밍
와전	w a̠ d͡ʑ ʌ̹ n	와전
와트	w a̠ tʰ ɯ	와트
왁자그르르	w a̠ k̚ t͡ɕ͈ a̠ ɡ ɯ ɾ ɯ ɾ ɯ	왁짜그르르
왁자지껄하다	w a̠ k̚ t͡ɕ͈ a̠ d͡ʑ i k͈ ʌ̹ ɾ ɦ a̠ d a̠	왁짜지껄하다
왁찐	w a̠ k̚ t͡ɕ͈ i n	왁찐
완고	w a̠ n ɡ o̞	완고
완고하다	w a̠ n ɡ o̞ ɦ a̠ d a̠	완고하다
완성형	w a̠ n sʰ ʌ̹ ŋ ʝ ʌ̹ ŋ	완성헝
완전하다	w a̠ ɲ d͡ʑ ʌ̹ n ɦ a̠ d a̠	완전하다
왈	w a̠ ɭ	왈
왐마	w a̠ m m a̠	왐마
왕	w a̠ ŋ	왕
왕게	w a̠ ŋ ɡ e̞	왕게
왕관비둘기	w a̠ ŋ ɡ w a̠ n b i d u ɭ ɡ i	왕관비둘기
왕녀	w a̠ ŋ ɲ ʌ̹	왕너
왕눈이	w a̠ ŋ n u n i	왕누니
왕따	w a̠ ŋ t͈ a̠	왕따
왕바다리	w a̠ ŋ b a̠ d a̠ ɾ i	왕바다리
왕서방	w a̠ ŋ sʰ ʌ̹ b a̠ ŋ	왕서방
왕수	w a̠ ŋ sʰ u	왕수
왕자병	w a̠ ŋ d͡ʑ a̠ p͈ j ʌ̹ ŋ	왕자뼝
왕정	w a̠ ŋ d͡ʑ ʌ̹ ŋ	왕정
왕지네	w a̠ ŋ d͡ʑ i n e̞	왕지네
왕홀	w a̠ ŋ β o̞ ɭ	왕홀
왜	w ɛː	왜
왜가리	w ɛː ɡ a̠ ɾ i	왜가리
외	w e̞	외
외계인	w e̞ː ɡ j e̞ i n	외계인
외국인혐오증	w e̞ː ɡ u ɡ i n ʝ ʌ̹ m o̞ d͡ʑ ɯ ŋ	외구긴허모증
외독소	w e̞ː d o̞ k s͈ o̞	외독쏘
외력	w e̞ː ɾ j ʌ̹ k̚	외력
외로움	w e̞ ɾ o̞ u m	외로움
외면하다	w e̞ː m j ʌ̹ n ɦ a̠ d a̠	외면하다
외몽고	w e̞ m o̞ ŋ ɡ o̞	외몽고
외무	w e̞ m u	외무
외발자전거	w e̞ b a̠ ʎ d͡ʑ a̠ d͡ʑ ʌ̹ n ɡ ʌ̹	외발자전거
외설하다	w e̞ː sʰ ʌ̹ ɾ ɦ a̠ d a̠	외설하다
외성	w e̞ sʰ ʌ̹ ŋ	외성
외숙모	w e̞ sʰ u ŋ m o̞	외숭모
외식하다	w e̞ː ɕʰ i kʰ a̠ d a̠	외시카다
외심	w e̞ː ɕʰ i m	외심
외우다	w e̞ u d a̠	외우다
외접원	w e̞ː d͡ʑ ʌ̹ b w ʌ̹ n	외저붠
외출하다	w e̞ː t͡ɕʰ u ɾ ɦ a̠ d a̠	외출하다
외침	w e̞ t͡ɕʰ i m	외침
외퀴	w e̞ː kʰ ɥ i	외퀴
외판원	w e̞ː pʰ a̠ n w ʌ̹ n	외파눤
왼손	w e̞ː n sʰ o̞ n	왼손
요	j o	요
요관	j o ɡ w a̠ n	요관
요람본	j o ɾ a̠ m b o̞ n	요람본
요방형근	j o b a̠ ŋ ʝ ʌ̹ ŋ ɡ ɯ n	요방헝근
요산요수	j o sʰ a̠ ɲ o sʰ u	요사뇨수
요셉	j o sʰ e̞ p̚	요셉
요원	j o w ʌ̹ n	요원
요의	j o ɰ i	요의
요청하다	j o t͡ɕʰ ʌ̹ ŋ ɦ a̠ d a̠	요청하다
요충	j o t͡ɕʰ u ŋ	요충
요트	j o tʰ ɯ	요트
욕	j o k̚	욕
욕설	j o k s͈ ʌ̹ ɭ	욕썰
용	j o ŋ	용
용감	j oː ŋ ɡ a̠ m	용감
용기	j o ŋ ɡ i	용기
용사	j oː ŋ sʰ a̠	용사
용상	j oː ŋ sʰ a̠ ŋ	용상
용상어	j o ŋ sʰ a̠ ŋ ʌ̹	용상어
용수철	j o ŋ sʰ u t͡ɕʰ ʌ̹ ɭ	용수철
용안	j o ŋ a̠ n	용안
용접공	j o ŋ d͡ʑ ʌ̹ p̚ k͈ o̞ ŋ	용접꽁
용접하다	j o ŋ d͡ʑ ʌ̹ pʰ a̠ d a̠	용저파다
우	u	우
우는토끼	uː n ɯ n tʰ o̞ k͈ i	우는토끼
우단	uː d a̠ n	우단
우두망찰	u d u m a̠ ŋ t͡ɕʰ a̠ ɭ	우두망찰
우두머리	u d u m ʌ̹ ɾ i	우두머리
우라누스	u ɾ a̠ n u sʰ ɯ	우라누스
우란	u ɾ a̠ n	우란
우량계	uː ɾ j a̠ ŋ ɡ j e̞	우량계
우러러보다	u ɾ ʌ̹ ɾ ʌ̹ b o̞ d a̠	우러러보다
우러르다	u ɾ ʌ̹ ɾ ɯ d a̠	우러르다
우럭볼락	u ɾ ʌ̹ k̚ p͈ o̞ ɭ ɭ a̠ k̚	우럭뽈락
우레	u ɾ e̞	우레
우르두어	u ɾ ɯ d u ʌ̹	우르두어
우리다	u ɾ i d a̠	우리다
우모	uː m o̞	우모
우무	u m u	우무
우무인	u m u i n	우무인
우민	u m i n	우민
우박	uː b a̠ k̚	우박
우비다	u b i d a̠	우비다
우빙	u b i ŋ	우빙
우산소나무	u sʰ a̠ n sʰ o̞ n a̠ m u	우산소나무
우안	u a̠ n	우안
우워치	u w ʌ̹ t͡ɕʰ i	우워치
우월	u w ʌ̹ ɭ	우월
우유부단	u j u b u d a̠ n	우유부단
우의	uː ɰ i	우의
우인	u i n	우인
우정	u d͡ʑ ʌ̹ ŋ	우정
우좀	uː d͡ʑ o̞ m	우좀
우주론	u d͡ʑ u ɾ o̞ n	우주론
우주진	uː d͡ʑ u d͡ʑ i n	우주진
우즈베크어	u d͡ʑ ɯ b e̞ k x ɯ ʌ̹	우즈베크어
우케	u kʰ e̞	우케
우틔	u tʰ i	우티
우파	uː pʰ a̠	우파
우펀국	u pʰ ʌ̹ n ɡ u k̚	우펀국
운검	u n ɡ ʌ̹ m	운검
운동량	uː n d o̞ ŋ ɲ a̠ ŋ	운동낭
운라	u ɭ ɭ a̠	울라
운반	u n b a̠ n	운반
운세	u n sʰ e̞	운세
운영	uː ɲ ʌ̹ ŋ	우넝
운하다	u n ɦ a̠ d a̠	운하다
울	u ɭ	울
울렁증	u ɭ ɭ ʌ̹ ŋ t͡ɕ͈ ɯ ŋ	울렁쯩
울창	u ʎ t͡ɕʰ a̠ ŋ	울창
울창하다	u ʎ t͡ɕʰ a̠ ŋ ɦ a̠ d a̠	울창하다
움	uː m	움
움직씨	u m d͡ʑ i k ɕ͈ i	움직씨
움트다	u m tʰ ɯ d a̠	움트다
웁살라	u p s͈ a̠ ɭ ɭ a̠	웁쌀라
웃돈	u t̚ t͈ o̞ n	욷똔
웃어넘기다	u sʰ ʌ̹ n ʌ̹ m ɡ i d a̠	우서넘기다
웃음소리	u sʰ ɯ m s͈ o̞ ɾ i	우슴쏘리
웃프다	u t̚ pʰ ɯ d a̠	욷프다
웅크리다	u ŋ k x ɯ ɾ i d a̠	웅크리다
웆제서	u t̚ t͡ɕ͈ e̞ sʰ ʌ̹	욷쩨서
워글워글	w ʌ̹ ɡ ɯ ɾ w ʌ̹ ɡ ɯ ɭ	워그뤄글
워석워석	w ʌ̹ sʰ ʌ̹ ɡ w ʌ̹ sʰ ʌ̹ k̚	워서궈석
워싱톤	w ʌ̹ ɕʰ i ŋ tʰ o̞ n	워싱톤
워썩	w ʌ̹ s͈ ʌ̹ k̚	워썩
워썩워썩	w ʌ̹ s͈ ʌ̹ ɡ w ʌ̹ s͈ ʌ̹ k̚	워써궈썩
워크숍	w ʌ̹ k x ɯ ɕʰ o p̚	워크숍
웍	w ʌ̹ k̚	웍
웍저그르르	w ʌ̹ k̚ t͡ɕ͈ ʌ̹ ɡ ɯ ɾ ɯ ɾ ɯ	웍쩌그르르
원	w ʌ̹ n	원
원곡	w ʌ̹ n ɡ o̞ k̚	원곡
원동	w ʌ̹ n d o̞ ŋ	원동
원리주의	w ʌ̹ ʎ ʎ i d͡ʑ u ɰ i	월리주의
원말	w ʌ̹ n m a̠ ɭ	원말
원반던지기	w ʌ̹ n b a̠ n d ʌ̹ ɲ d͡ʑ i ɡ i	원반던지기
원소	w ʌ̹ n sʰ o̞	원소
원시림	w ʌ̹ n ɕʰ i ɾ i m	원시림
원쑤	w ʌ̹ n s͈ u	원쑤
원앙사촌	w ʌ̹ n a̠ ŋ sʰ a̠ t͡ɕʰ o̞ n	워낭사촌
원어민	w ʌ̹ n ʌ̹ m i n	워너민
원자로	w ʌ̹ ɲ d͡ʑ a̠ ɾ o̞	원자로
원주률	w ʌ̹ ɲ d͡ʑ u ɾ j u ɭ	원주률
원주율	w ʌ̹ ɲ d͡ʑ u j u ɭ	원주율
원주필	w ʌ̹ ɲ d͡ʑ u pʰ i ɭ	원주필
원지	w ʌ̹ ɲ d͡ʑ i	원지
원추각막	w ʌ̹ ɲ t͡ɕʰ u ɡ a̠ ŋ m a̠ k̚	원추강막
원화	w ʌ̹ n β w a̠	원화
월	w ʌ̹ ɭ	월
월경지	w ʌ̹ ɭ ɡ j ʌ̹ ŋ d͡ʑ i	월경지
월귀탄	w ʌ̹ ɭ ɡ ɥ i tʰ a̠ n	월귀탄
월급	w ʌ̹ ɭ ɡ ɯ p̚	월급
월별	w ʌ̹ ɭ b j ʌ̹ ɭ	월별
월영	w ʌ̹ ɾ j ʌ̹ ŋ	워령
월월산산	w ʌ̹ ɾ w ʌ̹ ɭ sʰ a̠ n sʰ a̠ n	워뤌산산
월일	w ʌ̹ ɾ i ɭ	워릴
월장석	w ʌ̹ ʎ d͡ʑ a̠ ŋ sʰ ʌ̹ k̚	월장석
웨스턴	w e̞ sʰ ɯ tʰ ʌ̹ n	웨스턴
웨스트버지니아	w e̞ sʰ ɯ tʰ ɯ b ʌ̹ d͡ʑ i n i a̠	웨스트버지니아
웨이트리스	w e̞ i tʰ ɯ ɾ i sʰ ɯ	웨이트리스
웬	w e̞ n	웬
웬이	w e̞ː n i	웨니
웹	w e̞ p̚	웹
웼잉잉	w e̞ ɕ͈ i ŋ i ŋ	웨씽잉
윁남	w e̞ n n a̠ m	웬남
위	ɥ i	위
위거	ɥ i ɡ ʌ̹	위거
위구르	ɥ i ɡ u ɾ ɯ	위구르
위글	ɥ i ɡ ɯ ɭ	위글
위급존망지추	ɥ i ɡ ɯ p̚ t͡ɕ͈ o̞ n m a̠ ŋ d͡ʑ i t͡ɕʰ u	위급쫀망지추
위니펙	ɥ i n i pʰ e̞ k̚	위니펙
위독	ɥ i d o̞ k̚	위독
위로하다	ɥ i ɾ o̞ ɦ a̠ d a̠	위로하다
위병	ɥ i b j ʌ̹ ŋ	위병
위상수학	ɥ i sʰ a̠ ŋ sʰ uː ɦ a̠ k̚	위상수학
위선	ɥ i sʰ ʌ̹ n	위선
위스컨신	ɥ i sʰ ɯ kʰ ʌ̹ n ɕʰ i n	위스컨신
위스콘신	ɥ i sʰ ɯ kʰ o̞ n ɕʰ i n	위스콘신
위음성	ɥ i ɯ m sʰ ʌ̹ ŋ	위음성
위층	ɥ i t͡ɕʰ ɯ ŋ	위층
위치하다	ɥ i t͡ɕʰ i ɦ a̠ d a̠	위치하다
위풍당당	ɥ i pʰ u ŋ d a̠ ŋ d a̠ ŋ	위풍당당
위풍당당하다	ɥ i pʰ u ŋ d a̠ ŋ d a̠ ŋ ɦ a̠ d a̠	위풍당당하다
윌리엄	ɥ i ʎ ʎ i ʌ̹ m	윌리엄
유	j u	유
유가족	j u ɡ a̠ d͡ʑ o̞ k̚	유가족
유기체	j uː ɡ i t͡ɕʰ e̞	유기체
유능	j u n ɯ ŋ	유능
유니스	j u n i sʰ ɯ	유니스
유니코드	j u n i kʰ o̞ d ɯ	유니코드
유니콘	j u n i kʰ o̞ n	유니콘
유도기	j u d o̞ ɡ i	유도기
유독하다	j uː d o̞ kʰ a̠ d a̠	유도카다
유동	j u d o̞ ŋ	유동
유두	j u d u	유두
유량계	j uː ɾ j a̠ ŋ ɡ j e̞	유량계
유럽소나무담비	j u ɾ ʌ̹ p s͈ o̞ n a̠ m u d a̠ m b i	유럽쏘나무담비
유로퓸	j u ɾ o̞ pʰ j u m	유로퓸
유륜	j u ɾ j u n	유륜
유리	j u ɾ i	유리
유리창	j u ɾ i t͡ɕʰ a̠ ŋ	유리창
유린	j u ɾ i n	유린
유머러스하다	j u m ʌ̹ ɾ ʌ̹ sʰ ɯ ɦ a̠ d a̠	유머러스하다
유발	j u b a̠ ɭ	유발
유방암	j u b a̠ ŋ a̠ m	유방암
유보	j u b o̞	유보
유부	j u b u	유부
유부남	j uː b u n a̠ m	유부남
유부녀	j uː b u ɲ ʌ̹	유부너
유비무환	j uː b i m u β w a̠ n	유비무환
유사	j uː sʰ a̠	유사
유선	j uː sʰ ʌ̹ n	유선
유성우	j u sʰ ʌ̹ ŋ u	유성우
유술	j u sʰ u ɭ	유술
유신	j u ɕʰ i n	유신
유신론	j u ɕʰ i n n o̞ n	유신논
유아론	j u a̠ ɾ o̞ n	유아론
유약	j u j a̠ k̚	유약
유에프오	j u e̞ pʰ ɯ o̞	유에프오
유예하다	j u j e̞ ɦ a̠ d a̠	유예하다
유유상종	j uː j u sʰ a̠ ŋ d͡ʑ o̞ ŋ	유유상종
유음	j u ɯ m	유음
유인	j u i n	유인
유자	j uː d͡ʑ a̠	유자
유자나무	j uː d͡ʑ a̠ n a̠ m u	유자나무
유자차	j uː d͡ʑ a̠ t͡ɕʰ a̠	유자차
유전	j u d͡ʑ ʌ̹ n	유전
유조차	j u d͡ʑ o̞ t͡ɕʰ a̠	유조차
유주	j u d͡ʑ u	유주
유지어터	j u d͡ʑ i ʌ̹ tʰ ʌ̹	유지어터
유치	j u t͡ɕʰ i	유치
유카타	j u kʰ a̠ tʰ a̠	유카타
유콘	j u kʰ o̞ n	유콘
유타	j u tʰ a̠	유타
유하다	j u ɦ a̠ d a̠	유하다
유한	j u ɦ a̠ n	유한
유혈	j u ʝ ʌ̹ ɭ	유헐
유혈목이	j u ʝ ʌ̹ ɭ m o̞ ɡ i	유헐모기
유효하다	j uː ʝ o ɦ a̠ d a̠	유효하다
육	j u k̚	육
육각수	j u k̚ k͈ a̠ k s͈ u	육깍쑤
육고기	j u k̚ k͈ o̞ ɡ i	육꼬기
육구하다	j u k̚ k͈ u ɦ a̠ d a̠	육꾸하다
육덕	j u k̚ t͈ ʌ̹ k̚	육떡
육봉	j u k̚ p͈ o̞ ŋ	육뽕
육상	j u k s͈ a̠ ŋ	육쌍
육상경기	j u k s͈ a̠ ŋ ɡ j ʌ̹ ŋ ɡ i	육쌍경기
육조	j u k̚ t͡ɕ͈ o̞	육쪼
육진방언	j u k̚ t͡ɕ͈ i n b a̠ ŋ ʌ̹ n	육찐방언
육촌	j u k̚ t͡ɕʰ o̞ n	육촌
윤간	j u n ɡ a̠ n	윤간
윤년	j uː n ɲ ʌ̹ n	윤넌
율	j u ɭ	율
율무	j u ɭ m u	율무
율운	j u ɾ u n	유룬
융모	j u ŋ m o̞	융모
윷	j uː t̚	윧
으뜸	ɯ t͈ ɯ m	으뜸
으르다	ɯ ɾ ɯ d a̠	으르다
으스러뜨리다	ɯ sʰ ɯ ɾ ʌ̹ t͈ ɯ ɾ i d a̠	으스러뜨리다
으스름하다	ɯ sʰ ɯ ɾ ɯ m ɦ a̠ d a̠	으스름하다
으스스하다	ɯ sʰ ɯ sʰ ɯ ɦ a̠ d a̠	으스스하다
으슥하다	ɯ sʰ ɯ kʰ a̠ d a̠	으스카다
은	ɯ n	은
은닉	ɯ n n i k̚	은닉
은밀	ɯ n m i ɭ	은밀
은밀하다	ɯ n m i ɾ ɦ a̠ d a̠	은밀하다
은방울꽃	ɯ n b a̠ ŋ u ɭ k͈ o̞ t̚	은방울꼳
은수저	ɯ n sʰ u d͡ʑ ʌ̹	은수저
은신	ɯ n ɕʰ i n	은신
은연어	ɯ n ɲ ʌ̹ n ʌ̹	은너너
은은	ɯ n ɯ n	으는
은은하다	ɯ n ɯ n ɦ a̠ d a̠	으는하다
은자메나	ɯ ɲ d͡ʑ a̠ m e̞ n a̠	은자메나
은제	ɯː ɲ d͡ʑ e̞	은제
은화과	ɯ n β w a̠ ɡ w a̠	은화과
을	ɯ ɭ	을
을씨년스럽다	ɯ ɭ ɕ͈ i ɲ ʌ̹ n sʰ ɯ ɾ ʌ̹ p̚ t͈ a̠	을씨넌스럽따
읊다	ɯ p̚ t͈ a̠	읍따
읊조리다	ɯ p̚ t͡ɕ͈ o̞ ɾ i d a̠	읍쪼리다
음	ɯ m	음
음가	ɯ m k͈ a̠	음까
음경골	ɯ m ɡ j ʌ̹ ŋ ɡ o̞ ɭ	음경골
음계	ɯ m ɡ j e̞	음계
음낭	ɯ m n a̠ ŋ	음낭
음란	ɯ m n a̠ n	음난
음란하다	ɯ m n a̠ n ɦ a̠ d a̠	음난하다
음렬	ɯ m ɲ ʌ̹ ɭ	음널
음모설	ɯ m m o̞ sʰ ʌ̹ ɭ	음모설
음목	ɯ m m o̞ k̚	음목
음바바네	ɯ m b a̠ b a̠ n e̞	음바바네
음부	ɯ m b u	음부
음성모음	ɯ m sʰ ʌ̹ ŋ m o̞ ɯ m	음성모음
음수	ɯ m sʰ u	음수
음순	ɯ m sʰ u n	음순
음양가	ɯ m j a̠ ŋ ɡ a̠	으먕가
음역하다	ɯ m j ʌ̹ kʰ a̠ d a̠	으며카다
음욕	ɯ m j o k̚	으묙
음용수	ɯː m j o ŋ sʰ u	으묭수
음운	ɯ m u n	으문
음유시인	ɯ m j u ɕʰ i i n	으뮤시인
음주	ɯː m d͡ʑ u	음주
음탕	ɯ m tʰ a̠ ŋ	음탕
음탕하다	ɯ m tʰ a̠ ŋ ɦ a̠ d a̠	음탕하다
음향양자	ɯ m ʝ a̠ ŋ j a̠ ŋ d͡ʑ a̠	음항양자
읍	ɯ p̚	읍
읎다	ɯː p̚ t͈ a̠	읍따
응	ɯ ŋ	응
응가	ɯ ŋ ɡ a̠	응가
응결	ɯ ŋ ɡ j ʌ̹ ɭ	응결
응급	ɯː ŋ ɡ ɯ p̚	응급
응급실	ɯː ŋ ɡ ɯ p ɕ͈ i ɭ	응급씰
응답하다	ɯː ŋ d a̠ pʰ a̠ d a̠	응다파다
응분	ɯː ŋ b u n	응분
응원하다	ɯː ŋ w ʌ̹ n ɦ a̠ d a̠	응원하다
응접	ɯː ŋ d͡ʑ ʌ̹ p̚	응접
응하다	ɯː ŋ ɦ a̠ d a̠	응하다
응회암	ɯ ŋ β w e̞ a̠ m	응회암
의	ɰ iː	의
의견란	ɰ iː ɡ j ʌ̹ n n a̠ n	의견난
의견서	ɰ i ɡ j ʌ̹ n sʰ ʌ̹	의견서
의논하다	ɰ i n o̞ n ɦ a̠ d a̠	의논하다
의뢰	ɰ i ɾ w e̞	의뢰
의미하다	ɰ iː m i ɦ a̠ d a̠	의미하다
의분	ɰ iː b u n	의분
의사	ɰ i sʰ a̠	의사
의사록	ɰ i sʰ a̠ ɾ o̞ k̚	의사록
의식주	ɰ i ɕʰ i k̚ t͡ɕ͈ u	의식쭈
의심되다	ɰ i ɕʰ i m d w e̞ d a̠	의심되다
의심스럽다	ɰ i ɕʰ i m sʰ ɯ ɾ ʌ̹ p̚ t͈ a̠	의심스럽따
의아	ɰ i a̠	의아
의연금	ɰ iː j ʌ̹ n ɡ ɯ m	의연금
의열단	ɰ iː j ʌ̹ ɭ t͈ a̠ n	의열딴
의존	ɰ i d͡ʑ o̞ n	의존
의중	ɰ iː d͡ʑ u ŋ	의중
의지	ɰ i d͡ʑ i	의지
의지하다	ɰ i d͡ʑ i ɦ a̠ d a̠	의지하다
의창지	ɰ i t͡ɕʰ a̠ ŋ d͡ʑ i	의창지
의탁하다	ɰ i tʰ a̠ kʰ a̠ d a̠	의타카다
의하다	ɰ i ɦ a̠ d a̠	의하다
이	i	이
이거레알	i ɡ ʌ̹ ɾ e̞ a̠ ɭ	이거레알
이교	iː ɡ j o	이교
이구아나	i ɡ u a̠ n a̠	이구아나
이국인	iː ɡ u ɡ i n	이구긴
이끼도롱뇽	i k͈ i d o̞ ɾ o̞ ŋ ɲ o ŋ	이끼도롱뇽
이단자	iː d a̠ ɲ d͡ʑ a̠	이단자
이동하다	i d o̞ ŋ ɦ a̠ d a̠	이동하다
이두	iː d u	이두
이듭	i d ɯ p̚	이듭
이따	i t͈ a̠	이따
이딸리아	i t͈ a̠ ʎ ʎ i a̠	이딸리아
이라크어	i ɾ a̠ k x ɯ ʌ̹	이라크어
이런저런	i ɾ ʌ̹ ɲ d͡ʑ ʌ̹ ɾ ʌ̹ n	이런저런
이루수	iː ɾ u sʰ u	이루수
이루어지다	i ɾ u ʌ̹ d͡ʑ i d a̠	이루어지다
이룩하다	i ɾ u kʰ a̠ d a̠	이루카다
이르잡다	i ɾ ɯ d͡ʑ a̠ p̚ t͈ a̠	이르잡따
이름씨	i ɾ ɯ m ɕ͈ i	이름씨
이리듐	i ɾ i d j u m	이리듐
이망	i m a̠ ŋ	이망
이모지	i m o̞ d͡ʑ i	이모지
이문	iː m u n	이문
이민위천	iː m i n ɥ i t͡ɕʰ ʌ̹ n	이미뉘천
이민자	i m i ɲ d͡ʑ a̠	이민자
이방인	iː b a̠ ŋ i n	이방인
이봐요	i b w a̠ j o	이봐요
이북	iː b u k̚	이북
이빠이	i p͈ a̠ i	이빠이
이사	i sʰ a̠	이사
이사하다	i sʰ a̠ ɦ a̠ d a̠	이사하다
이삭	i sʰ a̠ k̚	이삭
이산화물	i sʰ a̠ n β w a̠ m u ɭ	이산화물
이상야릇하다	iː sʰ a̠ ŋ ɲ a̠ ɾ ɯ tʰ a̠ d a̠	이상나르타다
이서	iː sʰ ʌ̹	이서
이소니트릴	i sʰ o̞ n i tʰ ɯ ɾ i ɭ	이소니트릴
이소시아니드	i sʰ o̞ ɕʰ i a̠ n i d ɯ	이소시아니드
이슬	i sʰ ɯ ɭ	이슬
이슬람주의	i sʰ ɯ ɭ ɭ a̠ m d͡ʑ u ɰ i	이슬람주의
이슬비	i sʰ ɯ ɭ b i	이슬비
이심	iː ɕʰ i m	이심
이아	i a̠	이아
이어링	i ʌ̹ ɾ i ŋ	이어링
이용사	iː j o ŋ sʰ a̠	이용사
이울다	i u ɭ d a̠	이울다
이원론	iː w ʌ̹ ɭ ɭ o̞ n	이월론
이윤	i j u n	이윤
이응	i ɯ ŋ	이응
이의	iː ɰ i	이의
이주자	i d͡ʑ u d͡ʑ a̠	이주자
이중모음	i d͡ʑ u ŋ m o̞ ɯ m	이중모음
이지메	i d͡ʑ i m e̞	이지메
이차방정식	i t͡ɕʰ a̠ b a̠ ŋ d͡ʑ ʌ̹ ŋ ɕʰ i k̚	이차방정식
이차원	iː t͡ɕʰ a̠ w ʌ̹ n	이차원
이체자	iː t͡ɕʰ e̞ t͡ɕ͈ a̠	이체짜
이칼루이트	i kʰ a̠ ɭ ɭ u i tʰ ɯ	이칼루이트
이케바나	i kʰ e̞ b a̠ n a̠	이케바나
이크라	i k x ɯ ɾ a̠	이크라
이탄	iː tʰ a̠ n	이탄
이터븀	i tʰ ʌ̹ b j u m	이터븀
이테르븀	i tʰ e̞ ɾ ɯ b j u m	이테르븀
이토록	i tʰ o̞ ɾ o̞ k̚	이토록
이트륨	i tʰ ɯ ɾ j u m	이트륨
이팝나무	iː pʰ a̠ m n a̠ m u	이팜나무
이혼하다	iː β o̞ n ɦ a̠ d a̠	이혼하다
익	i k̚	익
익년	i ŋ ɲ ʌ̹ n	잉넌
익다	i k̚ t͈ a̠	익따
익사하다	i k s͈ a̠ ɦ a̠ d a̠	익싸하다
익살	i k s͈ a̠ ɭ	익쌀
익살스럽다	i k s͈ a̠ ɭ sʰ ɯ ɾ ʌ̹ p̚ t͈ a̠	익쌀스럽따
익월	i ɡ w ʌ̹ ɭ	이궐
익일	i ɡ i ɭ	이길
인	i n	인
인가	i n ɡ a̠	인가
인건비	i n k͈ ʌ̹ n b i	인껀비
인공위성	i n ɡ o̞ ŋ ɥ i sʰ ʌ̹ ŋ	인공위성
인광	i n ɡ w a̠ ŋ	인광
인구어계	i n ɡ u ʌ̹ ɡ j e̞	인구어계
인구어족	i n ɡ u ʌ̹ d͡ʑ o̞ k̚	인구어족
인국	i n ɡ u k̚	인국
인기척	i n k͈ i t͡ɕʰ ʌ̹ k̚	인끼척
인다라망	i n d a̠ ɾ a̠ m a̠ ŋ	인다라망
인덴	i n d e̞ n	인덴
인도유럽어족	i n d o̞ j u ɾ ʌ̹ b ʌ̹ d͡ʑ o̞ k̚	인도유러버족
인듐	i n d j u m	인듐
인디아나	i n d i a̠ n a̠	인디아나
인부	i n b u	인부
인사하다	i n sʰ a̠ ɦ a̠ d a̠	인사하다
인상	i n sʰ a̠ ŋ	인상
인서울	i n sʰ ʌ̹ u ɭ	인서울
인식하다	i n ɕʰ i kʰ a̠ d a̠	인시카다
인싸	i n s͈ a̠	인싸
인저	i ɲ d͡ʑ ʌ̹	인저
인적	i ɲ d͡ʑ ʌ̹ k̚	인적
인정하다	i ɲ d͡ʑ ʌ̹ ŋ ɦ a̠ d a̠	인정하다
인조인간	i ɲ d͡ʑ o̞ i n ɡ a̠ n	인조인간
인종차별주의	i ɲ d͡ʑ o̞ ŋ t͡ɕʰ a̠ b j ʌ̹ ʎ d͡ʑ u ɰ i	인종차별주의
인종차별주의자	i ɲ d͡ʑ o̞ ŋ t͡ɕʰ a̠ b j ʌ̹ ʎ d͡ʑ u ɰ i d͡ʑ a̠	인종차별주의자
인증하다	i ɲ d͡ʑ ɯ ŋ ɦ a̠ d a̠	인증하다
인지상정	i ɲ d͡ʑ i sʰ a̠ ŋ d͡ʑ ʌ̹ ŋ	인지상정
인질극	i ɲ d͡ʑ i ɭ ɡ ɯ k̚	인질극
인칭	i ɲ t͡ɕʰ i ŋ	인칭
일	i ɭ	일
일거리	iː ɭ k͈ ʌ̹ ɾ i	일꺼리
일거수일투족	i ɭ ɡ ʌ̹ sʰ u i ɭ tʰ u d͡ʑ o̞ k̚	일거수일투족
일거일동	i ɭ ɡ ʌ̹ i ɭ t͈ o̞ ŋ	일거일똥
일건서류	i ɭ ɡ ʌ̹ n sʰ ʌ̹ ɾ j u	일건서류
일과표	i ɭ ɡ w a̠ pʰ j o	일과표
일광욕	i ɭ ɡ w a̠ ŋ j o k̚	일광욕
일구이언	i ɭ ɡ u i ʌ̹ n	일구이언
일그리다	i ɭ ɡ ɯ ɾ i d a̠	일그리다
일년감	i ʎ ʎ ʌ̹ n ɡ a̠ m	일런감
일떠세우다	i ɭ t͈ ʌ̹ sʰ e̞ u d a̠	일떠세우다
일루수	i ɭ ɭ u sʰ u	일루수
일류	i ʎ ʎ u	일루
일리노이	i ʎ ʎ i n o̞ i	일리노이
일면식	i ɭ m j ʌ̹ n ɕʰ i k̚	일면식
일벌	iː ɭ b ʌ̹ ɭ	일벌
일본국	i ɭ b o̞ n ɡ u k̚	일본국
일본잎갈나무	i ɭ b o̞ n i p̚ k͈ a̠ ɭ ɭ a̠ m u	일보닙깔라무
일시	i ɭ ɕ͈ i	일씨
일신교	i ɭ ɕʰ i n ɡ j o	일신교
일신론	i ɭ ɕ͈ i n n o̞ n	일씬논
일심단결	i ɭ ɕ͈ i m d a̠ n ɡ j ʌ̹ ɭ	일씸단결
일없다	iː ɾ ʌ̹ p̚ t͈ a̠	이럽따
일여덟	i ɾ j ʌ̹ d ʌ̹ ɭ	이려덜
일용품	i ɾ j o ŋ pʰ u m	이룡품
일천하다	i ʎ t͡ɕʰ ʌ̹ n ɦ a̠ d a̠	일천하다
일축	i ʎ t͡ɕʰ u k̚	일축
일컫다	i ɭ kʰ ʌ̹ t̚ t͈ a̠	일컫따
일컬리다	i ɭ kʰ ʌ̹ ʎ ʎ i d a̠	일컬리다
일코	i ɭ kʰ o̞	일코
일터	iː ɭ tʰ ʌ̹	일터
일확천금	i ɾ β w a̠ k̚ t͡ɕʰ ʌ̹ n ɡ ɯ m	일확천금
잃어버리다	i ɾ ʌ̹ b ʌ̹ ɾ i d a̠	이러버리다
임	i m	임
임금	i m ɡ ɯ m	임금
임상	i m sʰ a̠ ŋ	임상
임신하다	iː m ɕʰ i n ɦ a̠ d a̠	임신하다
임업	i m ʌ̹ p̚	이멉
임연수어	i m j ʌ̹ n sʰ u ʌ̹	이면수어
임진강	i m d͡ʑ i n ɡ a̠ ŋ	임진강
임하다	i m ɦ a̠ d a̠	임하다
입	i p̚	입
입겿	i p̚ k͈ j ʌ̹ t̚	입껻
입국	i p̚ k͈ u k̚	입꾹
입덕	i p̚ t͈ ʌ̹ k̚	입떡
입덕하다	i p̚ t͈ ʌ̹ kʰ a̠ d a̠	입떠카다
입맞추다	i m m a̠ t̚ t͡ɕʰ u d a̠	임맏추다
입방체	i p̚ p͈ a̠ ŋ t͡ɕʰ e̞	입빵체
입법자	i p̚ p͈ ʌ̹ p̚ t͡ɕ͈ a̠	입뻡짜
입술연지	i p s͈ u ʎ ʎ ʌ̹ ɲ d͡ʑ i	입쑬런지
입쌀	iː p s͈ a̠ ɭ	입쌀
입음움직씨	i b ɯ m u m d͡ʑ i k ɕ͈ i	이브뭄직씨
입자가속기	i p̚ t͡ɕ͈ a̠ ɡ a̠ sʰ o̞ k̚ k͈ i	입짜가속끼
입자물리학	i p̚ t͡ɕ͈ a̠ m u ʎ ʎ i ɦ a̠ k̚	입짜물리학
입장권	i p̚ t͡ɕ͈ a̠ ŋ k͈ w ʌ̹ n	입짱꿘
입증하다	i p̚ t͡ɕ͈ ɯ ŋ ɦ a̠ d a̠	입쯩하다
입천장	i p̚ t͡ɕʰ ʌ̹ ɲ d͡ʑ a̠ ŋ	입천장
입학하다	i pʰ a̠ kʰ a̠ d a̠	이파카다
입향순속	i pʰ j a̠ ŋ sʰ u n sʰ o̞ k̚	이퍙순속
잇기	iː t̚ k͈ i	읻끼
있으시다	i s͈ ɯ ɕʰ i d a̠	이쓰시다
잉	i ŋ	잉
잊혀지다	i t͡ɕʰ ʌ̹ d͡ʑ i d a̠	이처지다
잎	i p̚	입
잎갈나무	i p̚ k͈ a̠ ɭ ɭ a̠ m u	입깔라무
잎겨드랑이	i p̚ k͈ j ʌ̹ d ɯ ɾ a̠ ŋ i	입껴드랑이
잎꼭지	i p̚ k͈ o̞ k̚ t͡ɕ͈ i	입꼭찌
잎파랑이	i p̚ pʰ a̠ ɾ a̠ ŋ i	입파랑이
자	t͡ɕ a̠	자
자각	t͡ɕ a̠ ɡ a̠ k̚	자각
자각몽	t͡ɕ a̠ ɡ a̠ ŋ m o̞ ŋ	자강몽
자괴감	t͡ɕ a̠ ɡ w e̞ ɡ a̠ m	자괴감
자구다복	t͡ɕ a̠ ɡ u d a̠ b o̞ k̚	자구다복
자국	t͡ɕ a̠ ɡ u k̚	자국
자급자족	t͡ɕ a̠ ɡ ɯ p̚ t͡ɕ͈ a̠ d͡ʑ o̞ k̚	자급짜족
자기	t͡ɕ a̠ ɡ i	자기
자동계단	t͡ɕ a̠ d o̞ ŋ ɡ j e̞ d a̠ n	자동계단
자랑하다	t͡ɕ a̠ ɾ a̠ ŋ ɦ a̠ d a̠	자랑하다
자루	t͡ɕ a̠ ɾ u	자루
자류석	t͡ɕ a̠ ɾ j u sʰ ʌ̹ k̚	자류석
자르다	t͡ɕ a̠ ɾ ɯ d a̠	자르다
자릿하다	t͡ɕ a̠ ɾ i tʰ a̠ d a̠	자리타다
자만추	t͡ɕ a̠ m a̠ ɲ t͡ɕʰ u	자만추
자문	t͡ɕ a̠ː m u n	자문
자본가	t͡ɕ a̠ b o̞ n ɡ a̠	자본가
자비롭다	t͡ɕ a̠ b i ɾ o̞ p̚ t͈ a̠	자비롭따
자살하다	t͡ɕ a̠ sʰ a̠ ɾ ɦ a̠ d a̠	자살하다
자상	t͡ɕ a̠ sʰ a̠ ŋ	자상
자상하다	t͡ɕ a̠ sʰ a̠ ŋ ɦ a̠ d a̠	자상하다
자소서	t͡ɕ a̠ sʰ o̞ sʰ ʌ̹	자소서
자소설	t͡ɕ a̠ sʰ o̞ sʰ ʌ̹ ɭ	자소설
자수하다	t͡ɕ a̠ sʰ u ɦ a̠ d a̠	자수하다
자신감	t͡ɕ a̠ ɕʰ i n ɡ a̠ m	자신감
자역하다	t͡ɕ a̠ j ʌ̹ kʰ a̠ d a̠	자여카다
자연사	t͡ɕ a̠ j ʌ̹ n sʰ a̠	자연사
자연인	t͡ɕ a̠ j ʌ̹ n i n	자여닌
자위하다	t͡ɕ a̠ ɥ i ɦ a̠ d a̠	자위하다
자유분방	t͡ɕ a̠ j u b u n b a̠ ŋ	자유분방
자유의지주의	t͡ɕ a̠ j u ɰ i d͡ʑ i d͡ʑ u ɰ i	자유의지주의
자작나무	t͡ɕ a̠ d͡ʑ a̠ ŋ n a̠ m u	자장나무
자잘	t͡ɕ a̠ d͡ʑ a̠ ɭ	자잘
자주	t͡ɕ a̠ d͡ʑ u	자주
자주복	t͡ɕ a̠ː d͡ʑ u b o̞ k̚	자주복
자찬	t͡ɕ a̠ t͡ɕʰ a̠ n	자찬
자초지종	t͡ɕ a̠ t͡ɕʰ o̞ d͡ʑ i d͡ʑ o̞ ŋ	자초지종
자취하다	t͡ɕ a̠ t͡ɕʰ ɥ i ɦ a̠ d a̠	자취하다
자치제	t͡ɕ a̠ t͡ɕʰ i d͡ʑ e̞	자치제
자치체	t͡ɕ a̠ t͡ɕʰ i t͡ɕʰ e̞	자치체
자화자찬	t͡ɕ a̠ β w a̠ d͡ʑ a̠ t͡ɕʰ a̠ n	자화자찬
작고하다	t͡ɕ a̠ k̚ k͈ o̞ ɦ a̠ d a̠	작꼬하다
작동하다	t͡ɕ a̠ k̚ t͈ o̞ ŋ ɦ a̠ d a̠	작똥하다
작렬하다	t͡ɕ a̠ ŋ ɲ ʌ̹ ɾ ɦ a̠ d a̠	장널하다
작성하다	t͡ɕ a̠ k s͈ ʌ̹ ŋ ɦ a̠ d a̠	작썽하다
작용하다	t͡ɕ a̠ ɡ j o ŋ ɦ a̠ d a̠	자굥하다
작월	t͡ɕ a̠ ɡ w ʌ̹ ɭ	자궐
작은곰자리	t͡ɕ a̠ ɡ ɯ n ɡ o̞ m d͡ʑ a̠ ɾ i	자근곰자리
작은두꺼비	t͡ɕ a̠ː ɡ ɯ n d u k͈ ʌ̹ b i	자근두꺼비
작일	t͡ɕ a̠ ɡ i ɭ	자길
작작	t͡ɕ a̠ k̚ t͡ɕ͈ a̠ k̚	작짝
작풍	t͡ɕ a̠ k̚ pʰ u ŋ	작풍
작하다	t͡ɕ a̠ kʰ a̠ d a̠	자카다
잔	t͡ɕ a̠ n	잔
잔가시고기	t͡ɕ a̠ n ɡ a̠ ɕʰ i ɡ o̞ ɡ i	잔가시고기
잔인	t͡ɕ a̠ n i n	자닌
잔점박이물범	t͡ɕ a̠ ɲ d͡ʑ ʌ̹ m b a̠ ɡ i m u ɭ b ʌ̹ m	잔점바기물범
잔텐	t͡ɕ a̠ n tʰ e̞ n	잔텐
잔학	t͡ɕ a̠ n ɦ a̠ k̚	잔학
잗갈다	t͡ɕ a̠ t̚ k͈ a̠ ɭ d a̠	잗깔다
잘	t͡ɕ a̠ ɭ	잘
잘그	t͡ɕ a̠ ɭ ɡ ɯ	잘그
잘다	t͡ɕ a̠ ɭ d a̠	잘다
잘되다	t͡ɕ a̠ ɭ d w e̞ d a̠	잘되다
잘못하다	t͡ɕ a̠ ɭ m o̞ tʰ a̠ d a̠	잘모타다
잠	t͡ɕ a̠ m	잠
잠간	t͡ɕ a̠ m k͈ a̠ n	잠깐
잠기다	t͡ɕ a̠ m ɡ i d a̠	잠기다
잠꾸러기	t͡ɕ a̠ m k͈ u ɾ ʌ̹ ɡ i	잠꾸러기
잠언	t͡ɕ a̠ m ʌ̹ n	자먼
잠자리	t͡ɕ a̠ m d͡ʑ a̠ ɾ i	잠자리
잠잠우물	t͡ɕ a̠ m d͡ʑ a̠ m u m u ɭ	잠자무물
잡	t͡ɕ a̠ p̚	잡
잡기	t͡ɕ a̠ p̚ k͈ i	잡끼
잡담	t͡ɕ a̠ p̚ t͈ a̠ m	잡땀
잡담하다	t͡ɕ a̠ p̚ t͈ a̠ m ɦ a̠ d a̠	잡땀하다
잡수다	t͡ɕ a̠ p s͈ u d a̠	잡쑤다
잡신	t͡ɕ a̠ p ɕ͈ i n	잡씬
잡아가다	t͡ɕ a̠ b a̠ ɡ a̠ d a̠	자바가다
잡아먹다	t͡ɕ a̠ b a̠ m ʌ̹ k̚ t͈ a̠	자바먹따
잡언	t͡ɕ a̠ b ʌ̹ n	자번
잡화	t͡ɕ a̠ pʰ w a̠	자퐈
잣	t͡ɕ a̠ t̚	잗
장	t͡ɕ a̠ ŋ	장
장가가다	t͡ɕ a̠ː ŋ ɡ a̠ ɡ a̠ d a̠	장가가다
장강	t͡ɕ a̠ ŋ ɡ a̠ ŋ	장강
장광설	t͡ɕ a̠ ŋ ɡ w a̠ ŋ sʰ ʌ̹ ɭ	장광설
장군풀	t͡ɕ a̠ ŋ ɡ u n pʰ u ɭ	장군풀
장기	t͡ɕ a̠ ŋ ɡ i	장기
장냔	t͡ɕ a̠ ŋ ɲ a̠ n	장난
장뇌	t͡ɕ a̠ ŋ n w e̞	장뇌
장님	t͡ɕ a̠ː ŋ n i m	장님
장단점	t͡ɕ a̠ ŋ d a̠ ɲ t͡ɕ͈ ʌ̹ m	장단쩜
장담	t͡ɕ a̠ː ŋ d a̠ m	장담
장담하다	t͡ɕ a̠ː ŋ d a̠ m ɦ a̠ d a̠	장담하다
장력	t͡ɕ a̠ ŋ ɲ ʌ̹ k̚	장넉
장례식	t͡ɕ a̠ː ŋ ɲ e̞ ɕʰ i k̚	장네식
장로	t͡ɕ a̠ː ŋ n o̞	장노
장막	t͡ɕ a̠ ŋ m a̠ k̚	장막
장문	t͡ɕ a̠ ŋ m u n	장문
장발	t͡ɕ a̠ ŋ b a̠ ɭ	장발
장병	t͡ɕ a̠ ŋ b j ʌ̹ ŋ	장병
장서	t͡ɕ a̠ ŋ sʰ ʌ̹	장서
장수	t͡ɕ a̠ ŋ sʰ u	장수
장수말벌	t͡ɕ a̠ ŋ sʰ u m a̠ ɭ b ʌ̹ ɭ	장수말벌
장시	t͡ɕ a̠ ŋ ɕʰ i	장시
장악	t͡ɕ a̠ː ŋ a̠ k̚	장악
장요근	t͡ɕ a̠ː ŋ j o ɡ ɯ n	장요근
장음	t͡ɕ a̠ ŋ ɯ m	장음
장인	t͡ɕ a̠ ŋ i n	장인
장자	t͡ɕ a̠ ŋ d͡ʑ a̠	장자
장타율	t͡ɕ a̠ ŋ tʰ a̠ j u ɭ	장타율
재가승	t͡ɕ ɛː ɡ a̠ sʰ ɯ ŋ	재가승
재구	t͡ɕ ɛː ɡ u	재구
재다	t͡ɕ ɛː d a̠	재다
재상	t͡ɕ ɛː sʰ a̠ ŋ	재상
재소자	t͡ɕ ɛː sʰ o̞ d͡ʑ a̠	재소자
재야당	t͡ɕ ɛː j a̠ d a̠ ŋ	재야당
재일조선어	t͡ɕ ɛː i ʎ d͡ʑ o̞ sʰ ʌ̹ n ʌ̹	재일조서너
재일한국어	t͡ɕ e̞ i ɾ h a̠ n ɡ u ɡ o̞	제일한구고
쟈바	t͡ɕ a̠ b a̠	자바
저	t͡ɕ ʌ̹	저
저널리즘	t͡ɕ ʌ̹ n ʌ̹ ʎ ʎ i d͡ʑ ɯ m	저널리즘
저녁놀	t͡ɕ ʌ̹ ɲ ʌ̹ ŋ n o̞ ɭ	저넝놀
저녁밥	t͡ɕ ʌ̹ ɲ ʌ̹ k̚ p͈ a̠ p̚	저넉빱
저돌	t͡ɕ ʌ̹ d o̞ ɭ	저돌
저리다	t͡ɕ ʌ̹ ɾ i d a̠	저리다
저마늄	t͡ɕ ʌ̹ m a̠ ɲ u m	저마눔
저물다	t͡ɕ ʌ̹ m u ɭ d a̠	저물다
저울	t͡ɕ ʌ̹ u ɭ	저울
저토록	t͡ɕ ʌ̹ tʰ o̞ ɾ o̞ k̚	저토록
적	t͡ɕ ʌ̹ k̚	적
적경	t͡ɕ ʌ̹ k̚ k͈ j ʌ̹ ŋ	적꼉
적국	t͡ɕ ʌ̹ k̚ k͈ u k̚	적꾹
적나라하다	t͡ɕ ʌ̹ ŋ n a̠ ɾ a̠ ɦ a̠ d a̠	정나라하다
적다	t͡ɕ ʌ̹ k̚ t͈ a̠	적따
적당량	t͡ɕ ʌ̹ k̚ t͈ a̠ ŋ ɲ a̠ ŋ	적땅낭
적량	t͡ɕ ʌ̹ ŋ ɲ a̠ ŋ	정낭
적법	t͡ɕ ʌ̹ k̚ p͈ ʌ̹ p̚	적뻡
적법하다	t͡ɕ ʌ̹ k̚ p͈ ʌ̹ pʰ a̠ d a̠	적뻐파다
적삼	t͡ɕ ʌ̹ k s͈ a̠ m	적쌈
적위	t͡ɕ ʌ̹ ɡ ɥ i	저귀
적절히	t͡ɕ ʌ̹ k̚ t͡ɕ͈ ʌ̹ ɾ ʝ i	적쩔히
적확하다	t͡ɕ ʌ̹ kʰ w a̠ kʰ a̠ d a̠	저콰카다
전	t͡ɕ ʌ̹ n	전
전경	t͡ɕ ʌ̹ n ɡ j ʌ̹ ŋ	전경
전국	t͡ɕ ʌ̹ n ɡ u k̚	전국
전기종합악기	t͡ɕ ʌ̹ n ɡ i d͡ʑ o̞ ŋ ɦ a̠ b a̠ k̚ k͈ i	전기종하박끼
전단	t͡ɕ ʌ̹ n d a̠ n	전단
전달하다	t͡ɕ ʌ̹ n d a̠ ɾ ɦ a̠ d a̠	전달하다
전라남북도	t͡ɕ ʌ̹ ɭ ɭ a̠ n a̠ m b u k̚ t͈ o̞	절라남북또
전면	t͡ɕ ʌ̹ n m j ʌ̹ n	전면
전멸	t͡ɕ ʌ̹ n m j ʌ̹ ɭ	전멸
전문일꾼	t͡ɕ ʌ̹ n m u n i ɭ k͈ u n	전무닐꾼
전선	t͡ɕ ʌ̹ n sʰ ʌ̹ n	전선
전성기	t͡ɕ ʌ̹ n sʰ ʌ̹ ŋ ɡ i	전성기
전세	t͡ɕ ʌ̹ n sʰ e̞	전세
전속력	t͡ɕ ʌ̹ n sʰ o̞ ŋ ɲ ʌ̹ k̚	전송넉
전언	t͡ɕ ʌ̹ n ʌ̹ n	저넌
전언판	t͡ɕ ʌ̹ n ʌ̹ n pʰ a̠ n	저넌판
전자가마	t͡ɕ ʌ̹ ɲ d͡ʑ a̠ ɡ a̠ m a̠	전자가마
전자기파	t͡ɕ ʌ̹ ɲ d͡ʑ a̠ ɡ i pʰ a̠	전자기파
전자메일	t͡ɕ ʌ̹ ɲ d͡ʑ a̠ m e̞ i ɭ	전자메일
전지전능	t͡ɕ ʌ̹ ɲ d͡ʑ i d͡ʑ ʌ̹ n n ɯ ŋ	전지전능
전직	t͡ɕ ʌ̹ ɲ d͡ʑ i k̚	전직
전집	t͡ɕ ʌ̹ ɲ d͡ʑ i p̚	전집
전치사	t͡ɕ ʌ̹ ɲ t͡ɕʰ i sʰ a̠	전치사
전파	t͡ɕ ʌ̹ n pʰ a̠	전파
전화하다	t͡ɕ ʌ̹ n β w a̠ ɦ a̠ d a̠	전화하다
절강	t͡ɕ ʌ̹ ɭ ɡ a̠ ŋ	절강
절단	t͡ɕ ʌ̹ ɭ t͈ a̠ n	절딴
절단하다	t͡ɕ ʌ̹ ɭ t͈ a̠ n ɦ a̠ d a̠	절딴하다
절도하다	t͡ɕ ʌ̹ ɭ d o̞ ɦ a̠ d a̠	절도하다
절따빛	t͡ɕ ʌ̹ ɭ t͈ a̠ b i t̚	절따빋
절약하다	t͡ɕ ʌ̹ ɾ j a̠ kʰ a̠ d a̠	저랴카다
절정	t͡ɕ ʌ̹ ʎ t͡ɕ͈ ʌ̹ ŋ	절쩡
절제	t͡ɕ ʌ̹ ʎ t͡ɕ͈ e̞	절쩨
절하다	t͡ɕ ʌ̹ ɾ ɦ a̠ d a̠	절하다
점령군	t͡ɕ ʌ̹ m ɲ ʌ̹ ŋ ɡ u n	점넝군
점박이물범	t͡ɕ ʌ̹ m b a̠ ɡ i m u ɭ b ʌ̹ m	점바기물범
점선	t͡ɕ ʌ̹ m sʰ ʌ̹ n	점선
점성술	t͡ɕ ʌ̹ m sʰ ʌ̹ ŋ sʰ u ɭ	점성술
점성학	t͡ɕ ʌ̹ m sʰ ʌ̹ ŋ ɦ a̠ k̚	점성학
점점점	t͡ɕ͈ ʌ̹ m t͡ɕ͈ ʌ̹ m t͡ɕ͈ ʌ̹ m	쩜쩜쩜
점프하다	t͡ɕ͈ ʌ̹ m pʰ ɯ ɦ a̠ d a̠	쩜프하다
접	t͡ɕ ʌ̹ p̚	접
접경	t͡ɕ ʌ̹ p̚ k͈ j ʌ̹ ŋ	접꼉
접다	t͡ɕ ʌ̹ p̚ t͈ a̠	접따
접두사	t͡ɕ ʌ̹ p̚ t͈ u sʰ a̠	접뚜사
접두어	t͡ɕ ʌ̹ p̚ t͈ u ʌ̹	접뚜어
접속사	t͡ɕ ʌ̹ p s͈ o̞ k s͈ a̠	접쏙싸
접수인	t͡ɕ ʌ̹ p s͈ u i n	접쑤인
접신	t͡ɕ ʌ̹ p ɕ͈ i n	접씬
접종	t͡ɕ ʌ̹ p̚ t͡ɕ͈ o̞ ŋ	접쫑
접종하다	t͡ɕ ʌ̹ p̚ t͡ɕ͈ o̞ ŋ ɦ a̠ d a̠	접쫑하다
젓	t͡ɕ ʌ̹ t̚	젇
젓가락질하다	t͡ɕ ʌ̹ t̚ k͈ a̠ ɾ a̠ k̚ t͡ɕ͈ i ɾ ɦ a̠ d a̠	젇까락찔하다
정	t͡ɕ ʌ̹ ŋ	정
정당	t͡ɕ ʌ̹ ŋ d a̠ ŋ	정당
정돈	t͡ɕ ʌ̹ ŋ d o̞ n	정돈
정력	t͡ɕ ʌ̹ ŋ ɲ ʌ̹ k̚	정넉
정례	t͡ɕ ʌ̹ ŋ ɲ e̞	정네
정변	t͡ɕ ʌ̹ ŋ b j ʌ̹ n	정변
정복하다	t͡ɕ ʌ̹ ŋ b o̞ kʰ a̠ d a̠	정보카다
정부군	t͡ɕ ʌ̹ ŋ b u ɡ u n	정부군
정상	t͡ɕ ʌ̹ ŋ sʰ a̠ ŋ	정상
정상위	t͡ɕ ʌ̹ ŋ sʰ a̠ ŋ ɥ i	정상위
정신과	t͡ɕ ʌ̹ ŋ ɕʰ i n k͈ w a̠	정신꽈
정신승리	t͡ɕ ʌ̹ ŋ ɕʰ i n sʰ ɯ ŋ n i	정신승니
정어리	t͡ɕ ʌ̹ ŋ ʌ̹ ɾ i	정어리
정역학	t͡ɕ ʌ̹ ŋ ɲ ʌ̹ kʰ a̠ k̚	정너칵
정자	t͡ɕ ʌ̹ ŋ d͡ʑ a̠	정자
정찰	t͡ɕ ʌ̹ ŋ t͡ɕʰ a̠ ɭ	정찰
정찰병	t͡ɕ ʌ̹ ŋ t͡ɕʰ a̠ ɭ b j ʌ̹ ŋ	정찰병
정찰하다	t͡ɕ ʌ̹ ŋ t͡ɕʰ a̠ ɾ ɦ a̠ d a̠	정찰하다
정체	t͡ɕ ʌ̹ ŋ t͡ɕʰ e̞	정체
정치범	t͡ɕ ʌ̹ ŋ t͡ɕʰ i b ʌ̹ m	정치범
정치질	t͡ɕ ʌ̹ ŋ t͡ɕʰ i d͡ʑ i ɭ	정치질
젖	t͡ɕ ʌ̹ t̚	젇
젖꼴만들기	t͡ɕ ʌ̹ t̚ k͈ o̞ ɭ m a̠ n d ɯ ɭ ɡ i	젇꼴만들기
제	t͡ɕ e̞	제
제갈량	t͡ɕ e̞ ɡ a̠ ʎ ʎ a̠ ŋ	제갈랑
제곱근	t͡ɕ e̞ ɡ o̞ p̚ k͈ ɯ n	제곱끈
제곱미터	t͡ɕ e̞ ɡ o̞ m m i tʰ ʌ̹	제곰미터
제구력	t͡ɕ e̞ː ɡ u ɾ j ʌ̹ k̚	제구력
제국	t͡ɕ e̞ː ɡ u k̚	제국
제논	t͡ɕ e̞ n o̞ n	제논
제니	t͡ɕ e̞ n i	제니
제도	t͡ɕ e̞ d o̞	제도
제독	t͡ɕ e̞ d o̞ k̚	제독
제동기	t͡ɕ e̞ː d o̞ ŋ ɡ i	제동기
제비꽃	t͡ɕ e̞ b i k͈ o̞ t̚	제비꼳
제시하다	t͡ɕ e̞ ɕʰ i ɦ a̠ d a̠	제시하다
제외하다	t͡ɕ e̞ w e̞ ɦ a̠ d a̠	제외하다
제원	t͡ɕ e̞ w ʌ̹ n	제원
제유법	t͡ɕ e̞ j u p͈ ʌ̹ p̚	제유뻡
제의하다	t͡ɕ e̞ ɰ i ɦ a̠ d a̠	제의하다
제인	t͡ɕ e̞ i n	제인
제정신	t͡ɕ e̞ d͡ʑ ʌ̹ ŋ ɕʰ i n	제정신
제조자	t͡ɕ e̞ː d͡ʑ o̞ d͡ʑ a̠	제조자
제조하다	t͡ɕ e̞ː d͡ʑ o̞ ɦ a̠ d a̠	제조하다
제주도롱뇽	t͡ɕ e̞ː d͡ʑ u d o̞ ɾ o̞ ŋ ɲ o ŋ	제주도롱뇽
제주모치망둑	t͡ɕ e̞ː d͡ʑ u m o̞ t͡ɕʰ i m a̠ ŋ d u k̚	제주모치망둑
제주특별자치도	t͡ɕ e̞ː d͡ʑ u tʰ ɯ k̚ p͈ j ʌ̹ ʎ d͡ʑ a̠ t͡ɕʰ i d o̞	제주특뼐자치도
제휴	t͡ɕ e̞ ʝ u	제후
제힘움직씨	t͡ɕ e̞ ʝ i m u m d͡ʑ i k ɕ͈ i	제히뭄직씨
젤	t͡ɕ e̞ ɭ	젤
조	t͡ɕ o̞	조
조각가	t͡ɕ o̞ ɡ a̠ k̚ k͈ a̠	조각까
조공	t͡ɕ o̞ ɡ o̞ ŋ	조공
조교	t͡ɕ o̞ ɡ j o	조교
조그맣다	t͡ɕ o̞ ɡ ɯ m a̠ tʰ a̠	조그마타
조동사	t͡ɕ o̞ d o̞ ŋ sʰ a̠	조동사
조로아스터	t͡ɕ o̞ ɾ o̞ a̠ sʰ ɯ tʰ ʌ̹	조로아스터
조루	t͡ɕ o̞ː ɾ u	조루
조르다	t͡ɕ o̞ ɾ ɯ d a̠	조르다
조리	t͡ɕ o̞ ɾ i	조리
조리다	t͡ɕ o̞ ɾ i d a̠	조리다
조리하다	t͡ɕ o̞ ɾ i ɦ a̠ d a̠	조리하다
조립하다	t͡ɕ o̞ ɾ i pʰ a̠ d a̠	조리파다
조마조마하다	t͡ɕ o̞ m a̠ d͡ʑ o̞ m a̠ ɦ a̠ d a̠	조마조마하다
조물주	t͡ɕ o̞ː m u ʎ t͡ɕ͈ u	조물쭈
조뼛조뼛	t͡ɕ o̞ p͈ j ʌ̹ t̚ t͡ɕ͈ o̞ p͈ j ʌ̹ t̚	조뼏쪼뼏
조사관	t͡ɕ o̞ sʰ a̠ ɡ w a̠ n	조사관
조선	t͡ɕ o̞ sʰ ʌ̹ n	조선
조선글	t͡ɕ o̞ sʰ ʌ̹ n ɡ ɯ ɭ	조선글
조선봉건왕조	t͡ɕ o̞ sʰ ʌ̹ n b o̞ ŋ ɡ ʌ̹ n w a̠ ŋ d͡ʑ o̞	조선봉거놩조
조선옷	t͡ɕ o̞ sʰ ʌ̹ n o̞ t̚	조서녿
조선족	t͡ɕ o̞ sʰ ʌ̹ ɲ d͡ʑ o̞ k̚	조선족
조심하다	t͡ɕ o̞ː ɕʰ i m ɦ a̠ d a̠	조심하다
조언하다	t͡ɕ o̞ː ʌ̹ n ɦ a̠ d a̠	조언하다
조율	t͡ɕ o̞ j u ɭ	조율
조지	t͡ɕ o̞ d͡ʑ i	조지
조촐하다	t͡ɕ o̞ t͡ɕʰ o̞ ɾ ɦ a̠ d a̠	조촐하다
조한	t͡ɕ o̞ ɦ a̠ n	조한
조합형	t͡ɕ o̞ ɦ a̠ pʰ j ʌ̹ ŋ	조하평
조혈	t͡ɕ o̞ ʝ ʌ̹ ɭ	조헐
조화롭다	t͡ɕ o̞ β w a̠ ɾ o̞ p̚ t͈ a̠	조화롭따
조회수	t͡ɕ o̞ː β w e̞ s͈ u	조회쑤
족	t͡ɕ o̞ k̚	족
족집게	t͡ɕ o̞ k̚ t͡ɕ͈ i p̚ k͈ e̞	족찝께
존	t͡ɕ o̞ n	존
존경하다	t͡ɕ o̞ n ɡ j ʌ̹ ŋ ɦ a̠ d a̠	존경하다
존버	t͡ɕ o̞ n b ʌ̹	존버
존예	t͡ɕ o̞ ɲ e̞	조네
존잘남	t͡ɕ o̞ ɲ d͡ʑ a̠ ɭ ɭ a̠ m	존잘람
존호	t͡ɕ o̞ n β o̞	존호
졸	t͡ɕ o̞ ɭ	졸
졸도	t͡ɕ o̞ ɭ d o̞	졸도
졸리다	t͡ɕ o̞ ʎ ʎ i d a̠	졸리다
졸망	t͡ɕ o̞ ɭ m a̠ ŋ	졸망
졸인젖	t͡ɕ o̞ ɾ i ɲ d͡ʑ ʌ̹ t̚	조린젇
졸작	t͡ɕ o̞ ʎ t͡ɕ͈ a̠ k̚	졸짝
졸참나무	t͡ɕ o̞ ʎ t͡ɕʰ a̠ m n a̠ m u	졸참나무
좀	t͡ɕ o̞ m	좀
좀구굴치	t͡ɕ o̞ m ɡ u ɡ u ʎ t͡ɕʰ i	좀구굴치
종	t͡ɕ o̞ ŋ	종
종가시나무	t͡ɕ o̞ ŋ ɡ a̠ ɕʰ i n a̠ m u	종가시나무
종결	t͡ɕ o̞ ŋ ɡ j ʌ̹ ɭ	종결
종국	t͡ɕ o̞ ŋ ɡ u k̚	종국
종다리	t͡ɕ o̞ ŋ d a̠ ɾ i	종다리
종렬	t͡ɕ o̞ ŋ ɲ ʌ̹ ɭ	종널
종료하다	t͡ɕ o̞ ŋ ɲ o ɦ a̠ d a̠	종뇨하다
종성	t͡ɕ o̞ ŋ sʰ ʌ̹ ŋ	종성
종어	t͡ɕ o̞ ŋ ʌ̹	종어
종적	t͡ɕ o̞ ŋ d͡ʑ ʌ̹ k̚	종적
종지부	t͡ɕ o̞ ŋ d͡ʑ i b u	종지부
종횡가	t͡ɕ o̞ ŋ β w e̞ ŋ ɡ a̠	종횡가
좆	t͡ɕ o̞ t̚	졷
좆같다	t͡ɕ o̞ t̚ k͈ a̠ t̚ t͈ a̠	졷깓따
좆나	t͡ɕ o̞ n n a̠	존나
좆되다	t͡ɕ o̞ t̚ t͈ w e̞ d a̠	졷뙤다
좆목	t͡ɕ o̞ n m o̞ k̚	존목
좆문가	t͡ɕ o̞ n m u n ɡ a̠	존문가
좆물	t͡ɕ o̞ n m u ɭ	존물
좆밥	t͡ɕ o̞ t̚ p͈ a̠ p̚	졷빱
좋이	t͡ɕ o̞ i	조이
좌빨	t͡ɕ w a̠ː p͈ a̠ ɭ	좌빨
좌식	t͡ɕ w a̠ː ɕʰ i k̚	좌식
좌안	t͡ɕ w a̠ a̠ n	좌안
좌우명	t͡ɕ w a̠ː u m j ʌ̹ ŋ	좌우명
좌좀	t͡ɕ w a̠ː d͡ʑ o̞ m	좌좀
좌지우지	t͡ɕ w a̠ d͡ʑ i u d͡ʑ i	좌지우지
좌파	t͡ɕ w a̠ː pʰ a̠	좌파
좽이	t͡ɕ w ɛː ŋ i	좽이
죄	t͡ɕ w e̞ː	죄
죄수복	t͡ɕ w e̞ː sʰ u b o̞ k̚	죄수복
죙이	t͡ɕ w e̞ ŋ i	죙이
죠지아	t͡ɕ o̞ d͡ʑ i a̠	조지아
주	t͡ɕ u	주
주가	t͡ɕ u k͈ a̠	주까
주걱뿔사슴	t͡ɕ u ɡ ʌ̹ k̚ p͈ u ɭ sʰ a̠ sʰ ɯ m	주걱뿔사슴
주검	t͡ɕ u ɡ ʌ̹ m	주검
주격	t͡ɕ u k͈ j ʌ̹ k̚	주껵
주구	t͡ɕ u ɡ u	주구
주기	t͡ɕ u ɡ i	주기
주기율표	t͡ɕ u ɡ i j u ɭ pʰ j o	주기율표
주년	t͡ɕ u ɲ ʌ̹ n	주넌
주노	t͡ɕ u n o̞	주노
주두	t͡ɕ u d u	주두
주둥이	t͡ɕ u d u ŋ i	주둥이
주둥치	t͡ɕ u d u ŋ t͡ɕʰ i	주둥치
주라	t͡ɕ u ɾ a̠	주라
주리다	t͡ɕ uː ɾ i d a̠	주리다
주먹밥	t͡ɕ u m ʌ̹ k̚ p͈ a̠ p̚	주먹빱
주목하다	t͡ɕ u m o̞ kʰ a̠ d a̠	주모카다
주문하다	t͡ɕ uː m u n ɦ a̠ d a̠	주문하다
주바	t͡ɕ u b a̠	주바
주발	t͡ɕ u b a̠ ɭ	주발
주비	t͡ɕ u b i	주비
주뼛	t͡ɕ u p͈ j ʌ̹ t̚	주뼏
주뼛주뼛	t͡ɕ u p͈ j ʌ̹ t̚ t͡ɕ͈ u p͈ j ʌ̹ t̚	주뼏쭈뼏
주시	t͡ɕ uː ɕʰ i	주시
주어지다	t͡ɕ u ʌ̹ d͡ʑ i d a̠	주어지다
주억	t͡ɕ u ʌ̹ k̚	주억
주의	t͡ɕ u ɰ i	주의
주의하다	t͡ɕ u ɰ i ɦ a̠ d a̠	주의하다
주일	t͡ɕ u i ɭ	주일
주작	t͡ɕ u d͡ʑ a̠ k̚	주작
주저앉다	t͡ɕ u d͡ʑ ʌ̹ a̠ n t͈ a̠	주저안따
주정꾼	t͡ɕ uː d͡ʑ ʌ̹ ŋ k͈ u n	주정꾼
주제가	t͡ɕ u d͡ʑ e̞ ɡ a̠	주제가
주제곡	t͡ɕ u d͡ʑ e̞ ɡ o̞ k̚	주제곡
주차하다	t͡ɕ uː t͡ɕʰ a̠ ɦ a̠ d a̠	주차하다
주체스럽다	t͡ɕ u t͡ɕʰ e̞ sʰ ɯ ɾ ʌ̹ p̚ t͈ a̠	주체스럽따
주판	t͡ɕ uː pʰ a̠ n	주판
죽	t͡ɕ u k̚	죽
죽이다	t͡ɕ u ɡ i d a̠	주기다
준주	t͡ɕ uː ɲ d͡ʑ u	준주
줄	t͡ɕ u ɭ	줄
줄납자루	t͡ɕ u ɭ ɭ a̠ p̚ t͡ɕ͈ a̠ ɾ u	줄랍짜루
줄망둑	t͡ɕ u ɭ m a̠ ŋ d u k̚	줄망둑
줄임말	t͡ɕ u ɾ i m m a̠ ɭ	주림말
줄풀	t͡ɕ u ɭ pʰ u ɭ	줄풀
중	t͡ɕ u ŋ	중
중공업	t͡ɕ uː ŋ ɡ o̞ ŋ ʌ̹ p̚	중공업
중국말	t͡ɕ u ŋ ɡ u ŋ m a̠ ɭ	중궁말
중뇌	t͡ɕ u ŋ n w e̞	중뇌
중도주의	t͡ɕ u ŋ d o̞ d͡ʑ u ɰ i	중도주의
중령	t͡ɕ u ŋ ɲ ʌ̹ ŋ	중넝
중미주	t͡ɕ u ŋ m i d͡ʑ u	중미주
중복되다	t͡ɕ uː ŋ b o̞ k̚ t͈ w e̞ d a̠	중복뙤다
중세국어	t͡ɕ u ŋ sʰ e̞ ɡ u ɡ ʌ̹	중세구거
중식	t͡ɕ u ŋ ɕʰ i k̚	중식
중심지	t͡ɕ u ŋ ɕʰ i m d͡ʑ i	중심지
중얼거리다	t͡ɕ u ŋ ʌ̹ ɭ ɡ ʌ̹ ɾ i d a̠	중얼거리다
중얼중얼	t͡ɕ u ŋ ʌ̹ ʎ d͡ʑ u ŋ ʌ̹ ɭ	중얼중얼
중요시	t͡ɕ uː ŋ j o ɕʰ i	중요시
중요시되다	t͡ɕ uː ŋ j o ɕʰ i d w e̞ d a̠	중요시되다
중용	t͡ɕ u ŋ j o ŋ	중용
중자	t͡ɕ u ŋ d͡ʑ a̠	중자
중장	t͡ɕ u ŋ d͡ʑ a̠ ŋ	중장
중천	t͡ɕ u ŋ t͡ɕʰ ʌ̹ n	중천
중추절	t͡ɕ u ŋ t͡ɕʰ u d͡ʑ ʌ̹ ɭ	중추절
중하다	t͡ɕ uː ŋ ɦ a̠ d a̠	중하다
줘	t͡ɕ w ʌ̹	줘
줴치다	t͡ɕ w e̞ː t͡ɕʰ i d a̠	줴치다
쥐	t͡ɕ ɥ i	쥐
쥐다	t͡ɕ ɥ iː d a̠	쥐다
쥐며느리	t͡ɕ ɥ i m j ʌ̹ n ɯ ɾ i	쥐며느리
쥑이다	t͡ɕ ɥ i ɡ i d a̠	쥐기다
쥬스	t͡ɕ u sʰ ɯ	주스
즉	t͡ɕ ɯ k̚	즉
즉각	t͡ɕ ɯ k̚ k͈ a̠ k̚	즉깍
즉결	t͡ɕ ɯ k̚ k͈ j ʌ̹ ɭ	즉껼
즉답	t͡ɕ ɯ k̚ t͈ a̠ p̚	즉땁
즉사	t͡ɕ ɯ k s͈ a̠	즉싸
즉석	t͡ɕ ɯ k s͈ ʌ̹ k̚	즉썩
즉위	t͡ɕ ɯ ɡ ɥ i	즈귀
즉일	t͡ɕ ɯ ɡ i ɭ	즈길
즉흥	t͡ɕ ɯ k x ɯ ŋ	즈킁
즐	t͡ɕ ɯ ɭ	즐
즐비	t͡ɕ ɯ ɭ b i	즐비
즐비하다	t͡ɕ ɯ ɭ b i ɦ a̠ d a̠	즐비하다
즘게	t͡ɕ ɯ m ɡ e̞	즘게
즙	t͡ɕ ɯ p̚	즙
증	t͡ɕ ɯ ŋ	증
증가되다	t͡ɕ ɯ ŋ ɡ a̠ d w e̞ d a̠	증가되다
증기선	t͡ɕ ɯ ŋ ɡ i sʰ ʌ̹ n	증기선
증류수	t͡ɕ ɯ ŋ ɲ u sʰ u	증누수
증류하다	t͡ɕ ɯ ŋ ɲ u ɦ a̠ d a̠	증누하다
증발	t͡ɕ ɯ ŋ b a̠ ɭ	증발
증조부모	t͡ɕ ɯ ŋ d͡ʑ o̞ b u m o̞	증조부모
지	t͡ɕ i	지
지각자	t͡ɕ i ɡ a̠ k̚ t͡ɕ͈ a̠	지각짜
지각하다	t͡ɕ i ɡ a̠ kʰ a̠ d a̠	지가카다
지게	t͡ɕ i ɡ e̞	지게
지게차	t͡ɕ i ɡ e̞ t͡ɕʰ a̠	지게차
지골리다	t͡ɕ i ɡ o̞ ʎ ʎ i d a̠	지골리다
지과	t͡ɕ i ɡ w a̠	지과
지권	t͡ɕ i k͈ w ʌ̹ n	지꿘
지급시	t͡ɕ i ɡ ɯ p ɕ͈ i	지급씨
지끔	t͡ɕ i k͈ ɯ m	지끔
지낙	t͡ɕ i n a̠ k̚	지낙
지난밤	t͡ɕ i n a̠ n b a̠ m	지난밤
지남석	t͡ɕ i n a̠ m sʰ ʌ̹ k̚	지남석
지네	t͡ɕ i n e̞	지네
지도력	t͡ɕ i d o̞ ɾ j ʌ̹ k̚	지도력
지동설	t͡ɕ i d o̞ ŋ sʰ ʌ̹ ɭ	지동설
지렁	t͡ɕ i ɾ ʌ̹ ŋ	지렁
지루다	t͡ɕ i ɾ u d a̠	지루다
지르다	t͡ɕ i ɾ ɯ d a̠	지르다
지리	t͡ɕ i ɾ i	지리
지리학자	t͡ɕ i ɾ i ɦ a̠ k̚ t͡ɕ͈ a̠	지리학짜
지명하다	t͡ɕ i m j ʌ̹ ŋ ɦ a̠ d a̠	지명하다
지문	t͡ɕ i m u n	지문
지방자치	t͡ɕ i b a̠ ŋ d͡ʑ a̠ t͡ɕʰ i	지방자치
지방족	t͡ɕ i b a̠ ŋ d͡ʑ o̞ k̚	지방족
지부티	t͡ɕ i b u tʰ i	지부티
지불하다	t͡ɕ i b u ɾ ɦ a̠ d a̠	지불하다
지빠귀	t͡ɕ i p͈ a̠ ɡ ɥ i	지빠귀
지아비	t͡ɕ i a̠ b i	지아비
지옥철	t͡ɕ i o̞ k̚ t͡ɕʰ ʌ̹ ɭ	지옥철
지완	t͡ɕ i w a̠ n	지완
지완하다	t͡ɕ i w a̠ n ɦ a̠ d a̠	지완하다
지원하다	t͡ɕ i w ʌ̹ n ɦ a̠ d a̠	지원하다
지읒	t͡ɕ i ɯ t̚	지읃
지의류	t͡ɕ i ɰ i ɾ j u	지의류
지장	t͡ɕ i d͡ʑ a̠ ŋ	지장
지저귀다	t͡ɕ i d͡ʑ ʌ̹ ɡ ɥ i d a̠	지저귀다
지적	t͡ɕ i d͡ʑ ʌ̹ k̚	지적
지적되다	t͡ɕ i d͡ʑ ʌ̹ k̚ t͈ w e̞ d a̠	지적뙤다
지지부진	t͡ɕ i d͡ʑ i b u d͡ʑ i n	지지부진
지지하다	t͡ɕ i d͡ʑ i ɦ a̠ d a̠	지지하다
지진학	t͡ɕ i d͡ʑ i n ɦ a̠ k̚	지진학
지질학자	t͡ɕ i d͡ʑ i ɾ ɦ a̠ k̚ t͡ɕ͈ a̠	지질학짜
지척	t͡ɕ i t͡ɕʰ ʌ̹ k̚	지척
지침	t͡ɕ i t͡ɕʰ i m	지침
지피다	t͡ɕ i pʰ i d a̠	지피다
지하누비	t͡ɕ i ɦ a̠ n u b i	지하누비
지형	t͡ɕ i ʝ ʌ̹ ŋ	지헝
지형학	t͡ɕ i ʝ ʌ̹ ŋ ɦ a̠ k̚	지헝학
지혜롭다	t͡ɕ i ʝ e̞ ɾ o̞ p̚ t͈ a̠	지헤롭따
지혜서	t͡ɕ i ʝ e̞ sʰ ʌ̹	지헤서
지휘	t͡ɕ i ɦ ɥ i	지휘
직	t͡ɕ i k̚	직
직경	t͡ɕ i k̚ k͈ j ʌ̹ ŋ	직꼉
직구	t͡ɕ i k̚ k͈ u	직꾸
직무	t͡ɕ i ŋ m u	징무
직발	t͡ɕ i k̚ p͈ a̠ ɭ	직빨
직분	t͡ɕ i k̚ p͈ u n	직뿐
직선	t͡ɕ i k s͈ ʌ̹ n	직썬
직설법	t͡ɕ iː k s͈ ʌ̹ ɭ p͈ ʌ̹ p̚	직썰뻡
직승기	t͡ɕ i k s͈ ɯ ŋ ɡ i	직씅기
직업여성	t͡ɕ i ɡ ʌ̹ m ɲ ʌ̹ sʰ ʌ̹ ŋ	지검너성
직접화법	t͡ɕ i k̚ t͡ɕ͈ ʌ̹ pʰ w a̠ b ʌ̹ p̚	직쩌퐈법
진공관	t͡ɕ i n ɡ o̞ ŋ ɡ w a̠ n	진공관
진급	t͡ɕ iː n ɡ ɯ p̚	진급
진뗑이	t͡ɕ i n t͈ e̞ ŋ i	진뗑이
진랍	t͡ɕ i ɭ ɭ a̠ p̚	질랍
진상	t͡ɕ i n sʰ a̠ ŋ	진상
진실게임	t͡ɕ i n ɕʰ i ɭ k͈ e̞ i m	진실께임
진압하다	t͡ɕ i n a̠ pʰ a̠ d a̠	지나파다
진언	t͡ɕ i n ʌ̹ n	지넌
진여	t͡ɕ i ɲ ʌ̹	지너
진열	t͡ɕ iː ɲ ʌ̹ ɭ	지널
진입	t͡ɕ i n i p̚	지닙
진정하다	t͡ɕ i ɲ d͡ʑ ʌ̹ ŋ ɦ a̠ d a̠	진정하다
진주층	t͡ɕ i ɲ d͡ʑ u t͡ɕʰ ɯ ŋ	진주층
진찰	t͡ɕ iː ɲ t͡ɕʰ a̠ ɭ	진찰
진찰하다	t͡ɕ iː ɲ t͡ɕʰ a̠ ɾ ɦ a̠ d a̠	진찰하다
질	t͡ɕ i ɭ	질
질식	t͡ɕ i ɭ ɕʰ i k̚	질식
질식하다	t͡ɕ i ɭ ɕʰ i kʰ a̠ d a̠	질시카다
질주	t͡ɕ i ʎ t͡ɕ͈ u	질쭈
질주하다	t͡ɕ i ʎ t͡ɕ͈ u ɦ a̠ d a̠	질쭈하다
질타하다	t͡ɕ i ɭ tʰ a̠ ɦ a̠ d a̠	질타하다
질투하다	t͡ɕ i ɭ tʰ u ɦ a̠ d a̠	질투하다
짊어지다	t͡ɕ i ɭ m ʌ̹ d͡ʑ i d a̠	질머지다
짐	t͡ɕ i m	짐
짐꾼	t͡ɕ i m k͈ u n	짐꾼
짐작하다	t͡ɕ i m d͡ʑ a̠ kʰ a̠ d a̠	짐자카다
짐치	t͡ɕ i m t͡ɕʰ i	짐치
집	t͡ɕ i p̚	집
집난이	t͡ɕ i m n a̠ n i	짐나니
집락	t͡ɕ i m n a̠ k̚	짐낙
집비둘기	t͡ɕ i p̚ p͈ i d u ɭ ɡ i	집삐둘기
집안일	t͡ɕ i b a̠ n i ɭ	지바닐
집오리	t͡ɕ i b o̞ ɾ i	지보리
집유령거미	t͡ɕ i b j u ɾ j ʌ̹ ŋ ɡ ʌ̹ m i	지뷰령거미
집주인	t͡ɕ i p̚ t͡ɕ͈ u i n	집쭈인
집중력	t͡ɕ i p̚ t͡ɕ͈ u ŋ ɲ ʌ̹ k̚	집쭝넉
집착	t͡ɕ i p̚ t͡ɕʰ a̠ k̚	집착
집회서	t͡ɕ i pʰ w e̞ sʰ ʌ̹	지푀서
짓	t͡ɕ iː t̚	짇
짓궂다	t͡ɕ iː t̚ k͈ u t̚ t͈ a̠	짇꾿따
짓이기다	t͡ɕ i n n i ɡ i d a̠	진니기다
징	t͡ɕ i ŋ	징
징거미	t͡ɕ i ŋ ɡ ʌ̹ m i	징거미
징그럽다	t͡ɕ i ŋ ɡ ɯ ɾ ʌ̹ p̚ t͈ a̠	징그럽따
징벌	t͡ɕ i ŋ b ʌ̹ ɭ	징벌
징역	t͡ɕ i ŋ j ʌ̹ k̚	징역
징조	t͡ɕ i ŋ d͡ʑ o̞	징조
짖다	t͡ɕ i t̚ t͈ a̠	짇따
짚	t͡ɕ i p̚	집
짚티미	t͡ɕ i p̚ tʰ i m i	집티미
짜	t͡ɕ͈ a̠	짜
짜굽다	t͡ɕ͈ a̠ ɡ u p̚ t͈ a̠	짜굽따
짝	t͡ɕ͈ a̠ k̚	짝
짝남	t͡ɕ͈ a̠ ŋ n a̠ m	짱남
짝녀	t͡ɕ͈ a̠ ŋ ɲ ʌ̹	짱너
짠지	t͡ɕ͈ a̠ ɲ d͡ʑ i	짠지
짤	t͡ɕ͈ a̠ ɭ	짤
짤방	t͡ɕ͈ a̠ ɭ b a̠ ŋ	짤방
짤줍	t͡ɕ͈ a̠ ʎ d͡ʑ u p̚	짤줍
짤줍하다	t͡ɕ͈ a̠ ʎ d͡ʑ u pʰ a̠ d a̠	짤주파다
짬	t͡ɕ͈ a̠ m	짬
짬밥	t͡ɕ͈ a̠ m p͈ a̠ p̚	짬빱
짭	t͡ɕ͈ a̠ p̚	짭
짱	t͡ɕ͈ a̠ ŋ	짱
짱꼴라	t͡ɕ͈ a̠ ŋ k͈ o̞ ɭ ɭ a̠	짱꼴라
짱뚱어	t͡ɕ͈ a̠ ŋ t͈ u ŋ ʌ̹	짱뚱어
쩔어	t͡ɕ͈ ʌ̹ ɾ ʌ̹	쩌러
쩡	t͡ɕ͈ ʌ̹ ŋ	쩡
쪄	t͡ɕ͈ ʌ̹	쩌
쪼박	t͡ɕ͈ o̞ b a̠ k̚	쪼박
쪼뼛	t͡ɕ͈ o̞ p͈ j ʌ̹ t̚	쪼뼏
쪼뼛쪼뼛	t͡ɕ͈ o̞ p͈ j ʌ̹ t̚ t͡ɕ͈ o̞ p͈ j ʌ̹ t̚	쪼뼏쪼뼏
쪽	t͡ɕ͈ o̞ k̚	쪽
쫄깃하다	t͡ɕ͈ o̞ ɭ ɡ i tʰ a̠ d a̠	쫄기타다
쫑쫑	t͡ɕ͈ o̞ ŋ t͡ɕ͈ o̞ ŋ	쫑쫑
쬐다	t͡ɕ͈ w e̞ː d a̠	쬐다
쭈뼛	t͡ɕ͈ u p͈ j ʌ̹ t̚	쭈뼏
쭉	t͡ɕ͈ u k̚	쭉
쭝쯔	t͡ɕ͈ u ŋ t͡ɕ͈ ɯ	쭝쯔
찌그러지다	t͡ɕ͈ i ɡ ɯ ɾ ʌ̹ d͡ʑ i d a̠	찌그러지다
찌끄레기	t͡ɕ͈ i k͈ ɯ ɾ e̞ ɡ i	찌끄레기
찌다	t͡ɕ͈ i d a̠	찌다
찌릿하다	t͡ɕ͈ i ɾ i tʰ a̠ d a̠	찌리타다
찌뿌둥하다	t͡ɕ͈ i p͈ u d u ŋ ɦ a̠ d a̠	찌뿌둥하다
찌아찌아어	t͡ɕ͈ i a̠ t͡ɕ͈ i a̠ ʌ̹	찌아찌아어
찌푸리다	t͡ɕ͈ i pʰ u ɾ i d a̠	찌푸리다
찐	t͡ɕ͈ i n	찐
찐따	t͡ɕ͈ i n t͈ a̠	찐따
찔게	t͡ɕ͈ i ɭ ɡ e̞	찔게
찔리다	t͡ɕ͈ i ʎ ʎ i d a̠	찔리다
찜	t͡ɕ͈ i m	찜
찡그리다	t͡ɕ͈ i ŋ ɡ ɯ ɾ i d a̠	찡그리다
찢	t͡ɕ͈ i t̚	찓
찢다	t͡ɕ͈ i t̚ t͈ a̠	찓따
찢어지다	t͡ɕ͈ i d͡ʑ ʌ̹ d͡ʑ i d a̠	찌저지다
찧다	t͡ɕ͈ i tʰ a̠	찌타
차	t͡ɕʰ a̠	차
차감	t͡ɕʰ a̠ ɡ a̠ m	차감
차근차근	t͡ɕʰ a̠ ɡ ɯ ɲ t͡ɕʰ a̠ ɡ ɯ n	차근차근
차돌박이	t͡ɕʰ a̠ d o̞ ɭ b a̠ ɡ i	차돌바기
차르	t͡ɕʰ a̠ ɾ ɯ	차르
차리다	t͡ɕʰ a̠ ɾ i d a̠	차리다
차리차	t͡ɕʰ a̠ ɾ i t͡ɕʰ a̠	차리차
차반	t͡ɕʰ a̠ b a̠ n	차반
차분몫	t͡ɕʰ a̠ b u n m o̞ k̚	차분목
차분하다	t͡ɕʰ a̠ b u n ɦ a̠ d a̠	차분하다
차악	t͡ɕʰ a̠ a̠ k̚	차악
차용	t͡ɕʰ a̠ː j o ŋ	차용
차용어	t͡ɕʰ a̠ː j o ŋ ʌ̹	차용어
차차웅	t͡ɕʰ a̠ t͡ɕʰ a̠ u ŋ	차차웅
차축	t͡ɕʰ a̠ t͡ɕʰ u k̚	차축
차터	t͡ɕʰ a̠ tʰ ʌ̹	차터
차후	t͡ɕʰ a̠ β u	차후
착	t͡ɕʰ a̠ k̚	착
착석하다	t͡ɕʰ a̠ k s͈ ʌ̹ kʰ a̠ d a̠	착써카다
착잡	t͡ɕʰ a̠ k̚ t͡ɕ͈ a̠ p̚	착짭
착잡하다	t͡ɕʰ a̠ k̚ t͡ɕ͈ a̠ pʰ a̠ d a̠	착짜파다
착지	t͡ɕʰ a̠ k̚ t͡ɕ͈ i	착찌
찬	t͡ɕʰ a̠ n	찬
찬란하다	t͡ɕʰ a̠ ɭ ɭ a̠ n ɦ a̠ d a̠	찰란하다
찬물	t͡ɕʰ a̠ n m u ɭ	찬물
찬미하다	t͡ɕʰ a̠ː n m i ɦ a̠ d a̠	찬미하다
찬반	t͡ɕʰ a̠ː n b a̠ n	찬반
찬성하다	t͡ɕʰ a̠ː n sʰ ʌ̹ ŋ ɦ a̠ d a̠	찬성하다
찬양	t͡ɕʰ a̠ː ɲ a̠ ŋ	차낭
찬탈	t͡ɕʰ a̠ː n tʰ a̠ ɭ	찬탈
찰	t͡ɕʰ a̠ ɭ	찰
찰벼	t͡ɕʰ a̠ ɭ b j ʌ̹	찰벼
참	t͡ɕʰ a̠ m	참
참가하다	t͡ɕʰ a̠ m ɡ a̠ ɦ a̠ d a̠	참가하다
참게	t͡ɕʰ a̠ m ɡ e̞	참게
참나물	t͡ɕʰ a̠ m n a̠ m u ɭ	참나물
참돔	t͡ɕʰ a̠ m d o̞ m	참돔
참마자	t͡ɕʰ a̠ m m a̠ d͡ʑ a̠	참마자
참말로	t͡ɕʰ a̠ m m a̠ ɭ ɭ o̞	참말로
참모	t͡ɕʰ a̠ m m o̞	참모
참바	t͡ɕʰ a̠ m b a̠	참바
참별고기	t͡ɕʰ a̠ m b j ʌ̹ ɭ ɡ o̞ ɡ i	참별고기
참수	t͡ɕʰ a̠ː m sʰ u	참수
참신	t͡ɕʰ a̠ː m ɕʰ i n	참신
참신하다	t͡ɕʰ a̠ː m ɕʰ i n ɦ a̠ d a̠	참신하다
참여하다	t͡ɕʰ a̠ m j ʌ̹ ɦ a̠ d a̠	차며하다
참조	t͡ɕʰ a̠ m d͡ʑ o̞	참조
참주	t͡ɕʰ a̠ː m d͡ʑ u	참주
참혹	t͡ɕʰ a̠ m β o̞ k̚	참혹
참회나무	t͡ɕʰ a̠ m β w e̞ n a̠ m u	참회나무
찻물	t͡ɕʰ a̠ n m u ɭ	찬물
찻잎	t͡ɕʰ a̠ n n i p̚	찬닙
찻주전자	t͡ɕʰ a̠ t̚ t͡ɕ͈ u d͡ʑ ʌ̹ ɲ d͡ʑ a̠	찯쭈전자
창	t͡ɕʰ a̠ ŋ	창
창가	t͡ɕʰ a̠ ŋ k͈ a̠	창까
창공	t͡ɕʰ a̠ ŋ ɡ o̞ ŋ	창공
창구	t͡ɕʰ a̠ ŋ ɡ u	창구
창던지기	t͡ɕʰ a̠ ŋ d ʌ̹ ɲ d͡ʑ i ɡ i	창던지기
창렬	t͡ɕʰ a̠ ŋ ɲ ʌ̹ ɭ	창널
창립자	t͡ɕʰ a̠ː ŋ n i p̚ t͡ɕ͈ a̠	창닙짜
창설되다	t͡ɕʰ a̠ː ŋ sʰ ʌ̹ ɭ d w e̞ d a̠	창설되다
창설자	t͡ɕʰ a̠ː ŋ sʰ ʌ̹ ʎ t͡ɕ͈ a̠	창설짜
창설하다	t͡ɕʰ a̠ː ŋ sʰ ʌ̹ ɾ ɦ a̠ d a̠	창설하다
창안	t͡ɕʰ a̠ ŋ a̠ n	창안
창작물	t͡ɕʰ a̠ː ŋ d͡ʑ a̠ ŋ m u ɭ	창장물
창펀	t͡ɕʰ a̠ ŋ pʰ ʌ̹ n	창펀
창포검	t͡ɕʰ a̠ ŋ pʰ o̞ ɡ ʌ̹ m	창포검
채	t͡ɕʰ ɛː	채
처	t͡ɕʰ ʌ̹	처
처부모	t͡ɕʰ ʌ̹ b u m o̞	처부모
처자	t͡ɕʰ ʌ̹ d͡ʑ a̠	처자
처절	t͡ɕʰ ʌ̹ d͡ʑ ʌ̹ ɭ	처절
척	t͡ɕʰ ʌ̹ k̚	척
척량	t͡ɕʰ ʌ̹ ŋ ɲ a̠ ŋ	청낭
천	t͡ɕʰ ʌ̹ n	천
천간	t͡ɕʰ ʌ̹ n ɡ a̠ n	천간
천구	t͡ɕʰ ʌ̹ n ɡ u	천구
천년기	t͡ɕʰ ʌ̹ n ɲ ʌ̹ n ɡ i	천넌기
천도교	t͡ɕʰ ʌ̹ n d o̞ ɡ j o	천도교
천동설	t͡ɕʰ ʌ̹ n d o̞ ŋ sʰ ʌ̹ ɭ	천동설
천렵	t͡ɕʰ ʌ̹ ʎ ʎ ʌ̹ p̚	철럽
천명	t͡ɕʰ ʌ̹ n m j ʌ̹ ŋ	천명
천벌	t͡ɕʰ ʌ̹ n b ʌ̹ ɭ	천벌
천부	t͡ɕʰ ʌ̹ n b u	천부
천분	t͡ɕʰ ʌ̹ n b u n	천분
천저	t͡ɕʰ ʌ̹ ɲ d͡ʑ ʌ̹	천저
천정	t͡ɕʰ ʌ̹ ɲ d͡ʑ ʌ̹ ŋ	천정
천주	t͡ɕʰ ʌ̹ ɲ d͡ʑ u	천주
천지신명	t͡ɕʰ ʌ̹ ɲ d͡ʑ i ɕʰ i n m j ʌ̹ ŋ	천지신명
천진	t͡ɕʰ ʌ̹ ɲ d͡ʑ i n	천진
천체물리학	t͡ɕʰ ʌ̹ ɲ t͡ɕʰ e̞ m u ʎ ʎ i ɦ a̠ k̚	천체물리학
철	t͡ɕʰ ʌ̹ ɭ	철
철거	t͡ɕʰ ʌ̹ ɭ ɡ ʌ̹	철거
철광석	t͡ɕʰ ʌ̹ ɭ ɡ w a̠ ŋ sʰ ʌ̹ k̚	철광석
철사	t͡ɕʰ ʌ̹ ɭ s͈ a̠	철싸
철수	t͡ɕʰ ʌ̹ ɭ sʰ u	철수
철원	t͡ɕʰ ʌ̹ ɾ w ʌ̹ n	처뤈
철자	t͡ɕʰ ʌ̹ ʎ t͡ɕ͈ a̠	철짜
철자하다	t͡ɕʰ ʌ̹ ʎ d͡ʑ a̠ ɦ a̠ d a̠	철자하다
철제	t͡ɕʰ ʌ̹ ʎ t͡ɕ͈ e̞	철쩨
철편	t͡ɕʰ ʌ̹ ɭ pʰ j ʌ̹ n	철편
철학자	t͡ɕʰ ʌ̹ ɾ ɦ a̠ k̚ t͡ɕ͈ a̠	철학짜
철회	t͡ɕʰ ʌ̹ ɾ β w e̞	철회
첨	t͡ɕʰ ʌ̹ m	첨
첨단	t͡ɕʰ ʌ̹ m d a̠ n	첨단
첨부하다	t͡ɕʰ ʌ̹ m b u ɦ a̠ d a̠	첨부하다
첩	t͡ɕʰ ʌ̹ p̚	첩
첫	t͡ɕʰ ʌ̹ t̚	첟
첫가끝	t͡ɕʰ ʌ̹ t̚ k͈ a̠ k͈ ɯ t̚	첟까끋
청	t͡ɕʰ ʌ̹ ŋ	청
청가시고기	t͡ɕʰ ʌ̹ ŋ ɡ a̠ ɕʰ i ɡ o̞ ɡ i	청가시고기
청구	t͡ɕʰ ʌ̹ ŋ ɡ u	청구
청구서	t͡ɕʰ ʌ̹ ŋ ɡ u sʰ ʌ̹	청구서
청구하다	t͡ɕʰ ʌ̹ ŋ ɡ u ɦ a̠ d a̠	청구하다
청기예보	t͡ɕʰ ʌ̹ ŋ ɡ i j e̞ b o̞	청기예보
청도요	t͡ɕʰ ʌ̹ ŋ d o̞ j o	청도요
청량제	t͡ɕʰ ʌ̹ ŋ ɲ a̠ ŋ d͡ʑ e̞	청낭제
청머리오리	t͡ɕʰ ʌ̹ ŋ m ʌ̹ ɾ i o̞ ɾ i	청머리오리
청사	t͡ɕʰ ʌ̹ ŋ sʰ a̠	청사
청사진	t͡ɕʰ ʌ̹ ŋ sʰ a̠ d͡ʑ i n	청사진
청산가리	t͡ɕʰ ʌ̹ ŋ sʰ a̠ n ɡ a̠ ɾ i	청산가리
청상아리	t͡ɕʰ ʌ̹ ŋ sʰ a̠ ŋ a̠ ɾ i	청상아리
청소부	t͡ɕʰ ʌ̹ ŋ sʰ o̞ b u	청소부
청소하다	t͡ɕʰ ʌ̹ ŋ sʰ o̞ ɦ a̠ d a̠	청소하다
청신	t͡ɕʰ ʌ̹ ŋ ɕʰ i n	청신
청신하다	t͡ɕʰ ʌ̹ ŋ ɕʰ i n ɦ a̠ d a̠	청신하다
청어	t͡ɕʰ ʌ̹ ŋ ʌ̹	청어
청원	t͡ɕʰ ʌ̹ ŋ w ʌ̹ n	청원
청주	t͡ɕʰ ʌ̹ ŋ d͡ʑ u	청주
청진기	t͡ɕʰ ʌ̹ ŋ d͡ʑ i n ɡ i	청진기
청천	t͡ɕʰ ʌ̹ ŋ t͡ɕʰ ʌ̹ n	청천
청천강	t͡ɕʰ ʌ̹ ŋ t͡ɕʰ ʌ̹ n ɡ a̠ ŋ	청천강
청취	t͡ɕʰ ʌ̹ ŋ t͡ɕʰ ɥ i	청취
청취력	t͡ɕʰ ʌ̹ ŋ t͡ɕʰ ɥ i ɾ j ʌ̹ k̚	청취력
청취자	t͡ɕʰ ʌ̹ ŋ t͡ɕʰ ɥ i d͡ʑ a̠	청취자
청취하다	t͡ɕʰ ʌ̹ ŋ t͡ɕʰ ɥ i ɦ a̠ d a̠	청취하다
청하다	t͡ɕʰ ʌ̹ ŋ ɦ a̠ d a̠	청하다
청혼	t͡ɕʰ ʌ̹ ŋ β o̞ n	청혼
청혼하다	t͡ɕʰ ʌ̹ ŋ β o̞ n ɦ a̠ d a̠	청혼하다
체	t͡ɕʰ e̞	체
체격	t͡ɕʰ e̞ ɡ j ʌ̹ k̚	체격
체다카	t͡ɕʰ e̞ d a̠ kʰ a̠	체다카
체류	t͡ɕʰ e̞ ɾ j u	체류
체벌	t͡ɕʰ e̞ b ʌ̹ ɭ	체벌
체스꼬	t͡ɕʰ e̞ sʰ ɯ k͈ o̞	체스꼬
체언	t͡ɕʰ e̞ ʌ̹ n	체언
체외사정	t͡ɕʰ e̞ w e̞ sʰ a̠ d͡ʑ ʌ̹ ŋ	체외사정
체용	t͡ɕʰ e̞ j o ŋ	체용
체읍	t͡ɕʰ e̞ ɯ p̚	체읍
체읍하다	t͡ɕʰ e̞ ɯ pʰ a̠ d a̠	체으파다
체적	t͡ɕʰ e̞ d͡ʑ ʌ̹ k̚	체적
체첸어	t͡ɕʰ e̞ t͡ɕʰ e̞ n ʌ̹	체체너
체크어	t͡ɕʰ e̞ k x ɯ ʌ̹	체크어
체포하다	t͡ɕʰ e̞ pʰ o̞ ɦ a̠ d a̠	체포하다
쳐	t͡ɕʰ ʌ̹	처
초	t͡ɕʰ o̞	초
초급학교	t͡ɕʰ o̞ ɡ ɯ pʰ a̠ k̚ k͈ j o	초그팍꾜
초롱	t͡ɕʰ o̞ ɾ o̞ ŋ	초롱
초롱꽃	t͡ɕʰ o̞ ɾ o̞ ŋ k͈ o̞ t̚	초롱꼳
초마	t͡ɕʰ o̞ m a̠	초마
초석	t͡ɕʰ o̞ sʰ ʌ̹ k̚	초석
초심리학	t͡ɕʰ o̞ ɕʰ i m n i ɦ a̠ k̚	초심니학
초어	t͡ɕʰ o̞ ʌ̹	초어
초원수리	t͡ɕʰ o̞ w ʌ̹ n sʰ u ɾ i	초원수리
초은하단	t͡ɕʰ o̞ ɯ n ɦ a̠ d a̠ n	초은하단
초인종	t͡ɕʰ o̞ i ɲ d͡ʑ o̞ ŋ	초인종
초침	t͡ɕʰ o̞ t͡ɕʰ i m	초침
초현실	t͡ɕʰ o̞ ʝ ʌ̹ n ɕʰ i ɭ	초헌실
초호	t͡ɕʰ o̞ β o̞	초호
촉	t͡ɕʰ o̞ k̚	촉
촉지	t͡ɕʰ o̞ k̚ t͡ɕ͈ i	촉찌
촌	t͡ɕʰ o̞ː n	촌
총	t͡ɕʰ o̞ ŋ	총
총검	t͡ɕʰ o̞ ŋ ɡ ʌ̹ m	총검
총구	t͡ɕʰ o̞ ŋ ɡ u	총구
총명하다	t͡ɕʰ o̞ ŋ m j ʌ̹ ŋ ɦ a̠ d a̠	총명하다
총비서	t͡ɕʰ o̞ː ŋ b i sʰ ʌ̹	총비서
총서기	t͡ɕʰ o̞ ŋ sʰ ʌ̹ ɡ i	총서기
총알열차	t͡ɕʰ o̞ ŋ a̠ ɾ j ʌ̹ ʎ t͡ɕʰ a̠	총아렬차
총영사	t͡ɕʰ o̞ ŋ j ʌ̹ ŋ sʰ a̠	총영사
촬	t͡ɕʰ w a̠ ɭ	촬
최	t͡ɕʰ w e̞	최
최고	t͡ɕʰ w e̞ ɡ o̞	최고
최고존엄	t͡ɕʰ w e̞ː ɡ o̞ d͡ʑ o̞ n ʌ̹ m	최고조넘
최다	t͡ɕʰ w e̞ː d a̠	최다
최단	t͡ɕʰ w e̞ː d a̠ n	최단
최면술	t͡ɕʰ w e̞ m j ʌ̹ n sʰ u ɭ	최면술
최소	t͡ɕʰ w e̞ː sʰ o̞	최소
최장	t͡ɕʰ w e̞ː d͡ʑ a̠ ŋ	최장
최저	t͡ɕʰ w e̞ː d͡ʑ ʌ̹	최저
최저임금	t͡ɕʰ w e̞ d͡ʑ ʌ̹ i m ɡ ɯ m	최저임금
최적	t͡ɕʰ w e̞ː d͡ʑ ʌ̹ k̚	최적
최적화	t͡ɕʰ w e̞ː d͡ʑ ʌ̹ kʰ w a̠	최저콰
최후통첩	t͡ɕʰ w e̞ː β u tʰ o̞ ŋ t͡ɕʰ ʌ̹ p̚	최후통첩
추모	t͡ɕʰ u m o̞	추모
추세	t͡ɕʰ u sʰ e̞	추세
추워지다	t͡ɕʰ u w ʌ̹ d͡ʑ i d a̠	추워지다
추잡하다	t͡ɕʰ u d͡ʑ a̠ pʰ a̠ d a̠	추자파다
추출하다	t͡ɕʰ u t͡ɕʰ u ɾ ɦ a̠ d a̠	추출하다
추측하다	t͡ɕʰ u t͡ɕʰ ɯ kʰ a̠ d a̠	추츠카다
추파	t͡ɕʰ u pʰ a̠	추파
추풍	t͡ɕʰ u pʰ u ŋ	추풍
추후	t͡ɕʰ u β u	추후
축	t͡ɕʰ u k̚	축
축소하다	t͡ɕʰ u k s͈ o̞ ɦ a̠ d a̠	축쏘하다
축일	t͡ɕʰ u ɡ i ɭ	추길
축전기	t͡ɕʰ u k̚ t͡ɕ͈ ʌ̹ n ɡ i	축쩐기
축제일	t͡ɕʰ u k̚ t͡ɕ͈ e̞ i ɭ	축쩨일
축지법	t͡ɕʰ u k̚ t͡ɕ͈ i p͈ ʌ̹ p̚	축찌뻡
축하하다	t͡ɕʰ u kʰ a̠ ɦ a̠ d a̠	추카하다
춘	t͡ɕʰ u n	춘
춘장	t͡ɕʰ u ɲ d͡ʑ a̠ ŋ	춘장
춘절	t͡ɕʰ u ɲ d͡ʑ ʌ̹ ɭ	춘절
춘천	t͡ɕʰ u ɲ t͡ɕʰ ʌ̹ n	춘천
출	t͡ɕʰ u ɭ	출
출국	t͡ɕʰ u ɭ ɡ u k̚	출국
출납계	t͡ɕʰ u ɭ ɭ a̠ p̚ k͈ j e̞	출랍꼐
출루율	t͡ɕʰ u ɭ ɭ u j u ɭ	출루율
출몰하다	t͡ɕʰ u ɭ m o̞ ɾ ɦ a̠ d a̠	출몰하다
출발지	t͡ɕʰ u ɭ b a̠ ʎ d͡ʑ i	출발지
출석하다	t͡ɕʰ u ɭ sʰ ʌ̹ kʰ a̠ d a̠	출서카다
출판물	t͡ɕʰ u ɭ pʰ a̠ n m u ɭ	출판물
춤	t͡ɕʰ u m	춤
충	t͡ɕʰ u ŋ	충
충고하다	t͡ɕʰ u ŋ ɡ o̞ ɦ a̠ d a̠	충고하다
충돌하다	t͡ɕʰ u ŋ d o̞ ɾ ɦ a̠ d a̠	충돌하다
충실	t͡ɕʰ u ŋ ɕʰ i ɭ	충실
충심	t͡ɕʰ u ŋ ɕʰ i m	충심
충전하다	t͡ɕʰ u ŋ d͡ʑ ʌ̹ n ɦ a̠ d a̠	충전하다
충청도	t͡ɕʰ u ŋ t͡ɕʰ ʌ̹ ŋ d o̞	충청도
충치	t͡ɕʰ u ŋ t͡ɕʰ i	충치
췌장	t͡ɕʰ w e̞ː d͡ʑ a̠ ŋ	췌장
취득하다	t͡ɕʰ ɥ iː d ɯ kʰ a̠ d a̠	취드카다
취소하다	t͡ɕʰ ɥ iː sʰ o̞ ɦ a̠ d a̠	취소하다
취임	t͡ɕʰ ɥ iː i m	취임
취체	t͡ɕʰ ɥ iː t͡ɕʰ e̞	취체
취흥	t͡ɕʰ ɥ iː ɣ ɯ ŋ	취흥
츄잉껌	t͡ɕʰ u i ŋ k͈ ʌ̹ m	추잉껌
측	t͡ɕʰ ɯ k̚	측
측력계	t͡ɕʰ ɯ ŋ ɲ ʌ̹ k̚ k͈ j e̞	층넉꼐
측은	t͡ɕʰ ɯ ɡ ɯ n	츠근
측은지심	t͡ɕʰ ɯ ɡ ɯ ɲ d͡ʑ i ɕʰ i m	츠근지심
측은하다	t͡ɕʰ ɯ ɡ ɯ n ɦ a̠ d a̠	츠근하다
측정	t͡ɕʰ ɯ k̚ t͡ɕ͈ ʌ̹ ŋ	측쩡
층	t͡ɕʰ ɯ ŋ	층
치	t͡ɕʰ i	치
치기만만	t͡ɕʰ i ɡ i m a̠ n m a̠ n	치기만만
치기만만하다	t͡ɕʰ i ɡ i m a̠ n m a̠ n ɦ a̠ d a̠	치기만만하다
치닫다	t͡ɕʰ i d a̠ t̚ t͈ a̠	치닫따
치료하다	t͡ɕʰ i ɾ j o ɦ a̠ d a̠	치료하다
치루다	t͡ɕʰ i ɾ u d a̠	치루다
치리	t͡ɕʰ i ɾ i	치리
치명률	t͡ɕʰ iː m j ʌ̹ ŋ ɲ u ɭ	치명눌
치수	t͡ɕʰ i sʰ u	치수
치어리딩	t͡ɕʰ i ʌ̹ ɾ i d i ŋ	치어리딩
치우다	t͡ɕʰ i u d a̠	치우다
치읓	t͡ɕʰ i ɯ t̚	치읃
칙	t͡ɕʰ i k̚	칙
친	t͡ɕʰ i n	친
친근	t͡ɕʰ i n ɡ ɯ n	친근
친미	t͡ɕʰ i n m i	친미
친지	t͡ɕʰ i ɲ d͡ʑ i	친지
칠	t͡ɕʰ i ɭ	칠
칠성상어	t͡ɕʰ i ɭ sʰ ʌ̹ ŋ sʰ a̠ ŋ ʌ̹	칠성상어
칠성장어	t͡ɕʰ i ɭ s͈ ʌ̹ ŋ d͡ʑ a̠ ŋ ʌ̹	칠썽장어
칠엽수	t͡ɕʰ i ɾ j ʌ̹ p s͈ u	치렵쑤
칠전팔기	t͡ɕʰ i ʎ d͡ʑ ʌ̹ n pʰ a̠ ɭ ɡ i	칠전팔기
칠촌	t͡ɕʰ i ʎ t͡ɕʰ o̞ n	칠촌
칠하다	t͡ɕʰ i ɾ ɦ a̠ d a̠	칠하다
칡	t͡ɕʰ i k̚	칙
침	t͡ɕʰ i m	침
침략자	t͡ɕʰ iː m ɲ a̠ k̚ t͡ɕ͈ a̠	침낙짜
침울	t͡ɕʰ i m u ɭ	치물
침울하다	t͡ɕʰ i m u ɾ ɦ a̠ d a̠	치물하다
침향	t͡ɕʰ i m ʝ a̠ ŋ	침항
칩	t͡ɕʰ i p̚	칩
칩다	t͡ɕʰ i p̚ t͈ a̠	칩따
카	kʰ a̠	카
카게베	kʰ a̠ ɡ e̞ b e̞	카게베
카공족	kʰ a̠ ɡ o̞ ŋ d͡ʑ o̞ k̚	카공족
카나다	kʰ a̠ n a̠ d a̠	카나다
카니발	kʰ a̠ n i b a̠ ɭ	카니발
카다	kʰ a̠ d a̠	카다
카라반	kʰ a̠ ɾ a̠ b a̠ n	카라반
카라칼	kʰ a̠ ɾ a̠ kʰ a̠ ɭ	카라칼
카레	kʰ a̠ ɾ e̞	카레
카레라이스	kʰ a̠ ɾ e̞ ɾ a̠ i sʰ ɯ	카레라이스
카렌더	kʰ a̠ ɾ e̞ n d ʌ̹	카렌더
카르보닐기	kʰ a̠ ɾ ɯ b o̞ n i ɭ ɡ i	카르보닐기
카르볼린	kʰ a̠ ɾ ɯ b o̞ ʎ ʎ i n	카르볼린
카바졸	kʰ a̠ b a̠ d͡ʑ o̞ ɭ	카바졸
카슈루트	kʰ a̠ ɕʰ u ɾ u tʰ ɯ	카수루트
카인	kʰ a̠ i n	카인
카자흐어	kʰ a̠ d͡ʑ a̠ ɣ ɯ ʌ̹	카자흐어
카카오톡	kʰ a̠ kʰ a̠ o̞ tʰ o̞ k̚	카카오톡
카탈로그	kʰ a̠ tʰ a̠ ɭ ɭ o̞ ɡ ɯ	카탈로그
카펠리니	kʰ a̠ pʰ e̞ ʎ ʎ i n i	카펠리니
카플	kʰ a̠ pʰ ɯ ɭ	카플
칸	kʰ a̠ n	칸
칼	kʰ a̠ ɭ	칼
칼납자루	kʰ a̠ ɭ ɭ a̠ p̚ t͡ɕ͈ a̠ ɾ u	칼랍짜루
칼리움	kʰ a̠ ʎ ʎ i u m	칼리움
캄보쟈	kʰ a̠ m b o̞ d͡ʑ a̠	캄보자
캄차카	kʰ a̠ m t͡ɕʰ a̠ kʰ a̠	캄차카
캄판	kʰ a̠ m pʰ a̠ n	캄판
커	kʰ ʌ̹	커
커닝하다	kʰ ʌ̹ n i ŋ ɦ a̠ d a̠	커닝하다
커엽다	kʰ ʌ̹ j ʌ̹ p̚ t͈ a̠	커엽따
커피메이커	kʰ ʌ̹ pʰ i m e̞ i kʰ ʌ̹	커피메이커
컨닝	kʰ ʌ̹ n n i ŋ	컨닝
컨닝하다	kʰ ʌ̹ n n i ŋ ɦ a̠ d a̠	컨닝하다
컨베이어	kʰ ʌ̹ n b e̞ i ʌ̹	컨베이어
컨셉	kʰ ʌ̹ n sʰ e̞ p̚	컨셉
컬러	kʰ ʌ̹ ɭ ɭ ʌ̹	컬러
컴터	kʰ ʌ̹ m tʰ ʌ̹	컴터
컵	kʰ ʌ̹ p̚	컵
케밥	kʰ e̞ b a̠ p̚	케밥
케블	kʰ e̞ː b ɯ ɭ	케블
케이팝	kʰ e̞ i pʰ a̠ p̚	케이팝
케피르	kʰ e̞ pʰ i ɾ ɯ	케피르
켄트	kʰ e̞ n tʰ ɯ	켄트
켕기다	kʰ e̞ ŋ ɡ i d a̠	켕기다
코	kʰ o̞	코
코나크리	kʰ o̞ n a̠ k x ɯ ɾ i	코나크리
코네티컷	kʰ o̞ n e̞ tʰ i kʰ ʌ̹ t̚	코네티컫
코딩하다	kʰ o̞ d i ŋ ɦ a̠ d a̠	코딩하다
코주부원숭이	kʰ o̞ d͡ʑ u b u w ʌ̹ n sʰ u ŋ i	코주부원숭이
코토누	kʰ o̞ tʰ o̞ n u	코토누
코토레타	kʰ o̞ tʰ o̞ ɾ e̞ tʰ a̠	코토레타
코페르니슘	kʰ o̞ pʰ e̞ ɾ ɯ n i ɕʰ u m	코페르니숨
콘리	kʰ o̞ ʎ ʎ i	콜리
콘비프	kʰ o̞ n b i pʰ ɯ	콘비프
콘센트	kʰ o̞ n sʰ e̞ n tʰ ɯ	콘센트
콘스탄티노폴리스	kʰ o̞ n sʰ ɯ tʰ a̠ n tʰ i n o̞ pʰ o̞ ʎ ʎ i sʰ ɯ	콘스탄티노폴리스
콘테스트	kʰ o̞ n tʰ e̞ sʰ ɯ tʰ ɯ	콘테스트
콘텐츠	kʰ o̞ n tʰ e̞ ɲ t͡ɕʰ ɯ	콘텐츠
콜	kʰ o̞ ɭ	콜
콜로라도	kʰ o̞ ɭ ɭ o̞ ɾ a̠ d o̞	콜로라도
콜롬보	kʰ o̞ ɭ ɭ o̞ m b o̞	콜롬보
콜콜	kʰ o̞ ɭ kʰ o̞ ɭ	콜콜
콤마	kʰ o̞ m m a̠	콤마
콤포트	kʰ o̞ m pʰ o̞ tʰ ɯ	콤포트
콧잔등	kʰ o̞ t̚ t͡ɕ͈ a̠ n d ɯ ŋ	콛짠등
콩	kʰ o̞ ŋ	콩
콩기름	kʰ o̞ ŋ ɡ i ɾ ɯ m	콩기름
콩묵	kʰ o̞ ŋ m u k̚	콩묵
콩밥	kʰ o̞ ŋ b a̠ p̚	콩밥
콩쿠르	kʰ o̞ ŋ kʰ u ɾ ɯ	콩쿠르
콱	kʰ w a̠ k̚	콱
쾅	kʰ w a̠ ŋ	쾅
쿠르드어	kʰ u ɾ ɯ d ɯ ʌ̹	쿠르드어
쿠폰	kʰ u pʰ o̞ n	쿠폰
쿨라크	kʰ u ɭ ɭ a̠ k x ɯ	쿨라크
쿨럭	kʰ u ɭ ɭ ʌ̹ k̚	쿨럭
쿨럭쿨럭	kʰ u ɭ ɭ ʌ̹ k̚ kʰ u ɭ ɭ ʌ̹ k̚	쿨럭쿨럭
쿼티	kʰ w ʌ̹ tʰ i	쿼티
퀘벡	kʰ w e̞ b e̞ k̚	퀘벡
퀴녹살린	kʰ ɥ i n o̞ k s͈ a̠ ʎ ʎ i n	퀴녹쌀린
퀴논	kʰ ɥ i n o̞ n	퀴논
퀴놀린	kʰ ɥ i n o̞ ʎ ʎ i n	퀴놀린
퀴륨	kʰ ɥ i ɾ j u m	퀴륨
퀴퍼	kʰ ɥ i pʰ ʌ̹	퀴퍼
퀸	kʰ ɥ i n	퀸
크게	k x ɯ ɡ e̞	크게
크레믈린	k x ɯ ɾ e̞ m ɯ ʎ ʎ i n	크레믈린
크레송	k x ɯ ɾ e̞ sʰ o̞ ŋ	크레송
크렘린	k x ɯ ɾ e̞ m n i n	크렘닌
크로아티아어	k x ɯ ɾ o̞ a̠ tʰ i a̠ ʌ̹	크로아티아어
크루아상	k x ɯ ɾ u a̠ sʰ a̠ ŋ	크루아상
크리스	k x ɯ ɾ i sʰ ɯ	크리스
크리스트	k x ɯ ɾ i sʰ ɯ tʰ ɯ	크리스트
크리스트교	k x ɯ ɾ i sʰ ɯ tʰ ɯ ɡ j o	크리스트교
크림	k x ɯ ɾ i m	크림
크립톤	k x ɯ ɾ i p̚ tʰ o̞ n	크립톤
크메르어	k x ɯ m e̞ ɾ ɯ ʌ̹	크메르어
크바르크	k x ɯ b a̠ ɾ ɯ k x ɯ	크바르크
크바스	k x ɯ b a̠ sʰ ɯ	크바스
크산텐	k x ɯ sʰ a̠ n tʰ e̞ n	크산텐
큰	k x ɯ n	큰
큰가시고기	k x ɯ n ɡ a̠ ɕʰ i ɡ o̞ ɡ i	큰가시고기
큰곰자리	k x ɯ n ɡ o̞ m d͡ʑ a̠ ɾ i	큰곰자리
큰굿	k x ɯ n ɡ u t̚	큰굳
큰귀박쥐	k x ɯ n ɡ ɥ i b a̠ k̚ t͡ɕ͈ ɥ i	큰귀박쮜
큰귀상어	k x ɯ n ɡ ɥ i sʰ a̠ ŋ ʌ̹	큰귀상어
큰납지리	k x ɯ n n a̠ p̚ t͡ɕ͈ i ɾ i	큰납찌리
큰낫	k x ɯ n n a̠ t̚	큰낟
큰논병아리	k x ɯ n n o̞ n b j ʌ̹ ŋ a̠ ɾ i	큰논병아리
큰눈환도상어	k x ɯ n n u n β w a̠ n d o̞ sʰ a̠ ŋ ʌ̹	큰눈환도상어
큰말똥가리	k x ɯ n m a̠ ɭ t͈ o̞ ŋ ɡ a̠ ɾ i	큰말똥가리
큰무당	k x ɯ n m u d a̠ ŋ	큰무당
큰발뒤쥐	k x ɯ n b a̠ ɭ d ɥ i d͡ʑ ɥ i	큰발뒤쥐
큰볏말뚝망둥어	k x ɯ n b j ʌ̹ n m a̠ ɭ t͈ u ŋ m a̠ ŋ d u ŋ ʌ̹	큰변말뚱망둥어
큰비	k x ɯ n b i	큰비
큰소리치다	k x ɯ n sʰ o̞ ɾ i t͡ɕʰ i d a̠	큰소리치다
큰입우럭	k x ɯ n i b u ɾ ʌ̹ k̚	크니부럭
큰줄납자루	k x ɯ ɲ d͡ʑ u ɭ ɭ a̠ p̚ t͡ɕ͈ a̠ ɾ u	큰줄랍짜루
큰집박쥐	k x ɯ ɲ d͡ʑ i p̚ p͈ a̠ k̚ t͡ɕ͈ ɥ i	큰집빡쮜
큰철갑상어	k x ɯ ɲ t͡ɕʰ ʌ̹ ɭ ɡ a̠ p s͈ a̠ ŋ ʌ̹	큰철갑쌍어
큰첨서	k x ɯ ɲ t͡ɕʰ ʌ̹ m sʰ ʌ̹	큰첨서
큰흰죽지	k x ɯ n ʝ i ɲ d͡ʑ u k̚ t͡ɕ͈ i	큰힌죽찌
클락션	k x ɯ ɭ ɭ a̠ k ɕ͈ ʌ̹ n	클락썬
클로로포름	k x ɯ ɭ ɭ o̞ ɾ o̞ pʰ o̞ ɾ ɯ m	클로로포름
클리토리스	k x ɯ ʎ ʎ i tʰ o̞ ɾ i sʰ ɯ	클리토리스
클릭하다	k x ɯ ʎ ʎ i kʰ a̠ d a̠	클리카다
클마니	k x ɯ ɭ m a̠ n i	클마니
타	tʰ a̠	타
타갈로그어	tʰ a̠ ɡ a̠ ɭ ɭ o̞ ɡ ɯ ʌ̹	타갈로그어
타격수	tʰ a̠ː ɡ j ʌ̹ k s͈ u	타격쑤
타결	tʰ a̠ː ɡ j ʌ̹ ɭ	타결
타나토스	tʰ a̠ n a̠ tʰ o̞ sʰ ɯ	타나토스
타는곳	tʰ a̠ n ɯ n ɡ o̞ t̚	타는곧
타달타달	tʰ a̠ d a̠ ɭ tʰ a̠ d a̠ ɭ	타달타달
타당	tʰ a̠ d a̠ ŋ	타당
타당하다	tʰ a̠ː d a̠ ŋ ɦ a̠ d a̠	타당하다
타동사	tʰ a̠ d o̞ ŋ sʰ a̠	타동사
타령	tʰ a̠ː ɾ j ʌ̹ ŋ	타령
타살	tʰ a̠ sʰ a̠ ɭ	타살
타석	tʰ a̠ː sʰ ʌ̹ k̚	타석
타수	tʰ a̠ː sʰ u	타수
타월	tʰ a̠ w ʌ̹ ɭ	타월
타인	tʰ a̠ i n	타인
타임아웃	tʰ a̠ i m a̠ u t̚	타이마욷
타자하다	tʰ a̠ː d͡ʑ a̠ ɦ a̠ d a̠	타자하다
타코마	tʰ a̠ kʰ o̞ m a̠	타코마
탁	tʰ a̠ k̚	탁
탁상공론	tʰ a̠ k s͈ a̠ ŋ ɡ o̞ ŋ n o̞ n	탁쌍공논
탁월하다	tʰ a̠ ɡ w ʌ̹ ɾ ɦ a̠ d a̠	타궐하다
탄두	tʰ a̠ː n d u	탄두
탄원	tʰ a̠ː n w ʌ̹ n	타눤
탄원하다	tʰ a̠ː n w ʌ̹ n ɦ a̠ d a̠	타눤하다
탄창	tʰ a̠ ɲ t͡ɕʰ a̠ ŋ	탄창
탄탈럼	tʰ a̠ n tʰ a̠ ɭ ɭ ʌ̹ m	탄탈럼
탄트라	tʰ a̠ n tʰ ɯ ɾ a̠	탄트라
탄환열차	tʰ a̠ː n β w a̠ ɲ ʌ̹ ʎ t͡ɕʰ a̠	탄화널차
탈	tʰ a̠ ɭ	탈
탈것	tʰ a̠ ɭ k͈ ʌ̹ t̚	탈껃
탈구	tʰ a̠ ɭ ɡ u	탈구
탈덕	tʰ a̠ ɭ d ʌ̹ k̚	탈덕
탈덕하다	tʰ a̠ ɭ d ʌ̹ kʰ a̠ d a̠	탈더카다
탈리에리니	tʰ a̠ ʎ ʎ i e̞ ɾ i n i	탈리에리니
탈북	tʰ a̠ ɭ b u k̚	탈북
탈세	tʰ a̠ ɭ s͈ e̞	탈쎄
탈세하다	tʰ a̠ ɭ s͈ e̞ ɦ a̠ d a̠	탈쎄하다
탈영	tʰ a̠ ɾ j ʌ̹ ŋ	타령
탈영하다	tʰ a̠ ɾ j ʌ̹ ŋ ɦ a̠ d a̠	타령하다
탈조선	tʰ a̠ ʎ d͡ʑ o̞ sʰ ʌ̹ n	탈조선
탈주자	tʰ a̠ ʎ t͡ɕ͈ u d͡ʑ a̠	탈쭈자
탈출하다	tʰ a̠ ʎ t͡ɕʰ u ɾ ɦ a̠ d a̠	탈출하다
탈취제	tʰ a̠ ʎ t͡ɕʰ ɥ i d͡ʑ e̞	탈취제
탐	tʰ a̠ m	탐
탐관오리	tʰ a̠ m ɡ w a̠ n o̞ ɾ i	탐과노리
탐라국	tʰ a̠ m n a̠ ɡ u k̚	탐나국
탐조	tʰ a̠ m d͡ʑ o̞	탐조
탐험하다	tʰ a̠ m ɦ ʌ̹ m ɦ a̠ d a̠	탐험하다
탑	tʰ a̠ p̚	탑
탑쎄기	tʰ a̠ p s͈ e̞ ɡ i	탑쎄기
탑파	tʰ a̠ p̚ pʰ a̠	탑파
탓	tʰ a̠ t̚	탇
탕	tʰ a̠ː ŋ	탕
탕위안	tʰ a̠ ŋ ɥ i a̠ n	탕위안
탕자	tʰ a̠ː ŋ d͡ʑ a̠	탕자
터	tʰ ʌ̹	터
터럭	tʰ ʌ̹ ɾ ʌ̹ k̚	터럭
터부	tʰ ʌ̹ b u	터부
터부시되다	tʰ ʌ̹ b u ɕʰ i d w e̞ d a̠	터부시되다
터부시하다	tʰ ʌ̹ b u ɕʰ i ɦ a̠ d a̠	터부시하다
터븀	tʰ ʌ̹ b j u m	터븀
터울	tʰ ʌ̹ u ɭ	터울
턱	tʰ ʌ̹ k̚	턱
턱무없다	tʰ ʌ̹ ŋ m u ʌ̹ p̚ t͈ a̠	텅무업따
털	tʰ ʌ̹ ɭ	털
털부처꽃	tʰ ʌ̹ ɭ b u t͡ɕʰ ʌ̹ k͈ o̞ t̚	털부처꼳
털실	tʰ ʌ̹ ɭ ɕʰ i ɭ	털실
테	tʰ e̞	테
테구시갈파	tʰ e̞ ɡ u ɕʰ i ɡ a̠ ɭ pʰ a̠	테구시갈파
테네시	tʰ e̞ n e̞ ɕ͈ i	테네씨
테네신	tʰ e̞ n e̞ ɕʰ i n	테네신
테니시	tʰ e̞ n i ɕ͈ i	테니씨
테오도시우스	tʰ e̞ o̞ d o̞ ɕʰ i u sʰ ɯ	테오도시우스
테제	tʰ e̞ d͡ʑ e̞	테제
테크	tʰ e̞ k x ɯ	테크
텍사스	tʰ e̞ k s͈ a̠ s͈ ɯ	텍싸쓰
텐션	tʰ e̞ n ɕʰ ʌ̹ n	텐선
텔레비죤	tʰ e̞ ɭ ɭ e̞ b i d͡ʑ o̞ n	텔레비존
텔레타이프	tʰ e̞ ɭ ɭ e̞ tʰ a̠ i pʰ ɯ	텔레타이프
텔루륨	tʰ e̞ ɭ ɭ u ɾ j u m	텔루륨
텔펜	tʰ e̞ ɭ pʰ e̞ n	텔펜
토	tʰ o̞	토
토기	tʰ o̞ ɡ i	토기
토끼몰이	tʰ o̞ k͈ i m o̞ ɾ i	토끼모리
토끼박쥐	tʰ o̞ k͈ i b a̠ k̚ t͡ɕ͈ ɥ i	토끼박쮜
토너먼트	tʰ o̞ n ʌ̹ m ʌ̹ n tʰ ɯ	토너먼트
토록	tʰ o̞ ɾ o̞ k̚	토록
토론하다	tʰ o̞ː ɾ o̞ n ɦ a̠ d a̠	토론하다
토론회	tʰ o̞ː ɾ o̞ n β w e̞	토론회
토루	tʰ o̞ ɾ u	토루
토르텔로니	tʰ o̞ ɾ ɯ tʰ e̞ ɭ ɭ o̞ n i	토르텔로니
토르텔리니	tʰ o̞ ɾ ɯ tʰ e̞ ʎ ʎ i n i	토르텔리니
토막	tʰ o̞ m a̠ k̚	토막
토이기	tʰ o̞ i ɡ i	토이기
토이기어	tʰ o̞ i ɡ i ʌ̹	토이기어
토치카	tʰ o̞ t͡ɕʰ i kʰ a̠	토치카
토하다	tʰ o̞ː ɦ a̠ d a̠	토하다
토혈	tʰ o̞ː ʝ ʌ̹ ɭ	토헐
토후국	tʰ o̞ β u ɡ u k̚	토후국
톤	tʰ o̞ n	톤
톨	tʰ o̞ ɭ	톨
톱	tʰ o̞ p̚	톱
톱날꽃게	tʰ o̞ m n a̠ ɭ k͈ o̞ t̚ k͈ e̞	톰날꼳께
톱니바퀴	tʰ o̞ m n i b a̠ kʰ ɥ i	톰니바퀴
톳	tʰ o̞ t̚	톧
통	tʰ o̞ ŋ	통
통가리	tʰ o̞ ŋ ɡ a̠ ɾ i	통가리
통과암호	tʰ o̞ ŋ ɡ w a̠ a̠ m β o̞	통과암호
통닭	tʰ o̞ ŋ d a̠ k̚	통닥
통미봉남	tʰ o̞ ŋ m i b o̞ ŋ n a̠ m	통미봉남
통발	tʰ o̞ ŋ b a̠ ɭ	통발
통사리	tʰ o̞ ŋ sʰ a̠ ɾ i	통사리
통산	tʰ o̞ ŋ sʰ a̠ n	통산
통솔자	tʰ o̞ː ŋ sʰ o̞ ʎ t͡ɕ͈ a̠	통솔짜
통시적	tʰ o̞ ŋ ɕʰ i d͡ʑ ʌ̹ k̚	통시적
통신원	tʰ o̞ ŋ ɕʰ i n w ʌ̹ n	통시눤
통역	tʰ o̞ː ŋ j ʌ̹ k̚	통역
통역자	tʰ o̞ ŋ j ʌ̹ k̚ t͡ɕ͈ a̠	통역짜
통치	tʰ o̞ː ŋ t͡ɕʰ i	통치
통치자	tʰ o̞ː ŋ t͡ɕʰ i d͡ʑ a̠	통치자
통치하다	tʰ o̞ː ŋ t͡ɕʰ i ɦ a̠ d a̠	통치하다
퇴각	tʰ w e̞ː ɡ a̠ k̚	퇴각
퇴각하다	tʰ w e̞ː ɡ a̠ kʰ a̠ d a̠	퇴가카다
퇴근하다	tʰ w e̞ː ɡ ɯ n ɦ a̠ d a̠	퇴근하다
퇴끼	tʰ w e̞ k͈ i	퇴끼
툐상	tʰ j o sʰ a̠ ŋ	툐상
투	tʰ u	투
투구게	tʰ u ɡ u ɡ e̞	투구게
투기꾼	tʰ u ɡ i k͈ u n	투기꾼
투끼	tʰ u k͈ i	투끼
투르크멘어	tʰ u ɾ ɯ k x ɯ m e̞ n ʌ̹	투르크메너
투병	tʰ u b j ʌ̹ ŋ	투병
투사지	tʰ u sʰ a̠ d͡ʑ i	투사지
투숙하다	tʰ u sʰ u kʰ a̠ d a̠	투수카다
투아례	tʰ u a̠ ɾ j e̞	투아례
투영기	tʰ u j ʌ̹ ŋ ɡ i	투영기
투자되다	tʰ u d͡ʑ a̠ d w e̞ d a̠	투자되다
투자자	tʰ u d͡ʑ a̠ d͡ʑ a̠	투자자
투자하다	tʰ u d͡ʑ a̠ ɦ a̠ d a̠	투자하다
투포환	tʰ u pʰ o̞ β w a̠ n	투포환
투표용지	tʰ u pʰ j o j o ŋ d͡ʑ i	투표용지
투표율	tʰ u pʰ j o j u ɭ	투표율
투표하다	tʰ u pʰ j o ɦ a̠ d a̠	투표하다
투항하다	tʰ u ɦ a̠ ŋ ɦ a̠ d a̠	투항하다
툭툭이	tʰ u k̚ tʰ u ɡ i	툭투기
툴	tʰ u ɭ	툴
툴륨	tʰ u ʎ ʎ u m	툴룸
퉁	tʰ u ŋ	퉁
튀각	tʰ ɥ i ɡ a̠ k̚	튀각
튀르크	tʰ ɥ i ɾ ɯ k x ɯ	튀르크
튕기다	tʰ ɥ i ŋ ɡ i d a̠	튕기다
트란스니스트리아	tʰ ɯ ɾ a̠ n sʰ ɯ n i sʰ ɯ tʰ ɯ ɾ i a̠	트란스니스트리아
트레이닝	tʰ ɯ ɾ e̞ i n i ŋ	트레이닝
트력제	tʰ ɯ ɾ j ʌ̹ k̚ t͡ɕ͈ e̞	트력쩨
트롤	tʰ ɯ ɾ o̞ ɭ	트롤
트롤리버스	tʰ ɯ ɾ o̞ ʎ ʎ i b ʌ̹ sʰ ɯ	트롤리버스
트림하다	tʰ ɯː ɾ i m ɦ a̠ d a̠	트림하다
트위터	tʰ ɯ ɥ i tʰ ʌ̹	트위터
트젠	tʰ ɯ d͡ʑ e̞ n	트젠
특	tʰ ɯ k̚	특
특별시	tʰ ɯ k̚ p͈ j ʌ̹ ɭ ɕʰ i	특뼐시
특보	tʰ ɯ k̚ p͈ o̞	특뽀
특사	tʰ ɯ k s͈ a̠	특싸
특산물	tʰ ɯ k s͈ a̠ n m u ɭ	특싼물
특수하다	tʰ ɯ k s͈ u ɦ a̠ d a̠	특쑤하다
특이하다	tʰ ɯ ɡ i ɦ a̠ d a̠	트기하다
특질	tʰ ɯ k̚ t͡ɕ͈ i ɭ	특찔
특파원	tʰ ɯ k̚ pʰ a̠ w ʌ̹ n	특파원
튽	tʰ ɯ n	튼
틀	tʰ ɯ ɭ	틀
틀딱충	tʰ ɯ ɭ t͈ a̠ k̚ t͡ɕʰ u ŋ	틀딱충
틈	tʰ ɯ m	틈
티베리우스	tʰ i b e̞ ɾ i u sʰ ɯ	티베리우스
티베트어	tʰ i b e̞ tʰ ɯ ʌ̹	티베트어
티비	tʰ i b i	티비
티아진	tʰ i a̠ d͡ʑ i n	티아진
틴에이저	tʰ i n e̞ i d͡ʑ ʌ̹	티네이저
팀	tʰ i m	팀
팀부	tʰ i m b u	팀부
팀원	tʰ i m w ʌ̹ n	티뭔
팁	tʰ i p̚	팁
파	pʰ a̠	파
파견	pʰ a̠ ɡ j ʌ̹ n	파견
파괴하다	pʰ a̠ː ɡ w e̞ ɦ a̠ d a̠	파괴하다
파기	pʰ a̠ ɡ i	파기
파두츠	pʰ a̠ d u t͡ɕʰ ɯ	파두츠
파라다이스	pʰ a̠ ɾ a̠ d a̠ i sʰ ɯ	파라다이스
파라마리보	pʰ a̠ ɾ a̠ m a̠ ɾ i b o̞	파라마리보
파랑어치	pʰ a̠ ɾ a̠ ŋ ʌ̹ t͡ɕʰ i	파랑어치
파랗다	pʰ a̠ː ɾ a̠ tʰ a̠	파라타
파본	pʰ a̠ː b o̞ n	파본
파산하다	pʰ a̠ː sʰ a̠ n ɦ a̠ d a̠	파산하다
파스닙	pʰ a̠ sʰ ɯ n i p̚	파스닙
파슬파슬	pʰ a̠ sʰ ɯ ɭ pʰ a̠ sʰ ɯ ɭ	파슬파슬
파쑈적	pʰ a̠ ɕ͈ o d͡ʑ ʌ̹ k̚	파쑈적
파악하다	pʰ a̠ a̠ kʰ a̠ d a̠	파아카다
파이다	pʰ a̠ i d a̠	파이다
파이즈리	pʰ a̠ i d͡ʑ ɯ ɾ i	파이즈리
파이프라인	pʰ a̠ i pʰ ɯ ɾ a̠ i n	파이프라인
파일럿	pʰ a̠ i ɭ ɭ ʌ̹ t̚	파일럳
파전	pʰ a̠ d͡ʑ ʌ̹ n	파전
파충	pʰ a̠ t͡ɕʰ u ŋ	파충
파토	pʰ a̠ tʰ o̞	파토
파하다	pʰ a̠ː ɦ a̠ d a̠	파하다
판	pʰ a̠ n	판
판관기	pʰ a̠ n ɡ w a̠ n ɡ i	판관기
판단하다	pʰ a̠ n d a̠ n ɦ a̠ d a̠	판단하다
판정	pʰ a̠ ɲ d͡ʑ ʌ̹ ŋ	판정
판타지	pʰ a̠ n tʰ a̠ d͡ʑ i	판타지
팔	pʰ a̠ ɭ	팔
팔리다	pʰ a̠ ʎ ʎ i d a̠	팔리다
팔자	pʰ a̠ ʎ d͡ʑ a̠	팔자
팔촌	pʰ a̠ ʎ t͡ɕʰ o̞ n	팔촌
팜유	pʰ a̠ m j u	파뮤
팜쥐	pʰ a̠ m d͡ʑ ɥ i	팜쥐
팡구	pʰ a̠ ŋ ɡ u	팡구
팡이	pʰ a̠ ŋ i	팡이
팡이무리	pʰ a̠ ŋ i m u ɾ i	팡이무리
팡주	pʰ a̠ ŋ d͡ʑ u	팡주
팥	pʰ a̠ t̚	팓
팥꽃나무	pʰ a̠ t̚ k͈ o̞ n n a̠ m u	팓꼰나무
팥밥	pʰ a̠ t̚ p͈ a̠ p̚	팓빱
패	pʰ ɛː	패
패습	pʰ ɛː sʰ ɯ p̚	패습
패자	pʰ ɛː d͡ʑ a̠	패자
패전하다	pʰ ɛː d͡ʑ ʌ̹ n ɦ a̠ d a̠	패전하다
퍅	pʰ j a̠ k̚	퍅
퍼드덕	pʰ ʌ̹ d ɯ d ʌ̹ k̚	퍼드덕
퍼브	pʰ ʌ̹ b ɯ	퍼브
퍼서석	pʰ ʌ̹ sʰ ʌ̹ sʰ ʌ̹ k̚	퍼서석
퍼석	pʰ ʌ̹ sʰ ʌ̹ k̚	퍼석
퍼슬퍼슬	pʰ ʌ̹ sʰ ɯ ɭ pʰ ʌ̹ sʰ ɯ ɭ	퍼슬퍼슬
펑	pʰ ʌ̹ ŋ	펑
펑크	pʰ ʌ̹ ŋ k x ɯ	펑크
페나진	pʰ e̞ n a̠ d͡ʑ i n	페나진
페난트렌	pʰ e̞ n a̠ n tʰ ɯ ɾ e̞ n	페난트렌
페난트리딘	pʰ e̞ n a̠ n tʰ ɯ ɾ i d i n	페난트리딘
페더럴웨이	pʰ e̞ d ʌ̹ ɾ ʌ̹ ɾ w e̞ i	페더러뤠이
페럿	pʰ e̞ ɾ ʌ̹ t̚	페럳
페레스트로이카	pʰ e̞ ɾ e̞ sʰ ɯ tʰ ɯ ɾ o̞ i kʰ a̠	페레스트로이카
페르뮴	pʰ e̞ ɾ ɯ m j u m	페르뮴
페르세포네	pʰ e̞ ɾ ɯ sʰ e̞ pʰ o̞ n e̞	페르세포네
페미니스트	pʰ e̞ m i n i sʰ ɯ tʰ ɯ	페미니스트
페지	pʰ e̞ d͡ʑ i	페지
페치카	pʰ e̞ t͡ɕʰ i kʰ a̠	페치카
페투치네	pʰ e̞ tʰ u t͡ɕʰ i n e̞	페투치네
펜	pʰ e̞ n	펜
펜실베니아	pʰ e̞ n ɕʰ i ɭ b e̞ n i a̠	펜실베니아
펜실베이니아	pʰ e̞ n ɕʰ i ɭ b e̞ i n i a̠	펜실베이니아
펜싱	pʰ e̞ n ɕ͈ i ŋ	펜씽
펜치	pʰ e̞ ɲ t͡ɕʰ i	펜치
펜테인	pʰ e̞ n tʰ e̞ i n	펜테인
펜팔	pʰ e̞ n pʰ a̠ ɭ	펜팔
펠라티오	pʰ e̞ ɭ ɭ a̠ tʰ i o̞	펠라티오
펠메니	pʰ e̞ ɭ m e̞ n i	펠메니
편	pʰ j ʌ̹ n	편
편가르기	pʰ j ʌ̹ n ɡ a̠ ɾ ɯ ɡ i	편가르기
편도선	pʰ j ʌ̹ n d o̞ sʰ ʌ̹ n	편도선
편모	pʰ j ʌ̹ n m o̞	편모
편암	pʰ j ʌ̹ n a̠ m	펴남
편육	pʰ j ʌ̹ ɲ u k̚	펴눅
편작	pʰ j ʌ̹ ɲ d͡ʑ a̠ k̚	편작
편집기	pʰ j ʌ̹ ɲ d͡ʑ i p̚ k͈ i	편집끼
편집인	pʰ j ʌ̹ ɲ d͡ʑ i b i n	편지빈
편집장	pʰ j ʌ̹ ɲ d͡ʑ i p̚ t͡ɕ͈ a̠ ŋ	편집짱
편집하다	pʰ j ʌ̹ ɲ d͡ʑ i pʰ a̠ d a̠	편지파다
편취	pʰ j ʌ̹ ɲ t͡ɕʰ ɥ i	편취
편히	pʰ j ʌ̹ n ʝ i	편히
폄	pʰ j ʌ̹ m	폄
평결	pʰ j ʌ̹ ŋ ɡ j ʌ̹ ɭ	평결
평안도	pʰ j ʌ̹ ŋ a̠ n d o̞	평안도
평정하다	pʰ j ʌ̹ ŋ d͡ʑ ʌ̹ ŋ ɦ a̠ d a̠	평정하다
폐	pʰ j e̞ː	폐
폐막식	pʰ j e̞ː m a̠ k ɕ͈ i k̚	폐막씩
폐지되다	pʰ j e̞ː d͡ʑ i d w e̞ d a̠	폐지되다
폐포	pʰ j e̞ː pʰ o̞	폐포
폐품	pʰ j e̞ pʰ u m	폐품
폐허	pʰ j e̞ː ɦ ʌ̹	폐허
포	pʰ o̞	포
포가	pʰ o̞ ɡ a̠	포가
포고	pʰ o̞ ɡ o̞	포고
포그롬	pʰ o̞ ɡ ɯ ɾ o̞ m	포그롬
포기	pʰ o̞ ɡ i	포기
포도아	pʰ o̞ d o̞ a̠	포도아
포도탄	pʰ o̞ d o̞ tʰ a̠ n	포도탄
포르토노보	pʰ o̞ ɾ ɯ tʰ o̞ n o̞ b o̞	포르토노보
포르피린	pʰ o̞ ɾ ɯ pʰ i ɾ i n	포르피린
포르핀	pʰ o̞ ɾ ɯ pʰ i n	포르핀
포리	pʰ o̞ ɾ i	포리
포리지	pʰ o̞ ɾ i d͡ʑ i	포리지
포삭포삭	pʰ o̞ sʰ a̠ k̚ pʰ o̞ sʰ a̠ k̚	포삭포삭
포상	pʰ o̞ sʰ a̠ ŋ	포상
포상금	pʰ o̞ sʰ a̠ ŋ ɡ ɯ m	포상금
포악	pʰ o̞ː a̠ k̚	포악
포위	pʰ o̞ː ɥ i	포위
포장마차	pʰ o̞ d͡ʑ a̠ ŋ m a̠ t͡ɕʰ a̠	포장마차
포장지	pʰ o̞ d͡ʑ a̠ ŋ d͡ʑ i	포장지
포즈	pʰ o̞ d͡ʑ ɯ	포즈
포차	pʰ o̞ t͡ɕʰ a̠	포차
포켓몬	pʰ o̞ kʰ e̞ n m o̞ n	포켄몬
포켓몬스터	pʰ o̞ kʰ e̞ n m o̞ n sʰ ɯ tʰ ʌ̹	포켄몬스터
포트모르즈비	pʰ o̞ tʰ ɯ m o̞ ɾ ɯ d͡ʑ ɯ b i	포트모르즈비
포트오브스페인	pʰ o̞ tʰ ɯ o̞ b ɯ sʰ ɯ pʰ e̞ i n	포트오브스페인
포함되다	pʰ o̞ ɦ a̠ m d w e̞ d a̠	포함되다
포함하다	pʰ o̞ ɦ a̠ m ɦ a̠ d a̠	포함하다
포환던지기	pʰ o̞ β w a̠ n d ʌ̹ ɲ d͡ʑ i ɡ i	포환던지기
포획하다	pʰ o̞ː β w e̞ kʰ a̠ d a̠	포회카다
포희미아	pʰ o̞ ʝ i m i a̠	포히미아
폭	pʰ o̞ k̚	폭
폭도	pʰ o̞ k̚ t͈ o̞	폭또
폭발하다	pʰ o̞ k̚ pʰ a̠ ɾ ɦ a̠ d a̠	폭팔하다
폭소	pʰ o̞ k s͈ o̞	폭쏘
폭염	pʰ o̞ ɡ j ʌ̹ m	포겸
폭주	pʰ o̞ k̚ t͡ɕ͈ u	폭쭈
폭탄주	pʰ o̞ k̚ tʰ a̠ ɲ d͡ʑ u	폭탄주
폰	pʰ o̞ n	폰
폴란드어	pʰ o̞ ɭ ɭ a̠ n d ɯ ʌ̹	폴란드어
폴리네시아	pʰ o̞ ʎ ʎ i n e̞ ɕʰ i a̠	폴리네시아
퐁당퐁당	pʰ o̞ ŋ d a̠ ŋ pʰ o̞ ŋ d a̠ ŋ	퐁당퐁당
표	pʰ j o	표
표기하다	pʰ j o ɡ i ɦ a̠ d a̠	표기하다
표면장력	pʰ j o m j ʌ̹ ɲ d͡ʑ a̠ ŋ ɲ ʌ̹ k̚	표면장넉
표믕롬	pʰ j o m ɯ ŋ n o̞ m	표믕놈
표본	pʰ j o b o̞ n	표본
표식	pʰ j o ɕʰ i k̚	표식
표어문자	pʰ j o ʌ̹ m u ɲ d͡ʑ a̠	표어문자
표적	pʰ j o d͡ʑ ʌ̹ k̚	표적
표현되다	pʰ j o ʝ ʌ̹ n d w e̞ d a̠	표헌되다
표현형	pʰ j o ʝ ʌ̹ n ʝ ʌ̹ ŋ	표헌헝
푸나무	pʰ u n a̠ m u	푸나무
푸라면	pʰ u ɾ a̠ m j ʌ̹ n	푸라면
푸르디푸르다	pʰ u ɾ ɯ d i pʰ u ɾ ɯ d a̠	푸르디푸르다
푸서석	pʰ u sʰ ʌ̹ sʰ ʌ̹ k̚	푸서석
푸석푸석	pʰ u sʰ ʌ̹ k̚ pʰ u sʰ ʌ̹ k̚	푸석푸석
푸성귀	pʰ u sʰ ʌ̹ ŋ ɡ ɥ i	푸성귀
푸슬푸슬	pʰ u sʰ ɯ ɭ pʰ u sʰ ɯ ɭ	푸슬푸슬
푸실리	pʰ u ɕʰ i ʎ ʎ i	푸실리
푸주한	pʰ u d͡ʑ u ɦ a̠ n	푸주한
푸코	pʰ u kʰ o̞	푸코
푸틴	pʰ u tʰ i n	푸틴
푹	pʰ u k̚	푹
푼	pʰ uː n	푼
풀	pʰ u ɭ	풀
풀그림	pʰ u ɭ ɡ ɯ ɾ i m	풀그림
풀리다	pʰ u ʎ ʎ i d a̠	풀리다
풀망둑	pʰ u ɭ m a̠ ŋ d u k̚	풀망둑
풀명자	pʰ u ɭ m j ʌ̹ ŋ d͡ʑ a̠	풀명자
풀무	pʰ u ɭ m u	풀무
풀버전	pʰ u ɭ b ʌ̹ d͡ʑ ʌ̹ n	풀버전
풀어지다	pʰ u ɾ ʌ̹ d͡ʑ i d a̠	푸러지다
풀잎	pʰ u ʎ ʎ i p̚	풀립
풀파워	pʰ u ɭ pʰ a̠ w ʌ̹	풀파워
품	pʰ u m	품
품사	pʰ uː m sʰ a̠	품사
품절	pʰ uː m d͡ʑ ʌ̹ ɭ	품절
풋풋하다	pʰ u t̚ pʰ u tʰ a̠ d a̠	푿푸타다
풍	pʰ u ŋ	풍
풍금조	pʰ u ŋ ɡ ɯ m d͡ʑ o̞	풍금조
풍기다	pʰ u ŋ ɡ i d a̠	풍기다
풍령	pʰ u ŋ ɲ ʌ̹ ŋ	풍넝
풍문	pʰ u ŋ m u n	풍문
풍물놀이	pʰ u ŋ m u ɭ ɭ o̞ ɾ i	풍물로리
풍비박산	pʰ u ŋ b i b a̠ k s͈ a̠ n	풍비박싼
풍설	pʰ u ŋ sʰ ʌ̹ ɭ	풍설
풍화	pʰ u ŋ β w a̠	풍화
퓨란	pʰ j u ɾ a̠ n	퓨란
퓨린	pʰ j u ɾ i n	퓨린
프라세오디뮴	pʰ ɯ ɾ a̠ sʰ e̞ o̞ d i m j u m	프라세오디뮴
프락치	pʰ ɯ ɾ a̠ k̚ t͡ɕʰ i	프락치
프란치스코	pʰ ɯ ɾ a̠ ɲ t͡ɕʰ i sʰ ɯ kʰ o̞	프란치스코
프랑슘	pʰ ɯ ɾ a̠ ŋ ɕʰ u m	프랑숨
프랑스인	pʰ ɯ ɾ a̠ ŋ sʰ ɯ i n	프랑스인
프레더릭턴	pʰ ɯ ɾ e̞ d ʌ̹ ɾ i k̚ tʰ ʌ̹ n	프레더릭턴
프로그람	pʰ ɯ ɾ o̞ ɡ ɯ ɾ a̠ m	프로그람
프로듀서	pʰ ɯ ɾ o̞ d j u sʰ ʌ̹	프로듀서
프로메튬	pʰ ɯ ɾ o̞ m e̞ tʰ j u m	프로메튬
프로젝터	pʰ ɯ ɾ o̞ d͡ʑ e̞ k̚ tʰ ʌ̹	프로젝터
프로토콜	pʰ ɯ ɾ o̞ tʰ o̞ kʰ o̞ ɭ	프로토콜
프로페인	pʰ ɯ ɾ o̞ pʰ e̞ i n	프로페인
프롯	pʰ ɯ ɾ o̞ t̚	프롣
프리드리히	pʰ ɯ ɾ i d ɯ ɾ i ʝ i	프리드리히
프리슈티나	pʰ ɯ ɾ i ɕʰ u tʰ i n a̠	프리수티나
프리타운	pʰ ɯ ɾ i tʰ a̠ u n	프리타운
프사	pʰ ɯ sʰ a̠	프사
프탈레인	pʰ ɯ tʰ a̠ ɭ ɭ e̞ i n	프탈레인
프테리딘	pʰ ɯ tʰ e̞ ɾ i d i n	프테리딘
프테린	pʰ ɯ tʰ e̞ ɾ i n	프테린
플라스크	pʰ ɯ ɭ ɭ a̠ sʰ ɯ k x ɯ	플라스크
플라이어	pʰ ɯ ɭ ɭ a̠ i ʌ̹	플라이어
플레로븀	pʰ ɯ ɭ ɭ e̞ ɾ o̞ b j u m	플레로븀
플로리다	pʰ ɯ ɭ ɭ o̞ ɾ i d a̠	플로리다
플루오르	pʰ ɯ ɭ ɭ u o̞ ɾ ɯ	플루오르
플루오린	pʰ ɯ ɭ ɭ u o̞ ɾ i n	플루오린
피	pʰ i	피
피고석	pʰ iː ɡ o̞ sʰ ʌ̹ k̚	피고석
피곤	pʰ i ɡ o̞ n	피곤
피구	pʰ iː ɡ u	피구
피넨	pʰ i n e̞ n	피넨
피동사	pʰ iː d o̞ ŋ sʰ a̠	피동사
피라냐	pʰ i ɾ a̠ ɲ a̠	피라나
피라졸	pʰ i ɾ a̠ d͡ʑ o̞ ɭ	피라졸
피라진	pʰ i ɾ a̠ d͡ʑ i n	피라진
피뢰침	pʰ iː ɾ w e̞ t͡ɕʰ i m	피뢰침
피리다진	pʰ i ɾ i d a̠ d͡ʑ i n	피리다진
피리미딘	pʰ i ɾ i m i d i n	피리미딘
피말강이	pʰ i m a̠ ɭ ɡ a̠ ŋ i	피말강이
피부과	pʰ i b u k͈ w a̠	피부꽈
피센	pʰ i sʰ e̞ n	피센
피스톨	pʰ i sʰ ɯ tʰ o̞ ɭ	피스톨
피씨방	pʰ i ɕ͈ i b a̠ ŋ	피씨방
피안	pʰ iː a̠ n	피안
피알	pʰ i a̠ ɭ	피알
피어오르다	pʰ i ʌ̹ o̞ ɾ ɯ d a̠	피어오르다
피오르	pʰ i o̞ ɾ ɯ	피오르
피오르드	pʰ i o̞ ɾ ɯ d ɯ	피오르드
피읖	pʰ i ɯ p̚	피읍
피임하다	pʰ iː i m ɦ a̠ d a̠	피임하다
피장파장	pʰ i d͡ʑ a̠ ŋ pʰ a̠ d͡ʑ a̠ ŋ	피장파장
피차	pʰ iː t͡ɕʰ a̠	피차
피처폰	pʰ i t͡ɕʰ ʌ̹ pʰ o̞ n	피처폰
피카츄	pʰ i kʰ a̠ t͡ɕʰ u	피카추
피통	pʰ i tʰ o̞ ŋ	피통
피페라진	pʰ i pʰ e̞ ɾ a̠ d͡ʑ i n	피페라진
피폐	pʰ i pʰ j e̞	피폐
피폭	pʰ iː pʰ o̞ k̚	피폭
피하	pʰ i ɦ a̠	피하
피하조직	pʰ i ɦ a̠ d͡ʑ o̞ d͡ʑ i k̚	피하조직
픽	pʰ i k̚	픽
핀란드어	pʰ i ɭ ɭ a̠ n d ɯ ʌ̹	필란드어
핀지	pʰ iː ɲ d͡ʑ i	핀지
핀치	pʰ i ɲ t͡ɕʰ i	핀치
필	pʰ i ɭ	필
필경	pʰ i ɭ ɡ j ʌ̹ ŋ	필경
필담	pʰ i ɭ d a̠ m	필담
필리핀독수리	pʰ i ʎ ʎ i pʰ i n d o̞ k s͈ u ɾ i	필리핀독쑤리
필림	pʰ i ʎ ʎ i m	필림
필립	pʰ i ʎ ʎ i p̚	필립
필명	pʰ i ɭ m j ʌ̹ ŋ	필명
필사적	pʰ i ɭ sʰ a̠ d͡ʑ ʌ̹ k̚	필사적
필수품	pʰ i ɭ s͈ u pʰ u m	필쑤품
필업	pʰ i ɾ ʌ̹ p̚	피럽
필요악	pʰ i ɾ j o a̠ k̚	피료악
필적	pʰ i ʎ d͡ʑ ʌ̹ k̚	필적
필적학	pʰ i ʎ d͡ʑ ʌ̹ kʰ a̠ k̚	필저칵
핍	pʰ i p̚	핍
핏가루	pʰ i t̚ k͈ a̠ ɾ u	핃까루
핑	pʰ i ŋ	핑
핑크	pʰ i ŋ k x ɯ	핑크
하	h a̠ː	하
하굣길	h a̠ː ɡ j o t̚ k͈ i ɭ	하굗낄
하구	h a̠ ɡ u	하구
하급	h a̠ ɡ ɯ p̚	하급
하나회	h a̠ n a̠ β w e̞	하나회
하난	h a̠ n a̠ n	하난
하날	h a̠ n a̠ ɭ	하날
하늘길	h a̠ n ɯ ɭ k͈ i ɭ	하늘낄
하늬	h a̠ n i	하니
하데스	h a̠ d e̞ sʰ ɯ	하데스
하동지동	h a̠ d o̞ ŋ d͡ʑ i d o̞ ŋ	하동지동
하락시	h a̠ ɾ a̠ k ɕ͈ i	하락씨
하루아침	h a̠ ɾ u a̠ t͡ɕʰ i m	하루아침
하릅	h a̠ ɾ ɯ p̚	하릅
하면	h a̠ m j ʌ̹ n	하면
하물	h a̠ m u ɭ	하물
하반신	h a̠ː b a̠ n ɕʰ i n	하반신
하수구	h a̠ː sʰ u ɡ u	하수구
하숙	h a̠ː sʰ u k̚	하숙
하숙옥	h a̠ː sʰ u ɡ o̞ k̚	하수곡
하슘	h a̠ ɕʰ u m	하숨
하십시오체	h a̠ ɕʰ i p ɕ͈ i o̞ t͡ɕʰ e̞	하십씨오체
하오체	h a̠ o̞ t͡ɕʰ e̞	하오체
하와이	h a̠ w a̠ i	하와이
하이드라존	h a̠ i d ɯ ɾ a̠ d͡ʑ o̞ n	하이드라존
하이드록실아민	h a̠ i d ɯ ɾ o̞ k ɕ͈ i ɾ a̠ m i n	하이드록씨라민
하이퍼링크	h a̠ i pʰ ʌ̹ ɾ i ŋ k x ɯ	하이퍼링크
하이픈	h a̠ i pʰ ɯ n	하이픈
하임움직씨	h a̠ i m u m d͡ʑ i k ɕ͈ i	하이뭄직씨
하지	h a̠ d͡ʑ i	하지
하직하다	h a̠ː d͡ʑ i kʰ a̠ d a̠	하지카다
하청	h a̠ː t͡ɕʰ ʌ̹ ŋ	하청
하체	h a̠ː t͡ɕʰ e̞	하체
하품하다	h a̠ pʰ u m ɦ a̠ d a̠	하품하다
하프늄	h a̠ pʰ ɯ ɲ u m	하프눔
학	h a̠ k̚	학
학공치	h a̠ k̚ k͈ o̞ ŋ t͡ɕʰ i	학꽁치
학괴	h a̠ k̚ k͈ w e̞	학꾀
학구적	h a̠ k̚ k͈ u d͡ʑ ʌ̹ k̚	학꾸적
학습하다	h a̠ k s͈ ɯ pʰ a̠ d a̠	학쓰파다
한	h a̠ n	한
한가하다	h a̠ n ɡ a̠ ɦ a̠ d a̠	한가하다
한갓지다	h a̠ n ɡ a̠ t̚ t͡ɕ͈ i d a̠	한갇찌다
한강	h a̠ː n ɡ a̠ ŋ	한강
한국까치	h a̠ n ɡ u k̚ k͈ a̠ t͡ɕʰ i	한국까치
한글화	h a̠ː n ɡ ɯ ɾ β w a̠	한글화
한나라	h a̠ː n n a̠ ɾ a̠	한나라
한남	h a̠ː n n a̠ m	한남
한담하다	h a̠ n d a̠ m ɦ a̠ d a̠	한담하다
한데	h a̠ n d e̞	한데
한류	h a̠ ʎ ʎ u	할루
한밤중	h a̠ n b a̠ m t͡ɕ͈ u ŋ	한밤쭝
한본어	h a̠ː n b o̞ n ʌ̹	한보너
한숨짓다	h a̠ n sʰ u m d͡ʑ i t̚ t͈ a̠	한숨짇따
한쌍	h a̠ n s͈ a̠ ŋ	한쌍
한아바이	h a̠ n a̠ b a̠ i	하나바이
한열	h a̠ ɲ ʌ̹ ɭ	하널
한월어	h a̠ː n w ʌ̹ ɾ ʌ̹	하눠러
한인	h a̠ n i n	하닌
한인회	h a̠ː n i n β w e̞	하닌회
한정사	h a̠ ɲ d͡ʑ ʌ̹ ŋ sʰ a̠	한정사
한족법	h a̠ː ɲ d͡ʑ o̞ k̚ p͈ ʌ̹ p̚	한족뻡
한하다	h a̠ n ɦ a̠ d a̠	한하다
할	h a̠ ɭ	할
할라카	h a̠ ɭ ɭ a̠ kʰ a̠	할라카
할례쁘	h a̠ ʎ ʎ e̞ p͈ ɯ	할레쁘
할많하않	h a̠ ɭ m a̠ n ɦ a̠ a̠ n	할만하안
할멈	h a̠ ɭ m ʌ̹ m	할멈
할부	h a̠ ɭ b u	할부
할아버님	h a̠ ɾ a̠ b ʌ̹ n i m	하라버님
할인가	h a̠ ɾ i n k͈ a̠	하린까
핥다	h a̠ ɭ t͈ a̠	할따
함	h a̠ː m	함
함경도	h a̠ m ɡ j ʌ̹ ŋ d o̞	함경도
함락	h a̠ː m n a̠ k̚	함낙
함박웃음	h a̠ m b a̠ ɡ u sʰ ɯ m	함바구슴
함흥차사	h a̠ m ɣ ɯ ŋ t͡ɕʰ a̠ sʰ a̠	함흥차사
합	h a̠ p̚	합
합격하다	h a̠ p̚ k͈ j ʌ̹ kʰ a̠ d a̠	합껴카다
합당하다	h a̠ p̚ t͈ a̠ ŋ ɦ a̠ d a̠	합땅하다
합리주의	h a̠ m n i d͡ʑ u ɰ i	함니주의
합병	h a̠ p̚ p͈ j ʌ̹ ŋ	합뼝
합서	h a̠ p s͈ ʌ̹	합써
합선	h a̠ p s͈ ʌ̹ n	합썬
합성록음	h a̠ p s͈ ʌ̹ ŋ n o̞ ɡ ɯ m	합썽노금
합치다	h a̠ p̚ t͡ɕʰ i d a̠	합치다
핫아비	h a̠ sʰ a̠ b i	하사비
핫어미	h a̠ sʰ ʌ̹ m i	하서미
항	h a̠ː ŋ	항
항고	h a̠ː ŋ ɡ o̞	항고
항공역	h a̠ː ŋ ɡ o̞ ŋ j ʌ̹ k̚	항공역
항공우주	h a̠ ŋ ɡ o̞ ŋ u d͡ʑ u	항공우주
항독소	h a̠ː ŋ d o̞ k s͈ o̞	항독쏘
항라머리검독수리	h a̠ː ŋ n a̠ m ʌ̹ ɾ i ɡ ʌ̹ m d o̞ k s͈ u ɾ i	항나머리검독쑤리
항렬	h a̠ ŋ ɲ ʌ̹ ɭ	항널
항만	h a̠ː ŋ m a̠ n	항만
항소	h a̠ː ŋ sʰ o̞	항소
항암	h a̠ː ŋ a̠ m	항암
항역	h a̠ː ŋ j ʌ̹ k̚	항역
항원	h a̠ ŋ w ʌ̹ n	항원
해	h ɛː	해
해결하다	h ɛː ɡ j ʌ̹ ɾ ɦ a̠ d a̠	해결하다
해답	h ɛː d a̠ p̚	해답
해동	h ɛː d o̞ ŋ	해동
해동하다	h ɛː d o̞ ŋ ɦ a̠ d a̠	해동하다
해라체	h ɛː ɾ a̠ t͡ɕʰ e̞	해라체
해방하다	h ɛː b a̠ ŋ ɦ a̠ d a̠	해방하다
해부	h ɛː b u	해부
해석자	h ɛː sʰ ʌ̹ k̚ t͡ɕ͈ a̠	해석짜
해석학	h ɛː sʰ ʌ̹ kʰ a̠ k̚	해서칵
해설	h ɛː sʰ ʌ̹ ɭ	해설
해설하다	h ɛː sʰ ʌ̹ ɾ ɦ a̠ d a̠	해설하다
해성	h ɛː sʰ ʌ̹ ŋ	해성
해수욕	h ɛː sʰ u j o k̚	해수욕
해수욕장	h ɛː sʰ u j o k̚ t͡ɕ͈ a̠ ŋ	해수욕짱
해양학	h ɛː j a̠ ŋ ɦ a̠ k̚	해양학
해요체	h ɛː j o t͡ɕʰ e̞	해요체
해월	h ɛː w ʌ̹ ɭ	해월
해중	h ɛː d͡ʑ u ŋ	해중
해지다	h ɛː d͡ʑ i d a̠	해지다
해치다	h ɛː t͡ɕʰ i d a̠	해치다
해코지	h ɛː kʰ o̞ d͡ʑ i	해코지
해항	h ɛː ɦ a̠ ŋ	해항
행복감	h ɛː ŋ b o̞ k̚ k͈ a̠ m	행복깜
행여	h ɛː ŋ j ʌ̹	행여
허	h ʌ̹	허
허버허버	h ʌ̹ b ʌ̹ ɦ ʌ̹ b ʌ̹	허버허버
허벅지	h ʌ̹ b ʌ̹ k̚ t͡ɕ͈ i	허벅찌
허세	h ʌ̹ sʰ e̞	허세
허위	h ʌ̹ ɥ i	허위
허접스럽다	h ʌ̹ d͡ʑ ʌ̹ p s͈ ɯ ɾ ʌ̹ p̚ t͈ a̠	허접쓰럽따
허하다	h ʌ̹ ɦ a̠ d a̠	허하다
허혼	h ʌ̹ β o̞ n	허혼
헌	h ʌ̹ n	헌
헌장	h ʌ̹ ɲ d͡ʑ a̠ ŋ	헌장
헐	h ʌ̹ ɭ	헐
헐가	h ʌ̹ ɭ k͈ a̠	헐까
헐렁하다	h ʌ̹ ɭ ɭ ʌ̹ ŋ ɦ a̠ d a̠	헐렁하다
험	h ʌ̹ m	험
헛간	h ʌ̹ t̚ k͈ a̠ n	헏깐
헛기다리다	h ʌ̹ t̚ k͈ i d a̠ ɾ i d a̠	헏끼다리다
헛되다	h ʌ̹ t̚ t͈ w e̞ d a̠	헏뙤다
헛코골다	h ʌ̹ t̚ kʰ o̞ ɡ o̞ ɭ d a̠	헏코골다
헝가리어	h ʌ̹ ŋ ɡ a̠ ɾ i ʌ̹	헝가리어
헤기	h e̞ ɡ i	헤기
헤어드라이어	h e̞ ʌ̹ d ɯ ɾ a̠ i ʌ̹	헤어드라이어
헤이룽장	h e̞ i ɾ u ŋ d͡ʑ a̠ ŋ	헤이룽장
헤집다	h e̞ d͡ʑ i p̚ t͈ a̠	헤집따
헤프다	h e̞ː pʰ ɯ d a̠	헤프다
헥세인	h e̞ k s͈ e̞ i n	헥쎄인
헥토르	h e̞ k̚ tʰ o̞ ɾ ɯ	헥토르
헬	h e̞ ɭ	헬
헬레나	h e̞ ɭ ɭ e̞ n a̠	헬레나
헬린이	h e̞ ʎ ʎ i n i	헬리니
헬조선	h e̞ ʎ d͡ʑ o̞ sʰ ʌ̹ n	헬조선
헬창	h e̞ ʎ t͡ɕʰ a̠ ŋ	헬창
헷말	h e̞ n m a̠ ɭ	헨말
헹구다	h e̞ ŋ ɡ u d a̠	헹구다
호	ɸʷ o̞	호
호각	ɸʷ o̞ː ɡ a̠ k̚	호각
호격	ɸʷ o̞ k͈ j ʌ̹ k̚	호껵
호금	ɸʷ o̞ ɡ ɯ m	호금
호랑버들	ɸʷ o̞ ɾ a̠ ŋ b ʌ̹ d ɯ ɭ	호랑버들
호리다	ɸʷ o̞ ɾ i d a̠	호리다
호모포비아	ɸʷ o̞ m o̞ pʰ o̞ b i a̠	호모포비아
호박산	ɸʷ o̞ b a̠ k s͈ a̠ n	호박싼
호반	ɸʷ o̞ b a̠ n	호반
호버크라프트	ɸʷ o̞ b ʌ̹ k x ɯ ɾ a̠ pʰ ɯ tʰ ɯ	호버크라프트
호북	ɸʷ o̞ b u k̚	호북
호분자	ɸʷ o̞ b u ɲ d͡ʑ a̠	호분자
호불호	ɸʷ o̞ b u ɾ β o̞	호불호
호빵	ɸʷ o̞ p͈ a̠ ŋ	호빵
호선	ɸʷ o̞ sʰ ʌ̹ n	호선
호수	ɸʷ o̞ sʰ u	호수
호실	ɸʷ o̞ː ɕʰ i ɭ	호실
호의	ɸʷ o̞ː ɰ i	호의
호전되다	ɸʷ o̞ː d͡ʑ ʌ̹ n d w e̞ d a̠	호전되다
호전하다	ɸʷ o̞ː d͡ʑ ʌ̹ n ɦ a̠ d a̠	호전하다
호출기	ɸʷ o̞ t͡ɕʰ u ɭ ɡ i	호출기
호피	ɸʷ o̞ː pʰ i	호피
호환성	ɸʷ o̞ː β w a̠ n s͈ ʌ̹ ŋ	호환썽
호흡계통	ɸʷ o̞ ɣ ɯ p̚ k j e̞ː tʰ o̞ ŋ	호흡계통
혹가이도	ɸʷ o̞ k̚ k͈ a̠ i d o̞	혹까이도
혹고니	ɸʷ o̞ k̚ k͈ o̞ n i	혹꼬니
혹부리오리	ɸʷ o̞ k̚ p͈ u ɾ i o̞ ɾ i	혹뿌리오리
혹자	ɸʷ o̞ k̚ t͡ɕ͈ a̠	혹짜
혼	ɸʷ o̞ n	혼
혼나다	ɸʷ o̞ n n a̠ d a̠	혼나다
혼돈하다	ɸʷ o̞ː n d o̞ n ɦ a̠ d a̠	혼돈하다
혼란스럽다	ɸʷ o̞ː ɭ ɭ a̠ n sʰ ɯ ɾ ʌ̹ p̚ t͈ a̠	홀란스럽따
혼미	ɸʷ o̞ n m i	혼미
혼밥	ɸʷ o̞ n b a̠ p̚	혼밥
혼사	ɸʷ o̞ n sʰ a̠	혼사
혼술	ɸʷ o̞ n sʰ u ɭ	혼술
혼잡하다	ɸʷ o̞ ɲ d͡ʑ a̠ pʰ a̠ d a̠	혼자파다
홀	ɸʷ o̞ ɭ	홀
홀리다	ɸʷ o̞ ʎ ʎ i d a̠	홀리다
홀뮴	ɸʷ o̞ ɭ m j u m	홀뮴
홀소리	ɸʷ o̞ ɭ s͈ o̞ ɾ i	홀쏘리
홀스터	ɸʷ o̞ ɭ sʰ ɯ tʰ ʌ̹	홀스터
홀씨	ɸʷ o̞ ɭ ɕ͈ i	홀씨
홈	ɸʷ o̞ m	홈
홈런	ɸʷ o̞ m n ʌ̹ n	홈넌
홍	ɸʷ o̞ ŋ	홍
홍게	ɸʷ o̞ ŋ ɡ e̞	홍게
홍발정	ɸʷ o̞ ŋ b a̠ ʎ t͡ɕ͈ ʌ̹ ŋ	홍발쩡
홍살문	ɸʷ o̞ ŋ sʰ a̠ ɭ m u n	홍살문
홍위병	ɸʷ o̞ ŋ ɥ i b j ʌ̹ ŋ	홍위병
홍진	ɸʷ o̞ ŋ d͡ʑ i n	홍진
홍학	ɸʷ o̞ ŋ ɦ a̠ k̚	홍학
홑	ɸʷ o̞ t̚	혿
홑이불	ɸʷ o̞ n n i b u ɭ	혼니불
화	ɸ w a̠	화
화나다	ɸ w a̠ː n a̠ d a̠	화나다
화두	ɸ w a̠ d u	화두
화려	ɸ w a̠ ɾ j ʌ̹	화려
화룡점정	ɸ w a̠ː ɾ j o ŋ d͡ʑ ʌ̹ m d͡ʑ ʌ̹ ŋ	화룡점정
화법	ɸ w a̠ p͈ ʌ̹ p̚	화뻡
화병	ɸ w a̠ b j ʌ̹ ŋ	화병
화사	ɸ w a̠ sʰ a̠	화사
화산	ɸ w a̠ː sʰ a̠ n	화산
화성돈	ɸ w a̠ sʰ ʌ̹ ŋ d o̞ n	화성돈
화식	ɸ w a̠ː ɕʰ i k̚	화식
화염	ɸ w a̠ː j ʌ̹ m	화염
화이트	ɸ w a̠ i tʰ ɯ	화이트
화이트호스	ɸ w a̠ i tʰ ɯ β o̞ s͈ ɯ	화이트호쓰
화자	ɸ w a̠ d͡ʑ a̠	화자
화장	ɸ w a̠ d͡ʑ a̠ ŋ	화장
화제한어	ɸ w a̠ d͡ʑ e̞ ɦ a̠ n ʌ̹	화제하너
화질	ɸ w a̠ː d͡ʑ i ɭ	화질
화타	ɸ w a̠ tʰ a̠	화타
화평	ɸ w a̠ pʰ j ʌ̹ ŋ	화평
화폐학	ɸ w a̠ː pʰ j e̞ ɦ a̠ k̚	화폐학
화학전달물질	ɸ w a̠ː ɦ a̠ k̚ t͡ɕ ʌ̹ n d a̠ ɭ m u ʎ t͡ɕ͈ i ɭ	화학전달물찔
확	ɸ w a̠ k̚	확
확고하다	ɸ w a̠ k̚ k͈ o̞ ɦ a̠ d a̠	확꼬하다
확신하다	ɸ w a̠ k ɕ͈ i n ɦ a̠ d a̠	확씬하다
확약	ɸ w a̠ ɡ j a̠ k̚	화갹
확인되다	ɸ w a̠ ɡ i n d w e̞ d a̠	화긴되다
확정하다	ɸ w a̠ k̚ t͡ɕ͈ ʌ̹ ŋ ɦ a̠ d a̠	확쩡하다
확증편향	ɸ w a̠ k̚ t͡ɕ͈ ɯ ŋ pʰ j ʌ̹ n ʝ a̠ ŋ	확쯩편항
확진자	ɸ w a̠ k̚ t͡ɕ͈ i ɲ d͡ʑ a̠	확찐자
환도	ɸ w a̠ n d o̞	환도
환도상어	ɸ w a̠ n d o̞ sʰ a̠ ŋ ʌ̹	환도상어
환락	ɸ w a̠ ɭ ɭ a̠ k̚	활락
환불금	ɸ w a̠ n b u ɭ ɡ ɯ m	환불금
환불하다	ɸ w a̠ n b u ɾ ɦ a̠ d a̠	환불하다
환송하다	ɸ w a̠ n sʰ o̞ ŋ ɦ a̠ d a̠	환송하다
환약	ɸ w a̠ ɲ a̠ k̚	화낙
환영	ɸ w a̠ ɲ ʌ̹ ŋ	화넝
환영하다	ɸ w a̠ ɲ ʌ̹ ŋ ɦ a̠ d a̠	화넝하다
활	ɸ w a̠ ɭ	활
활력	ɸ w a̠ ʎ ʎ ʌ̹ k̚	활럭
활석	ɸ w a̠ ɭ sʰ ʌ̹ k̚	활석
활시위	ɸ w a̠ ɭ ɕ͈ i ɥ i	활씨위
활엽수	ɸ w a̠ ɾ j ʌ̹ p s͈ u	화렵쑤
활활	ɸ w a̠ ɾ β w a̠ ɭ	활활
황	ɸ w a̠ ŋ	황
황당	ɸ w a̠ ŋ d a̠ ŋ	황당
황당무계	ɸ w a̠ ŋ d a̠ ŋ m u ɡ j e̞	황당무계
황당무계하다	ɸ w a̠ ŋ d a̠ ŋ m u ɡ j e̞ ɦ a̠ d a̠	황당무계하다
황당하다	ɸ w a̠ ŋ d a̠ ŋ ɦ a̠ d a̠	황당하다
황련	ɸ w a̠ ŋ ɲ ʌ̹ n	황넌
황마	ɸ w a̠ ŋ m a̠	황마
황오리	ɸ w a̠ ŋ o̞ ɾ i	황오리
황옥	ɸ w a̠ ŋ o̞ k̚	황옥
황자	ɸ w a̠ ŋ d͡ʑ a̠	황자
황족	ɸ w a̠ ŋ d͡ʑ o̞ k̚	황족
황줄망둑	ɸ w a̠ ŋ d͡ʑ u ɭ m a̠ ŋ d u k̚	황줄망둑
황학루	ɸ w a̠ ŋ ɦ a̠ ŋ n u	황항누
회	ɸ w e̞	회
회계원	ɸ w e̞ː ɡ j e̞ w ʌ̹ n	회계원
회교도	ɸ w e̞ ɡ j o d o̞	회교도
회나무	ɸ w e̞ n a̠ m u	회나무
회남자	ɸ w e̞ n a̠ m d͡ʑ a̠	회남자
회뢰	ɸ w e̞ː ɾ w e̞	회뢰
회의	ɸ w e̞ ɰ i	회의
회의록	ɸ w e̞ː ɰ i ɾ o̞ k̚	회의록
회의하다	ɸ w e̞ ɰ i ɦ a̠ d a̠	회의하다
회자	ɸ w e̞ː d͡ʑ a̠	회자
회족	ɸ w e̞ː d͡ʑ o̞ k̚	회족
획	ɸ w e̞ k̚	획
획득하다	ɸ w e̞ k̚ t͈ ɯ kʰ a̠ d a̠	획뜨카다
획수	ɸ w e̞ k s͈ u	획쑤
획순	ɸ w e̞ k s͈ u n	획쑨
횡	ɸ w e̞ ŋ	횡
횡령하다	ɸ w e̞ ŋ ɲ ʌ̹ ŋ ɦ a̠ d a̠	횡넝하다
횡목	ɸ w e̞ ŋ m o̞ k̚	횡목
횡성	ɸ w e̞ ŋ sʰ ʌ̹ ŋ	횡성
후	ɸʷ uː	후
후과	ɸʷ u ɡ w a̠	후과
후다	ɸʷ u d a̠	후다
후략	ɸʷ uː ɾ j a̠ k̚	후략
후루룩	ɸʷ u ɾ u ɾ u k̚	후루룩
후문	ɸʷ uː m u n	후문
후방주의	ɸʷ uː b a̠ ŋ t͡ɕ uː ɰ i	후방주의
후사	ɸʷ uː sʰ a̠	후사
후세	ɸʷ uː sʰ e̞	후세
후연	ɸʷ u j ʌ̹ n	후연
후자	ɸʷ uː d͡ʑ a̠	후자
후줄근하다	ɸʷ u d͡ʑ u ɭ ɡ ɯ n ɦ a̠ d a̠	후줄근하다
후퇴	ɸʷ uː tʰ w e̞	후퇴
후퇴하다	ɸʷ uː tʰ w e̞ ɦ a̠ d a̠	후퇴하다
후회하다	ɸʷ uː β w e̞ ɦ a̠ d a̠	후회하다
훈	ɸʷ uː n	훈
훈가자	ɸʷ uː n ɡ a̠ d͡ʑ a̠	훈가자
훈몽자회	ɸʷ uː n m o̞ ŋ d͡ʑ a̠ β w e̞	훈몽자회
훈연	ɸʷ u ɲ ʌ̹ n	후넌
훈춘	ɸʷ u ɲ t͡ɕʰ u n	훈춘
훈훈하다	ɸʷ u n β u n ɦ a̠ d a̠	훈훈하다
훌	ɸʷ u ɭ	훌
훌륭하다	ɸʷ u ʎ ʎ o ŋ ɦ a̠ d a̠	훌룡하다
훌리건	ɸʷ u ʎ ʎ i ɡ ʌ̹ n	훌리건
훑다	ɸʷ u ɭ t͈ a̠	훌따
훑어읽다	ɸʷ u ɭ tʰ ʌ̹ i k̚ t͈ a̠	훌터익따
훔침	ɸʷ u m t͡ɕʰ i m	훔침
훙	ɸʷ u ŋ	훙
훤	ɸ w ʌ̹ n	훤
훼드럴웨이	ɸ w e̞ d ɯ ɾ ʌ̹ ɾ w e̞ i	훼드러뤠이
훼손	ɸ w e̞ː sʰ o̞ n	훼손
휘다	h ɥ i d a̠	휘다
휘두르다	h ɥ i d u ɾ ɯ d a̠	휘두르다
휘발유	h ɥ i b a̠ ɾ j u	휘바류
흐느적거리다	x ɯ n ɯ d͡ʑ ʌ̹ k̚ k͈ ʌ̹ ɾ i d a̠	흐느적꺼리다
흐려지다	x ɯ ɾ j ʌ̹ d͡ʑ i d a̠	흐려지다
흐르바쯔까	x ɯ ɾ ɯ b a̠ t͡ɕ͈ ɯ k͈ a̠	흐르바쯔까
흐트러트리다	x ɯ tʰ ɯ ɾ ʌ̹ tʰ ɯ ɾ i d a̠	흐트러트리다
흑	x ɯ k̚	흑
흑고니	x ɯ k̚ k͈ o̞ n i	흑꼬니
흑기러기	x ɯ k̚ k͈ i ɾ ʌ̹ ɡ i	흑끼러기
흑기사	x ɯ k̚ k͈ i sʰ a̠	흑끼사
흑룡강	x ɯ ŋ ɲ o ŋ ɡ a̠ ŋ	흥뇽강
흑비둘기	x ɯ k̚ p͈ i d u ɭ ɡ i	흑삐둘기
흑사병	x ɯ k s͈ a̠ p͈ j ʌ̹ ŋ	흑싸뼝
흑업	x ɯ ɡ ʌ̹ p̚	흐겁
흑역사	x ɯ ɡ j ʌ̹ k s͈ a̠	흐격싸
흑우	x ɯ ɡ u	흐구
흔	x ɯ n	흔
흘러나오다	x ɯ ɭ ɭ ʌ̹ n a̠ o̞ d a̠	흘러나오다
흘림	x ɯ ʎ ʎ i m	흘림
흙	x ɯ k̚	흑
흙밥	x ɯ k̚ p͈ a̠ p̚	흑빱
흠	x ɯ m	흠
흠잡다	x ɯː m d͡ʑ a̠ p̚ t͈ a̠	흠잡따
흡	x ɯ p̚	흡
흡수	x ɯ p s͈ u	흡쑤
흡수하다	x ɯ p s͈ u ɦ a̠ d a̠	흡쑤하다
흡연하다	x ɯ b j ʌ̹ n ɦ a̠ d a̠	흐변하다
흡혈	x ɯ pʰ j ʌ̹ ɭ	흐펼
흡혈동물	x ɯ pʰ j ʌ̹ ɭ d o̞ ŋ m u ɭ	흐펼동물
흥	x ɯ ŋ	흥
흥겹다	x ɯː ŋ ɡ j ʌ̹ p̚ t͈ a̠	흥겹따
흥륭	x ɯ ŋ ɲ u ŋ	흥눙
흩날다	x ɯ n n a̠ ɭ d a̠	흔날다
흩날리다	x ɯ n n a̠ ʎ ʎ i d a̠	흔날리다
