ᆯ지	ʎ t͡ɕ͈ i	ㄹ찌
ㄱㄴㄷ순	k a̠ n a̠ d a̠ sʰ u n	가나다순
ㄴㄴ	n o̞ n o̞	노노
ㅋㅋㅋ	k x ɯ k x ɯ k x ɯ	ㄱ흑흑흐
가가린	k a̠ ɡ a̠ ɾ i n	가가린
가감	k a̠ ɡ a̠ m	가감
가게	k a̠ː ɡ e̞	가게
가격	k a̠ ɡ j ʌ̹ k̚	가격
가계	k a̠ ɡ j e̞	가계
가공품	k a̠ ɡ o̞ ŋ pʰ u m	가공품
가구	k a̠ ɡ u	가구
가깝다	k a̠ k͈ a̠ p̚ t͈ a̠	가깝따
가끔	k a̠ k͈ ɯ m	가끔
가끔씩	k a̠ k͈ ɯ m ɕ͈ i k̚	가끔씩
가나	k a̠ n a̠	가나
가난하다	k a̠ n a̠ n ɦ a̠ d a̠	가난하다
가는쥐	k a̠ n ɯ ɲ d͡ʑ ɥ i	가는쥐
가늘다	k a̠ n ɯ ɭ d a̠	가늘다
가늠	k a̠ n ɯ m	가늠
가늠하다	k a̠ n ɯ m ɦ a̠ d a̠	가늠하다
가능성	k a̠ː n ɯ ŋ s͈ ʌ̹ ŋ	가능썽
가능하다	k a̠ː n ɯ ŋ ɦ a̠ d a̠	가능하다
가독성	k a̠ d o̞ k s͈ ʌ̹ ŋ	가독썽
가동	k a̠ d o̞ ŋ	가동
가두리	k a̠ː d u ɾ i	가두리
가드	k a̠ d ɯ	가드
가득	k a̠ d ɯ k̚	가득
가득가득	k a̠ d ɯ k̚ k͈ a̠ d ɯ k̚	가득까득
가득하다	k a̠ d ɯ kʰ a̠ d a̠	가드카다
가따까나	k a̠ t͈ a̠ k͈ a̠ n a̠	가따까나
가라데	k a̠ ɾ a̠ d e̞	가라데
가라오케	k a̠ ɾ a̠ o̞ kʰ e̞	가라오케
가랑비	k a̠ ɾ a̠ ŋ b i	가랑비
가령	k a̠ː ɾ j ʌ̹ ŋ	가령
가로	k a̠ ɾ o̞	가로
가로다	k a̠ ɾ o̞ d a̠	가로다
가로등	k a̠ ɾ o̞ d ɯ ŋ	가로등
가루	k a̠ ɾ u	가루
가르치다	k a̠ ɾ ɯ t͡ɕʰ i d a̠	가르치다
가르침	k a̠ ɾ ɯ t͡ɕʰ i m	가르침
가리다	k a̠ ɾ i d a̠	가리다
가리비	k a̠ ɾ i b i	가리비
가마솥	k a̠ m a̠ sʰ o̞ t̚	가마솓
가마우지	k a̠ m a̠ u d͡ʑ i	가마우지
가만	k a̠ m a̠ n	가만
가만가만	k a̠ m a̠ n ɡ a̠ m a̠ n	가만가만
가만두다	k a̠ m a̠ n d u d a̠	가만두다
가만히	k a̠ m a̠ n ʝ i	가만히
가맣다	k a̠ː m a̠ tʰ a̠	가마타
가면	k a̠ː m j ʌ̹ n	가면
가면극	k a̠ː m j ʌ̹ n ɡ ɯ k̚	가면극
가명	k a̠ː m j ʌ̹ ŋ	가명
가무	k a̠ m u	가무
가무이야기	k a̠ m u i j a̠ ɡ i	가무이야기
가문	k a̠ m u n	가문
가물가물	k a̠ m u ɭ ɡ a̠ m u ɭ	가물가물
가물치	k a̠ m u ʎ t͡ɕʰ i	가물치
가뭄	k a̠ m u m	가뭄
가방	k a̠ b a̠ ŋ	가방
가보	k a̠ b o̞	가보
가봉	k a̠ b o̞ ŋ	가봉
가부좌	k a̠ b u d͡ʑ w a̠	가부좌
가브리엘	k a̠ b ɯ ɾ i e̞ ɭ	가브리엘
가사	k a̠ sʰ a̠	가사
가산	k a̠ sʰ a̠ n	가산
가세	k a̠ sʰ e̞	가세
가숭어	k a̠ː sʰ u ŋ ʌ̹	가수어
가스	k͈ a̠ sʰ ɯ	까스
가시	k a̠ ɕʰ i	가시
가시고기	k a̠ ɕʰ i ɡ o̞ ɡ i	가시고기
가시나	k a̠ ɕʰ i n a̠	가시나
가시나무	k a̠ ɕʰ i n a̠ m u	가시나무
가시다	k a̠ ɕʰ i d a̠	가시다
가시아버지	k a̠ ɕʰ i a̠ b ʌ̹ d͡ʑ i	가시아버지
가시화	k a̠ ɕʰ i β w a̠	가시화
가식	k a̠ː ɕʰ i k̚	가식
가야금	k a̠ j a̠ ɡ ɯ m	가야금
가엾다	k a̠ː j ʌ̹ p̚ t͈ a̠	가엽따
가운데	k a̠ u n d e̞	가운데
가운데소리	k a̠ u n d e̞ sʰ o̞ ɾ i	가운데소리
가위	k a̠ ɥ i	가위
가위바위보	k a̠ ɥ i b a̠ ɥ i b o̞	가위바위보
가을	k a̠ ɯ ɭ	가을
가을철	k a̠ ɯ ʎ t͡ɕʰ ʌ̹ ɭ	가을철
가이드	k a̠ i d ɯ	가이드
가자	k a̠ d͡ʑ a̠	가자
가장자리	k a̠ː d͡ʑ a̠ ŋ d͡ʑ a̠ ɾ i	가장자리
가정법	k a̠ː d͡ʑ ʌ̹ ŋ p͈ ʌ̹ p̚	가정뻡
가제	k a̠ d͡ʑ e̞	가제
가제따	k a̠ d͡ʑ e̞ t͈ a̠	가제따
가젤	k a̠ d͡ʑ e̞ ɭ	가젤
가져가다	k a̠ d͡ʑ ʌ̹ ɡ a̠ d a̠	가저가다
가져오다	k a̠ d͡ʑ ʌ̹ o̞ d a̠	가저오다
가지	k a̠ d͡ʑ i	가지
가지고	k a̠ d͡ʑ i ɡ o̞	가지고
가지다	k a̠ d͡ʑ i d a̠	가지다
가지뿔	k a̠ d͡ʑ i p͈ u ɭ	가지뿔
가차	k a̠ t͡ɕʰ a̠	가차
가축	k a̠ t͡ɕʰ u k̚	가축
가톨릭	k a̠ tʰ o̞ ʎ ʎ i k̚	가톨릭
가톨릭교회	k a̠ tʰ o̞ ʎ ʎ i k̚ k͈ j o β w e̞	가톨릭꾜회
가파르다	k a̠ pʰ a̠ ɾ ɯ d a̠	가파르다
가히	k a̠ː ʝ i	가히
각국	k a̠ k̚ k͈ u k̚	각꾹
각기	k a̠ k̚ k͈ i	각끼
각다귀	k a̠ k̚ t͈ a̠ ɡ ɥ i	각따귀
각도	k a̠ k̚ t͈ o̞	각또
각막	k a̠ ŋ m a̠ k̚	강막
각본	k a̠ k̚ p͈ o̞ n	각뽄
각선미	k a̠ k s͈ ʌ̹ n m i	각썬미
각설	k a̠ k s͈ ʌ̹ ɭ	각썰
각시	k a̠ k ɕ͈ i	각씨
각자	k a̠ k̚ t͡ɕ͈ a̠	각짜
각종	k a̠ k̚ t͡ɕ͈ o̞ ŋ	각쫑
각하	k a̠ kʰ a̠	가카
간간이	k a̠ n ɡ a̠ n i	간가니
간극	k a̠ n ɡ ɯ k̚	간극
간단히	k a̠ n d a̠ n ʝ i	간단히
간드리	k a̠ n d ɯ ɾ i	간드리
간부	k a̠ n b u	간부
간사	k a̠ n sʰ a̠	간사
간사하다	k a̠ n sʰ a̠ ɦ a̠ d a̠	간사하다
간선도로	k a̠ n sʰ ʌ̹ n d o̞ ɾ o̞	간선도로
간성	k a̠ n sʰ ʌ̹ ŋ	간성
간식	k a̠ː n ɕʰ i k̚	간식
간악하다	k a̠ n a̠ kʰ a̠ d a̠	가나카다
간유	k a̠ː ɲ j u	가뉴
간음	k a̠ː n ɯ m	가늠
간절	k a̠ ɲ d͡ʑ ʌ̹ ɭ	간절
간접	k a̠ː ɲ d͡ʑ ʌ̹ p̚	간접
간주	k a̠ː ɲ d͡ʑ u	간주
간지	k a̠ ɲ d͡ʑ i	간지
간지럼	k a̠ ɲ d͡ʑ i ɾ ʌ̹ m	간지럼
간질	k a̠ː ɲ d͡ʑ i ɭ	간질
간질거리다	k a̠ ɲ d͡ʑ i ɭ ɡ ʌ̹ ɾ i d a̠	간질거리다
간질이다	k a̠ ɲ d͡ʑ i ɾ i d a̠	간지리다
간첩	k a̠ː ɲ t͡ɕʰ ʌ̹ p̚	간첩
간체	k a̠ ɲ t͡ɕʰ e̞	간체
간통	k a̠ː n tʰ o̞ ŋ	간통
간판	k a̠ n pʰ a̠ n	간판
간편하다	k a̠ n pʰ j ʌ̹ n ɦ a̠ d a̠	간편하다
간헐천	k a̠ː n ɦ ʌ̹ ʎ t͡ɕʰ ʌ̹ n	간헐천
간호사	k a̠ n β o̞ sʰ a̠	간호사
간혹	k a̠ː n β o̞ k̚	간혹
갈고	k a̠ ɭ ɡ o̞	갈고
갈기	k a̠ː ɭ ɡ i	갈기
갈등	k a̠ ɭ t͈ ɯ ŋ	갈뜽
갈륨	k a̠ ʎ ʎ j u m	갈륨
갈리시아	k a̠ ʎ ʎ i ɕʰ i a̠	갈리시아
갈림길	k a̠ ʎ ʎ i m k͈ i ɭ	갈림낄
갈망	k a̠ ɭ m a̠ ŋ	갈망
갈망하다	k a̠ ɭ m a̠ ŋ ɦ a̠ d a̠	갈망하다
갈비	k a̠ ɭ b i	갈비
갈비뼈	k a̠ ɭ b i p͈ j ʌ̹	갈비뼈
갈비탕	k a̠ ɭ b i tʰ a̠ ŋ	갈비탕
갈수록	k a̠ ɭ s͈ u ɾ o̞ k̚	갈쑤록
갈아타다	k a̠ ɾ a̠ tʰ a̠ d a̠	가라타다
갈증	k a̠ ʎ t͡ɕ͈ ɯ ŋ	갈쯩
갉다	k a̠ k̚ t͈ a̠	각따
감각	k a̠ː m ɡ a̠ k̚	감각
감각적	k a̠ m ɡ a̠ k̚ t͡ɕ͈ ʌ̹ k̚	감각쩍
감금	k a̠ m ɡ ɯ m	감금
감기	k a̠ː m ɡ i	감기
감당	k a̠ m d a̠ ŋ	감당
감당하다	k a̠ m d a̠ ŋ ɦ a̠ d a̠	감당하다
감동	k a̠ː m d o̞ ŋ	감동
감리교	k a̠ m n i ɡ j o	감니교
감마	k a̠ m m a̠	감마
감명	k a̠ m m j ʌ̹ ŋ	감명
감미료	k a̠ m m i ɾ j o	감미료
감방	k a̠ m b a̠ ŋ	감방
감사하다	k a̠ː m sʰ a̠ ɦ a̠ d a̠	감사하다
감상	k a̠ m sʰ a̠ ŋ	감상
감소	k a̠ː m sʰ o̞	감소
감수하다	k a̠ː m sʰ u ɦ a̠ d a̠	감수하다
감시	k a̠ m ɕʰ i	감시
감시하다	k a̠ m ɕʰ i ɦ a̠ d a̠	감시하다
감안	k a̠ m a̠ n	가만
감염	k a̠ː m j ʌ̹ m	가몀
감옥	k a̠ m o̞ k̚	가목
감자튀김	k a̠ m d͡ʑ a̠ tʰ ɥ i ɡ i m	감자튀김
감전	k a̠ː m d͡ʑ ʌ̹ n	감전
감정	k a̠ː m d͡ʑ ʌ̹ ŋ	감정
감초	k a̠ m t͡ɕʰ o̞	감초
감탄	k a̠ː m tʰ a̠ n	감탄
갑분싸	k a̠ p̚ p͈ u n s͈ a̠	갑뿐싸
갑자기	k a̠ p̚ t͡ɕ͈ a̠ ɡ i	갑짜기
갑작스레	k a̠ p̚ t͡ɕ͈ a̠ k s͈ ɯ ɾ e̞	갑짝쓰레
갑충	k a̠ p̚ t͡ɕʰ u ŋ	갑충
갑판	k a̠ p̚ pʰ a̠ n	갑판
강가	k a̠ ŋ k͈ a̠	강까
강간	k a̠ː ŋ ɡ a̠ n	강간
강간하다	k a̠ː ŋ ɡ a̠ n ɦ a̠ d a̠	강간하다
강경	k a̠ ŋ ɡ j ʌ̹ ŋ	강경
강국	k a̠ ŋ ɡ u k̚	강국
강당	k a̠ː ŋ d a̠ ŋ	강당
강력	k a̠ ŋ ɲ j ʌ̹ k̚	강녁
강력하다	k a̠ ŋ ɲ j ʌ̹ kʰ a̠ d a̠	강녀카다
강렬하다	k a̠ ŋ ɲ j ʌ̹ ɾ ɦ a̠ d a̠	강녈하다
강림	k a̠ː ŋ n i m	강님
강물	k a̠ ŋ m u ɭ	강물
강변	k a̠ ŋ b j ʌ̹ n	강변
강설	k a̠ː ŋ sʰ ʌ̹ ɭ	강설
강세	k a̠ ŋ sʰ e̞	강세
강수	k a̠ː ŋ sʰ u	강수
강아지	k a̠ ŋ a̠ d͡ʑ i	가아지
강아지풀	k a̠ ŋ a̠ d͡ʑ i pʰ u ɭ	가아지풀
강요	k a̠ː ŋ j o	가요
강요하다	k a̠ː ŋ j o ɦ a̠ d a̠	가요하다
강원도	k a̠ ŋ w ʌ̹ n d o̞	가원도
강의	k a̠ː ŋ ɰ i	가의
강점기	k a̠ː ŋ d͡ʑ ʌ̹ m ɡ i	강점기
강정	k a̠ ŋ d͡ʑ ʌ̹ ŋ	강정
강제	k a̠ː ŋ d͡ʑ e̞	강제
강조하다	k a̠ ŋ d͡ʑ o̞ ɦ a̠ d a̠	강조하다
강준치	k a̠ ŋ d͡ʑ u ɲ t͡ɕʰ i	강준치
강철	k a̠ ŋ t͡ɕʰ ʌ̹ ɭ	강철
강추	k a̠ ŋ t͡ɕʰ u	강추
강판	k a̠ ŋ pʰ a̠ n	강판
강하다	k a̠ ŋ ɦ a̠ d a̠	강하다
강화도	k a̠ ŋ β w a̠ d o̞	강화도
갖가지	k a̠ t̚ k͈ a̠ d͡ʑ i	갇까지
갖다	k a̠ t̚ t͈ a̠	갇따
같다	k a̠ t̚ t͈ a̠	갇따
같은	k a̠ tʰ ɯ n	가튼
같이	k a̠ t͡ɕʰ i	가치
같이하다	k a̠ t͡ɕʰ i ɦ a̠ d a̠	가치하다
같잖다	k a̠ t̚ t͡ɕ͈ a̠ n tʰ a̠	갇짠타
갚다	k a̠ p̚ t͈ a̠	갑따
개고기	k ɛː ɡ o̞ ɡ i	개고기
개나리	k ɛː n a̠ ɾ i	개나리
개나리꽃	k ɛː n a̠ ɾ i k͈ o̞ t̚	개나리꼳
개다	k ɛː d a̠	개다
개량	k ɛː ɾ j a̠ ŋ	개량
개성	k ɛː sʰ ʌ̹ ŋ	개성
개수	k ɛː s͈ u	개쑤
개요	k ɛː j o	개요
개인적	k ɛː i ɲ d͡ʑ ʌ̹ k̚	개인적
개정판	k ɛː d͡ʑ ʌ̹ ŋ pʰ a̠ n	개정판
개천	k ɛː t͡ɕʰ ʌ̹ n	개천
개체	k ɛː t͡ɕʰ e̞	개체
개판	k ɛː pʰ a̠ n	개판
개혁	k ɛː ʝ j ʌ̹ k̚	개혁
갸웃거리다	k j a̠ u t̚ k͈ ʌ̹ ɾ i d a̠	갸욷꺼리다
갹출	k j a̠ k̚ t͡ɕʰ u ɭ	갹출
거기	k ʌ̹ ɡ i	거기
거드름	k ɘː d ɯ ɾ ɯ m	거드름
거든	k ʌ̹ d ɯ n	거든
거듭	k ʌ̹ d ɯ p̚	거듭
거뜨다	k ʌ̹ t͈ ɯ d a̠	거뜨다
거리다	k ʌ̹ ɾ i d a̠	거리다
거릿모테이	k ʌ̹ ɾ i n m o̞ tʰ e̞ i	거린모테이
거만	k ɘː m a̠ n	거만
거만하다	k ɘː m a̠ n ɦ a̠ d a̠	거만하다
거머리	k ɘː m ʌ̹ ɾ i	거머리
거문고	k ʌ̹ m u n ɡ o̞	거문고
거미	k ʌ̹ m i	거미
거미줄	k ʌ̹ m i d͡ʑ u ɭ	거미줄
거부하다	k ɘː b u ɦ a̠ d a̠	거부하다
거북선	k ʌ̹ b u k s͈ ʌ̹ n	거북썬
거북이	k ʌ̹ b u ɡ i	거부기
거성	k ɘː sʰ ʌ̹ ŋ	거성
거세	k ɘː sʰ e̞	거세
거세다	k ʌ̹ sʰ e̞ d a̠	거세다
거스러미	k ʌ̹ sʰ ɯ ɾ ʌ̹ m i	거스러미
거스름돈	k ʌ̹ sʰ ɯ ɾ ɯ m t͈ o̞ n	거스름똔
거슬리다	k ʌ̹ sʰ ɯ ʎ ʎ i d a̠	거슬리다
거시기	k ʌ̹ ɕʰ i ɡ i	거시기
거실	k ʌ̹ ɕʰ i ɭ	거실
거야	k ɘː j a̠	거야
거역	k ɘː j ʌ̹ k̚	거역
거울	k ʌ̹ u ɭ	거울
거유	k ɘː j u	거유
거의	k ʌ̹ ɰ i	거의
거인	k ɘː i n	거인
거절	k ɘː d͡ʑ ʌ̹ ɭ	거절
거주	k ʌ̹ d͡ʑ u	거주
거주하다	k ʌ̹ d͡ʑ u ɦ a̠ d a̠	거주하다
거즈	k ʌ̹ d͡ʑ ɯ	거즈
거지	k ɘː d͡ʑ i	거지
거짓	k ɘː d͡ʑ i t̚	거짇
거짓말	k ɘː d͡ʑ i n m a̠ ɭ	거진말
거치적거리다	k ʌ̹ t͡ɕʰ i d͡ʑ ʌ̹ k̚ k͈ ʌ̹ ɾ i d a̠	거치적꺼리다
거칠다	k ʌ̹ t͡ɕʰ i ɭ d a̠	거칠다
거품	k ʌ̹ pʰ u m	거품
걱정	k ʌ̹ k̚ t͡ɕ͈ ʌ̹ ŋ	걱쩡
건강	k ɘː n ɡ a̠ ŋ	건강
건강하다	k ɘː n ɡ a̠ ŋ ɦ a̠ d a̠	건강하다
건강히	k ɘː n ɡ a̠ ŋ ʝ i	건강히
건너가다	k ɘː n n ʌ̹ ɡ a̠ d a̠	건너가다
건너다	k ɘː n n ʌ̹ d a̠	건너다
건너편	k ɘː n n ʌ̹ pʰ j ʌ̹ n	건너편
건넌편	k ɘː n n ʌ̹ n pʰ j ʌ̹ n	건넌편
건널목	k ɘː n n ʌ̹ ɭ m o̞ k̚	건널목
건네다	k ɘː n n e̞ d a̠	건네다
건답	k ʌ̹ n d a̠ p̚	건답
건더기	k ʌ̹ n d ʌ̹ ɡ i	건더기
건반	k ʌ̹ n b a̠ n	건반
건설	k ɘː n sʰ ʌ̹ ɭ	건설
건설하다	k ɘː n sʰ ʌ̹ ɾ ɦ a̠ d a̠	건설하다
건의	k ɘː n ɰ i	거늬
건전하다	k ʌ̹ ɲ d͡ʑ ʌ̹ n ɦ a̠ d a̠	건전하다
건조	k ʌ̹ ɲ d͡ʑ o̞	건조
건조기	k ʌ̹ ɲ d͡ʑ o̞ ɡ i	건조기
건조하다	k ʌ̹ ɲ d͡ʑ o̞ ɦ a̠ d a̠	건조하다
건지다	k ʌ̹ ɲ d͡ʑ i d a̠	건지다
건축	k ɘː ɲ t͡ɕʰ u k̚	건축
건축가	k ɘː ɲ t͡ɕʰ u k̚ k͈ a̠	건축까
건축물	k ɘː ɲ t͡ɕʰ u ŋ m u ɭ	건충물
걸다	k ɘː ɭ d a̠	걸다
걸레	k ʌ̹ ɭ ɭ e̞	걸레
걸리다	k ʌ̹ ʎ ʎ i d a̠	걸리다
걸신	k ʌ̹ ɭ ɕ͈ i n	걸씬
걸어	k ʌ̹ ɾ ʌ̹	거러
걸어가다	k ʌ̹ ɾ ʌ̹ ɡ a̠ d a̠	거러가다
걸음	k ʌ̹ ɾ ɯ m	거름
걸음마	k ʌ̹ ɾ ɯ m m a̠	거름마
걸인	k ʌ̹ ɾ i n	거린
걸치다	k ɘː ʎ t͡ɕʰ i d a̠	걸치다
걸프렌드	k ʌ̹ ɭ pʰ ɯ ɾ e̞ n d ɯ	걸프렌드
걸핏	k ʌ̹ ɭ pʰ i t̚	걸핃
검다	k ɘː m t͈ a̠	검따
검도	k ɘː m d o̞	검도
검독수리	k ʌ̹ m d o̞ k s͈ u ɾ i	검독쑤리
검둥오리	k ʌ̹ m d u ŋ o̞ ɾ i	검두오리
검둥오리사촌	k ʌ̹ m d u ŋ o̞ ɾ i sʰ a̠ t͡ɕʰ o̞ n	검두오리사촌
검둥이	k ʌ̹ m d u ŋ i	검두이
검사	k ɘː m sʰ a̠	검사
검소하다	k ɘː m sʰ o̞ ɦ a̠ d a̠	검소하다
검술	k ɘː m sʰ u ɭ	검술
검역	k ɘː m j ʌ̹ k̚	거멱
검열	k ɘː m ɲ j ʌ̹ ɭ	검녈
검은금	k ʌ̹ m ɯ n ɡ ɯ m	거믄금
검은딸기	k ʌ̹ m ɯ n t͈ a̠ ɭ ɡ i	거믄딸기
검은머리흰죽지	k ʌ̹ m ɯ n m ʌ̹ ɾ i ʝ i ɲ d͡ʑ u k̚ t͡ɕ͈ i	거믄머리힌죽찌
검정	k ʌ̹ m d͡ʑ ʌ̹ ŋ	검정
검정망둑	k ʌ̹ m d͡ʑ ʌ̹ ŋ m a̠ ŋ d u k̚	검정망둑
검토	k ɘː m tʰ o̞	검토
겉핥다	k ʌ̹ tʰ a̠ ɭ t͈ a̠	거탈따
게다가	k e̞ d a̠ ɡ a̠	게다가
게르마늄	k e̞ ɾ ɯ m a̠ ɲ j u m	게르마늄
게르만	k e̞ ɾ ɯ m a̠ n	게르만
게릴라	k e̞ ɾ i ɭ ɭ a̠	게릴라
게스트하우스	k e̞ sʰ ɯ tʰ ɯ ɦ a̠ u sʰ ɯ	게스트하우스
게시	k e̞ː ɕʰ i	게시
게시판	k e̞ː ɕʰ i pʰ a̠ n	게시판
게시하다	k e̞ː ɕʰ i ɦ a̠ d a̠	게시하다
게으르다	k e̞ ɯ ɾ ɯ d a̠	게으르다
게으름	k e̞ ɯ ɾ ɯ m	게으름
게이샤	k e̞ i ɕʰ a̠	게이사
게이트	k e̞ i tʰ ɯ	게이트
게임	k͈ e̞ i m	께임
게임기	k͈ e̞ i m ɡ i	께임기
게장	k e̞ d͡ʑ a̠ ŋ	게장
겨누다	k j ʌ̹ n u d a̠	겨누다
겨드랑이	k j ʌ̹ d ɯ ɾ a̠ ŋ i	겨드라이
겨레	k j ʌ̹ ɾ e̞	겨레
겨루다	k j ʌ̹ ɾ u d a̠	겨루다
겨를	k j ʌ̹ ɾ ɯ ɭ	겨를
겨우	k j ʌ̹ u	겨우
겨울철	k j ʌ̹ u ʎ t͡ɕʰ ʌ̹ ɭ	겨울철
겨자	k j ʌ̹ d͡ʑ a̠	겨자
격납고	k j ʌ̹ ŋ n a̠ p̚ k͈ o̞	경납꼬
격려	k j ʌ̹ ŋ ɲ j ʌ̹	경녀
격리	k j ʌ̹ ŋ n i	경니
격언	k j ʌ̹ ɡ ʌ̹ n	겨건
겪다	k j ʌ̹ k̚ t͈ a̠	격따
견디다	k j ʌ̹ n d i d a̠	견디다
견본	k j ɘː n b o̞ n	견본
견유	k j ʌ̹ ɲ j u	겨뉴
견주다	k j ʌ̹ ɲ d͡ʑ u d a̠	견주다
결론	k j ʌ̹ ɭ ɭ o̞ n	결론
결심	k j ʌ̹ ɭ ɕ͈ i m	결씸
결장	k j ʌ̹ ʎ t͡ɕ͈ a̠ ŋ	결짱
결정	k j ʌ̹ ʎ t͡ɕ͈ ʌ̹ ŋ	결쩡
결정되다	k j ʌ̹ ʎ t͡ɕ͈ ʌ̹ ŋ d w e̞ d a̠	결쩡되다
결정론	k j ʌ̹ ʎ t͡ɕ͈ ʌ̹ ŋ n o̞ n	결쩡논
결정짓다	k j ʌ̹ ʎ t͡ɕ͈ ʌ̹ ŋ d͡ʑ i t̚ t͈ a̠	결쩡짇따
결정하다	k j ʌ̹ ʎ t͡ɕ͈ ʌ̹ ŋ ɦ a̠ d a̠	결쩡하다
결코	k j ʌ̹ ɭ kʰ o̞	결코
결핍	k j ʌ̹ ɭ pʰ i p̚	결핍
결함	k j ʌ̹ ɾ ɦ a̠ m	결함
결합	k j ʌ̹ ɾ ɦ a̠ p̚	결합
결합되다	k j ʌ̹ ɾ ɦ a̠ p̚ t͈ w e̞ d a̠	결합뙤다
결혼	k j ʌ̹ ɾ β o̞ n	결혼
겸손	k j ʌ̹ m sʰ o̞ n	겸손
겸손하다	k j ʌ̹ m sʰ o̞ n ɦ a̠ d a̠	겸손하다
겹다	k j ɘː p̚ t͈ a̠	겹따
경계	k j ʌ̹ ŋ ɡ j e̞	경계
경고	k j ɘː ŋ ɡ o̞	경고
경고창	k j ɘː ŋ ɡ o̞ t͡ɕʰ a̠ ŋ	경고창
경고하다	k j ɘː ŋ ɡ o̞ ɦ a̠ d a̠	경고하다
경관	k j ʌ̹ ŋ ɡ w a̠ n	경관
경구	k j ɘː ŋ k͈ u	경꾸
경기도	k j ʌ̹ ŋ ɡ i d o̞	경기도
경기장	k j ɘː ŋ ɡ i d͡ʑ a̠ ŋ	경기장
경력	k j ʌ̹ ŋ ɲ j ʌ̹ k̚	경녁
경로	k j ʌ̹ ŋ n o̞	경노
경멸적	k j ʌ̹ ŋ m j ʌ̹ ʎ t͡ɕ͈ ʌ̹ k̚	경멸쩍
경보기	k j ɘː ŋ b o̞ ɡ i	경보기
경비원	k j ɘː ŋ b i w ʌ̹ n	경비원
경상남도	k j ɘː ŋ sʰ a̠ ŋ n a̠ m d o̞	경상남도
경상도	k j ɘː ŋ sʰ a̠ ŋ d o̞	경상도
경성	k j ʌ̹ ŋ sʰ ʌ̹ ŋ	경성
경시	k j ʌ̹ ŋ ɕʰ i	경시
경악	k j ʌ̹ ŋ a̠ k̚	겨악
경어	k j ɘː ŋ ʌ̹	겨어
경영	k j ʌ̹ ŋ j ʌ̹ ŋ	겨영
경영자	k j ʌ̹ ŋ j ʌ̹ ŋ d͡ʑ a̠	겨영자
경영하다	k j ʌ̹ ŋ j ʌ̹ ŋ ɦ a̠ d a̠	겨영하다
경외	k j ɘː ŋ w e̞	겨외
경우	k j ʌ̹ ŋ u	겨우
경이롭다	k j ʌ̹ ŋ i ɾ o̞ p̚ t͈ a̠	겨이롭따
경제	k j ʌ̹ ŋ d͡ʑ e̞	경제
경제적	k j ʌ̹ ŋ d͡ʑ e̞ d͡ʑ ʌ̹ k̚	경제적
경주	k j ɘː ŋ d͡ʑ u	경주
경찰	k j ɘː ŋ t͡ɕʰ a̠ ɭ	경찰
경찰서	k j ɘː ŋ t͡ɕʰ a̠ ɭ s͈ ʌ̹	경찰써
경청	k j ʌ̹ ŋ t͡ɕʰ ʌ̹ ŋ	경청
경축	k j ɘː ŋ t͡ɕʰ u k̚	경축
경치	k j ʌ̹ ŋ t͡ɕʰ i	경치
경향	k j ʌ̹ ŋ ʝ j a̠ ŋ	경향
경험	k j ʌ̹ ŋ ɦ ʌ̹ m	경험
경험하다	k j ʌ̹ ŋ ɦ ʌ̹ m ɦ a̠ d a̠	경험하다
계간	k j e̞ ɡ a̠ n	계간
계곡	k j e̞ ɡ o̞ k̚	계곡
계급	k j e̞ ɡ ɯ p̚	계급
계단	k j e̞ d a̠ n	계단
계란	k j e̞ ɾ a̠ n	계란
계란찜	k j e̞ ɾ a̠ ɲ t͡ɕ͈ i m	계란찜
계량경제학	k j e̞ː ɾ j a̠ ŋ ɡ j ʌ̹ ŋ d͡ʑ e̞ ɦ a̠ k̚	계량경제학
계렬	k j e̞ ɾ j ʌ̹ ɭ	계렬
계모	k j e̞ː m o̞	계모
계산	k j e̞ː sʰ a̠ n	계산
계산기	k j e̞ː sʰ a̠ n ɡ i	계산기
계산서	k j e̞ː sʰ a̠ n sʰ ʌ̹	계산서
계산원	k j e̞ː sʰ a̠ n w ʌ̹ n	계사눤
계속	k j e̞ː sʰ o̞ k̚	계속
계속하다	k j e̞ː sʰ o̞ kʰ a̠ d a̠	계소카다
계수	k j e̞ː sʰ u	계수
계승	k j e̞ sʰ ɯ ŋ	계승
계시	k j e̞ː ɕʰ i	계시
계시다	k j e̞ː ɕʰ i d a̠	계시다
계약	k j e̞ː j a̠ k̚	계약
계열	k j e̞ j ʌ̹ ɭ	계열
계절	k j e̞ː d͡ʑ ʌ̹ ɭ	계절
계절적	k j e̞ː d͡ʑ ʌ̹ ʎ t͡ɕ͈ ʌ̹ k̚	계절쩍
계정	k j e̞ː d͡ʑ ʌ̹ ŋ	계정
계좌	k j e̞ː d͡ʑ w a̠	계좌
계층	k j e̞ t͡ɕʰ ɯ ŋ	계층
계통	k j e̞ː tʰ o̞ ŋ	계통
고가교	k o̞ ɡ a̠ ɡ j o	고가교
고고학	k o̞ː ɡ o̞ ɦ a̠ k̚	고고학
고관	k o̞ ɡ w a̠ n	고관
고구려	k o̞ ɡ u ɾ j ʌ̹	고구려
고구마	k o̞ː ɡ u m a̠	고구마
고국	k o̞ː ɡ u k̚	고국
고급	k o̞ ɡ ɯ p̚	고급
고기겹빵	k o̞ ɡ i ɡ j ʌ̹ p̚ p͈ a̠ ŋ	고기겹빵
고난	k o̞ n a̠ n	고난
고니	k o̞ n i	고니
고달피다	k o̞ d a̠ ɭ pʰ i d a̠	고달피다
고독	k o̞ d o̞ k̚	고독
고독하다	k o̞ d o̞ kʰ a̠ d a̠	고도카다
고등어	k o̞ d ɯ ŋ ʌ̹	고드어
고등학교	k o̞ d ɯ ŋ ɦ a̠ k̚ k͈ j o	고등학꾜
고라니	k o̞ ɾ a̠ n i	고라니
고량주	k o̞ ɾ j a̠ ŋ d͡ʑ u	고량주
고려	k o̞ ɾ j ʌ̹	고려
고려말	k o̞ ɾ j ʌ̹ m a̠ ɭ	고려말
고루	k o̞ ɾ u	고루
고르다	k o̞ ɾ ɯ d a̠	고르다
고리	k o̞ ɾ i	고리
고릴라	k o̞ ɾ i ɭ ɭ a̠	고릴라
고마워	k o̞ m a̠ w ʌ̹	고마워
고맙다	k o̞ː m a̠ p̚ t͈ a̠	고맙따
고맙습니다	k o̞ m a̠ p s͈ ɯ m n i d a̠	고맙씀니다
고모	k o̞ m o̞	고모
고모부	k o̞ m o̞ b u	고모부
고무신	k o̞ m u ɕʰ i n	고무신
고문	k o̞ m u n	고문
고민	k o̞ m i n	고민
고민하다	k o̞ m i n ɦ a̠ d a̠	고민하다
고바야시박쥐	k o̞ b a̠ j a̠ ɕʰ i b a̠ k̚ t͡ɕ͈ ɥ i	고바야시박쮜
고발	k o̞ː b a̠ ɭ	고발
고방오리	k o̞ b a̠ ŋ o̞ ɾ i	고바오리
고삐	k o̞ p͈ i	고삐
고사기	k o̞ː sʰ a̠ ɡ i	고사기
고사리	k o̞ sʰ a̠ ɾ i	고사리
고사성어	k o̞ː sʰ a̠ sʰ ʌ̹ ŋ ʌ̹	고사서어
고사포	k o̞ sʰ a̠ pʰ o̞	고사포
고산	k o̞ sʰ a̠ n	고산
고속버스	k o̞ sʰ o̞ k̚ p͈ ʌ̹ sʰ ɯ	고속뻐스
고수	k o̞ sʰ u	고수
고순쥐	k o̞ sʰ u ɲ d͡ʑ ɥ i	고순쥐
고스트	k o̞ sʰ ɯ tʰ ɯ	고스트
고시	k o̞ː ɕʰ i	고시
고아	k o̞ a̠	고아
고아원	k o̞ a̠ w ʌ̹ n	고아원
고양이	k o̞ j a̠ ŋ i	고야이
고어	k o̞ː ʌ̹	고어
고온	k o̞ o̞ n	고온
고요	k o̞ j o	고요
고용	k o̞ j o ŋ	고용
고을	k o̞ ɯ ɭ	고을
고저	k o̞ d͡ʑ ʌ̹	고저
고전	k o̞ː d͡ʑ ʌ̹ n	고전
고전적	k o̞ː d͡ʑ ʌ̹ ɲ d͡ʑ ʌ̹ k̚	고전적
고정	k o̞ d͡ʑ ʌ̹ ŋ	고정
고정되다	k o̞ d͡ʑ ʌ̹ ŋ d w e̞ d a̠	고정되다
고조	k o̞ d͡ʑ o̞	고조
고조선	k o̞ː d͡ʑ o̞ sʰ ʌ̹ n	고조선
고지	k o̞ d͡ʑ i	고지
고지리학	k o̞ː d͡ʑ i ɾ i ɦ a̠ k̚	고지리학
고지식하다	k o̞ d͡ʑ i ɕʰ i kʰ a̠ d a̠	고지시카다
고질병	k o̞ d͡ʑ i ɭ p͈ j ʌ̹ ŋ	고질뼝
고집	k o̞ d͡ʑ i p̚	고집
고집스럽다	k o̞ d͡ʑ i p s͈ ɯ ɾ ʌ̹ p̚ t͈ a̠	고집쓰럽따
고집하다	k o̞ d͡ʑ i pʰ a̠ d a̠	고지파다
고추장	k o̞ t͡ɕʰ u d͡ʑ a̠ ŋ	고추장
고춧가루	k o̞ t͡ɕʰ u t̚ k͈ a̠ ɾ u	고춛까루
고통	k o̞ tʰ o̞ ŋ	고통
고통스럽다	k o̞ tʰ o̞ ŋ sʰ ɯ ɾ ʌ̹ p̚ t͈ a̠	고통스럽따
고투	k o̞ː tʰ u	고투
고프다	k o̞ pʰ ɯ d a̠	고프다
고혈압	k o̞ ʝ j ʌ̹ ɾ a̠ p̚	고혀랍
고환	k o̞ β w a̠ n	고환
곡물	k o̞ ŋ m u ɭ	공물
곡식	k o̞ k ɕ͈ i k̚	곡씩
곡예사	k o̞ ɡ j e̞ sʰ a̠	고계사
곡조	k o̞ k̚ t͡ɕ͈ o̞	곡쪼
곤란	k o̞ː ɭ ɭ a̠ n	골란
곤란하다	k o̞ː ɭ ɭ a̠ n ɦ a̠ d a̠	골란하다
곤이	k o̞ n i	고니
곤충	k o̞ ɲ t͡ɕʰ u ŋ	곤충
곤충학	k o̞ ɲ t͡ɕʰ u ŋ ɦ a̠ k̚	곤충학
곧바로	k o̞ t̚ p͈ a̠ ɾ o̞	곧빠로
곧은창자	k o̞ d ɯ ɲ t͡ɕʰ a̠ ŋ d͡ʑ a̠	고든창자
곧장	k o̞ t̚ t͡ɕ͈ a̠ ŋ	곧짱
골드바	k o̞ ɭ d ɯ b a̠	골드바
골목	k o̞ː ɭ m o̞ k̚	골목
골무	k o̞ ɭ m u	골무
골반	k o̞ ɭ b a̠ n	골반
골상학	k o̞ ɭ sʰ a̠ ŋ ɦ a̠ k̚	골상학
골수	k o̞ ɭ s͈ u	골쑤
골인	k͈ o̞ ɾ i n	꼬린
골짜기	k o̞ ʎ t͡ɕ͈ a̠ ɡ i	골짜기
골프	k͈ o̞ ɭ pʰ ɯ	꼴프
곪다	k o̞ː m t͈ a̠	곰따
곰국	k o̞ː m k͈ u k̚	곰꾹
곰비임비	k o̞ m b i i m b i	곰비임비
곰실	k o̞ m ɕʰ i ɭ	곰실
곰틀	k o̞ m tʰ ɯ ɭ	곰틀
곰팡이	k o̞ m pʰ a̠ ŋ i	곰파이
곱사연어	k o̞ p s͈ a̠ j ʌ̹ n ʌ̹	곱싸여너
곱셈	k o̞ p s͈ e̞ m	곱쎔
곳곳	k o̞ t̚ k͈ o̞ t̚	곧꼳
공간	k o̞ ŋ ɡ a̠ n	공간
공갈	k o̞ː ŋ ɡ a̠ ɭ	공갈
공격	k o̞ː ŋ ɡ j ʌ̹ k̚	공격
공경	k o̞ ŋ ɡ j ʌ̹ ŋ	공경
공공	k o̞ ŋ ɡ o̞ ŋ	공공
공구	k o̞ ŋ ɡ u	공구
공군	k o̞ ŋ ɡ u n	공군
공급	k o̞ː ŋ ɡ ɯ p̚	공급
공동	k o̞ː ŋ d o̞ ŋ	공동
공동체	k o̞ː ŋ d o̞ ŋ t͡ɕʰ e̞	공동체
공로	k o̞ ŋ n o̞	공노
공룡	k o̞ː ŋ ɲ j o ŋ	공뇽
공리주의	k o̞ ŋ n i d͡ʑ u ɰ i	공니주의
공모	k o̞ː ŋ m o̞	공모
공무원	k o̞ ŋ m u w ʌ̹ n	공무원
공민	k o̞ ŋ m i n	공민
공방	k o̞ ŋ b a̠ ŋ	공방
공병	k o̞ ŋ b j ʌ̹ ŋ	공병
공보원	k o̞ ŋ b o̞ w ʌ̹ n	공보원
공부하다	k o̞ ŋ b u ɦ a̠ d a̠	공부하다
공산당	k o̞ː ŋ sʰ a̠ n d a̠ ŋ	공산당
공산주의	k o̞ː ŋ sʰ a̠ ɲ d͡ʑ u ɰ i	공산주의
공산주의자	k o̞ː ŋ sʰ a̠ ɲ d͡ʑ u ɰ i d͡ʑ a̠	공산주의자
공성계	k o̞ ŋ sʰ ʌ̹ ŋ ɡ j e̞	공성계
공세	k o̞ː ŋ sʰ e̞	공세
공수	k o̞ ŋ sʰ u	공수
공수도	k o̞ ŋ sʰ u d o̞	공수도
공수병	k o̞ː ŋ sʰ u p͈ j ʌ̹ ŋ	공수뼝
공식	k o̞ ŋ ɕʰ i k̚	공식
공식어	k o̞ ŋ ɕʰ i ɡ ʌ̹	공시거
공안	k o̞ ŋ a̠ n	고안
공언	k o̞ ŋ ʌ̹ n	고언
공언하다	k o̞ ŋ ʌ̹ n ɦ a̠ d a̠	고언하다
공업	k o̞ ŋ ʌ̹ p̚	고업
공업화	k o̞ː ŋ ʌ̹ pʰ w a̠	고어퐈
공연	k o̞ ŋ j ʌ̹ n	고연
공용어	k o̞ ŋ j o ŋ ʌ̹	고요어
공원	k o̞ ŋ w ʌ̹ n	고원
공인	k o̞ ŋ i n	고인
공작	k o̞ː ŋ d͡ʑ a̠ k̚	공작
공정	k o̞ ŋ d͡ʑ ʌ̹ ŋ	공정
공정하다	k o̞ ŋ d͡ʑ ʌ̹ ŋ ɦ a̠ d a̠	공정하다
공주	k o̞ ŋ d͡ʑ u	공주
공중	k o̞ ŋ d͡ʑ u ŋ	공중
공중전화	k o̞ ŋ d͡ʑ u ŋ d͡ʑ ʌ̹ n β w a̠	공중전화
공지	k o̞ ŋ d͡ʑ i	공지
공짜	k o̞ ŋ t͡ɕ͈ a̠	공짜
공통점	k o̞ː ŋ tʰ o̞ ŋ t͡ɕ͈ ʌ̹ m	공통쩜
공포	k o̞ː ŋ pʰ o̞	공포
공학	k o̞ ŋ ɦ a̠ k̚	공학
공항	k o̞ ŋ ɦ a̠ ŋ	공항
공허하다	k o̞ ŋ ɦ ʌ̹ ɦ a̠ d a̠	공허하다
공황	k o̞ː ŋ β w a̠ ŋ	공황
과거형	k w a̠ː ɡ ʌ̹ ʝ j ʌ̹ ŋ	과거형
과금	k w a̠ ɡ ɯ m	과금
과두	k w a̠ː d u	과두
과들루쁘	k w a̠ d ɯ ɭ ɭ u p͈ ɯ	과들루쁘
과들루프	k w a̠ d ɯ ɭ ɭ u pʰ ɯ	과들루프
과떼말라	k w a̠ t͈ e̞ m a̠ ɭ ɭ a̠	과떼말라
과로	k w a̠ː ɾ o̞	과로
과로사	k w a̠ː ɾ o̞ sʰ a̠	과로사
과립	k w a̠ ɾ i p̚	과립
과메기	k w a̠ m e̞ ɡ i	과메기
과물	k w a̠ m u ɭ	과물
과업	k w a̠ ʌ̹ p̚	과업
과연	k w a̠ː j ʌ̹ n	과연
과외	k w a̠ w e̞	과외
과욕	k w a̠ː j o k̚	과욕
과일	k w a̠ː i ɭ	과일
과일단물	k w a̠ i ɭ d a̠ n m u ɭ	과일단물
과일물	k w a̠ː i ɭ m u ɭ	과일물
과자	k w a̠ː d͡ʑ a̠	과자
과장	k w a̠ d͡ʑ a̠ ŋ	과장
과정	k w a̠ː d͡ʑ ʌ̹ ŋ	과정
과테말라	k w a̠ tʰ e̞ m a̠ ɭ ɭ a̠	과테말라
과팅	k w a̠ tʰ i ŋ	과팅
과포자	k w a̠ pʰ o̞ d͡ʑ a̠	과포자
과학	k w a̠ ɦ a̠ k̚	과학
과학관	k w a̠ ɦ a̠ k̚ k͈ w a̠ n	과학꽌
과학자	k w a̠ ɦ a̠ k̚ t͡ɕ͈ a̠	과학짜
과학적	k w a̠ ɦ a̠ k̚ t͡ɕ͈ ʌ̹ k̚	과학쩍
곽밥	k w a̠ k̚ p͈ a̠ p̚	곽빱
관계	k w a̠ n ɡ j e̞	관계
관계어	k w a̠ n ɡ j e̞ ʌ̹	관계어
관계없이	k w a̠ n ɡ j e̞ ʌ̹ p ɕ͈ i	관계업씨
관계자	k w a̠ n ɡ j e̞ d͡ʑ a̠	관계자
관광	k w a̠ n ɡ w a̠ ŋ	관광
관광버스	k w a̠ n ɡ w a̠ ŋ b ʌ̹ sʰ ɯ	관광버스
관광학	k w a̠ n ɡ w a̠ ŋ ɦ a̠ k̚	관광학
관념	k w a̠ n ɲ j ʌ̹ m	관념
관람차	k w a̠ ɭ ɭ a̠ m t͡ɕʰ a̠	괄람차
관련	k w a̠ ʎ ʎ j ʌ̹ n	괄련
관련성	k w a̠ ʎ ʎ j ʌ̹ n s͈ ʌ̹ ŋ	괄련썽
관리	k w a̠ ʎ ʎ i	괄리
관리인	k w a̠ ʎ ʎ i i n	괄리인
관리하다	k w a̠ ʎ ʎ i ɦ a̠ d a̠	괄리하다
관문	k w a̠ n m u n	관문
관박쥐	k w a̠ n b a̠ k̚ t͡ɕ͈ ɥ i	관박쮜
관복	k w a̠ n b o̞ k̚	관복
관사	k w a̠ n sʰ a̠	관사
관성	k w a̠ n sʰ ʌ̹ ŋ	관성
관세	k w a̠ n sʰ e̞	관세
관심	k w a̠ n ɕʰ i m	관심
관용구	k w a̠ ɲ j o ŋ k͈ u	과뇽꾸
관음	k w a̠ n ɯ m	과늠
관자놀이	k w a̠ ɲ d͡ʑ a̠ n o̞ ɾ i	관자노리
관절	k w a̠ ɲ d͡ʑ ʌ̹ ɭ	관절
관절염	k w a̠ ɲ d͡ʑ ʌ̹ ɾ j ʌ̹ m	관저렴
관찰	k w a̠ ɲ t͡ɕʰ a̠ ɭ	관찰
관찰하다	k w a̠ ɲ t͡ɕʰ a̠ ɾ ɦ a̠ d a̠	관찰하다
관코박쥐	k w a̠ n kʰ o̞ b a̠ k̚ t͡ɕ͈ ɥ i	관코박쮜
관풍금	k w a̠ n pʰ u ŋ ɡ ɯ m	관풍금
관할	k w a̠ n ɦ a̠ ɭ	관할
관현악단	k w a̠ n ʝ j ʌ̹ n a̠ k̚ t͈ a̠ n	관혀낙딴
관형사	k w a̠ n ʝ j ʌ̹ ŋ sʰ a̠	관형사
괄약근	k w a̠ ɾ j a̠ k̚ k͈ ɯ n	과략끈
괄호	k w a̠ ɾ β o̞	괄호
광검	k w a̠ ŋ ɡ ʌ̹ m	광검
광견병	k w a̠ ŋ ɡ j ʌ̹ n p͈ j ʌ̹ ŋ	광견뼝
광경	k w a̠ ŋ ɡ j ʌ̹ ŋ	광경
광년	k w a̠ ŋ ɲ j ʌ̹ n	광년
광동	k w a̠ː ŋ d o̞ ŋ	광동
광동어	k w a̠ː ŋ d o̞ ŋ ʌ̹	광도어
광둥	k w a̠ ŋ d u ŋ	광둥
광명	k w a̠ ŋ m j ʌ̹ ŋ	광명
광명성절	k w a̠ ŋ m j ʌ̹ ŋ sʰ ʌ̹ ŋ d͡ʑ ʌ̹ ɭ	광명성절
광물	k w a̠ː ŋ m u ɭ	광물
광부	k w a̠ː ŋ b u	광부
광산	k w a̠ː ŋ sʰ a̠ n	광산
광석	k w a̠ː ŋ sʰ ʌ̹ k̚	광석
광선	k w a̠ ŋ sʰ ʌ̹ n	광선
광시	k w a̠ ŋ ɕʰ i	광시
광업	k w a̠ː ŋ ʌ̹ p̚	과업
광역시	k w a̠ː ŋ j ʌ̹ k ɕ͈ i	과역씨
광우병	k w a̠ ŋ u p͈ j ʌ̹ ŋ	과우뼝
광원	k w a̠ ŋ w ʌ̹ n	과원
광장	k w a̠ː ŋ d͡ʑ a̠ ŋ	광장
광초	k w a̠ ŋ t͡ɕʰ o̞	광초
광학	k w a̠ ŋ ɦ a̠ k̚	광학
광화문	k w a̠ ŋ β w a̠ m u n	광화문
괴기	k w e̞ ɡ i	괴기
괴다	k w e̞ː d a̠	괴다
괴담	k w e̞ː d a̠ m	괴담
괴로움	k w e̞ ɾ o̞ u m	괴로움
괴롭다	k w e̞ ɾ o̞ p̚ t͈ a̠	괴롭따
괴뢰	k w e̞ː ɾ w e̞	괴뢰
괴리	k w e̞ ɾ i	괴리
괴물	k w e̞ː m u ɭ	괴물
괴수	k w e̞ː sʰ u	괴수
괴짜	k w e̞ː t͡ɕ͈ a̠	괴짜
괴한	k w e̞ː ɦ a̠ n	괴한
굉장히	k w e̞ ŋ d͡ʑ a̠ ŋ ʝ i	굉장히
교가	k j oː ɡ a̠	교가
교각	k j o ɡ a̠ k̚	교각
교거	k j o ɡ ʌ̹	교거
교과서	k j oː k͈ w a̠ sʰ ʌ̹	교꽈서
교도	k j oː d o̞	교도
교란	k j o ɾ a̠ n	교란
교량	k j o ɾ j a̠ ŋ	교량
교류	k j o ɾ j u	교류
교리	k j oː ɾ i	교리
교미	k j o m i	교미
교복	k j oː b o̞ k̚	교복
교수	k j oː sʰ u	교수
교실	k j oː ɕʰ i ɭ	교실
교양	k j oː j a̠ ŋ	교양
교역	k j o j ʌ̹ k̚	교역
교외	k j o w e̞	교외
교원	k j oː w ʌ̹ n	교원
교육	k j oː j u k̚	교육
교육학	k j oː j u kʰ a̠ k̚	교유칵
교인	k j oː i n	교인
교장	k j oː d͡ʑ a̠ ŋ	교장
교전	k j o d͡ʑ ʌ̹ n	교전
교정	k j oː d͡ʑ ʌ̹ ŋ	교정
교조	k j oː d͡ʑ o̞	교조
교차로	k j o t͡ɕʰ a̠ ɾ o̞	교차로
교체	k j o t͡ɕʰ e̞	교체
교체하다	k j o t͡ɕʰ e̞ ɦ a̠ d a̠	교체하다
교탁	k j oː tʰ a̠ k̚	교탁
교토	k j o tʰ o̞	교토
교통	k j o tʰ o̞ ŋ	교통
교통사고	k j o tʰ o̞ ŋ sʰ a̠ ɡ o̞	교통사고
교통요금	k j o tʰ o̞ ŋ j o ɡ ɯ m	교토요금
교포	k j o pʰ o̞	교포
교향곡	k j o ʝ j a̠ ŋ ɡ o̞ k̚	교향곡
교환	k j o β w a̠ n	교환
교활하다	k j o β w a̠ ɾ ɦ a̠ d a̠	교활하다
교황	k j oː β w a̠ ŋ	교황
교회론	k j oː β w e̞ ɾ o̞ n	교회론
구강	k uː ɡ a̠ ŋ	구강
구결자	k uː ɡ j ʌ̹ ʎ t͡ɕ͈ a̠	구결짜
구경	k uː ɡ j ʌ̹ ŋ	구경
구경꾼	k uː ɡ j ʌ̹ ŋ k͈ u n	구경꾼
구경하다	k uː ɡ j ʌ̹ ŋ ɦ a̠ d a̠	구경하다
구굴무치	k u ɡ u ɭ m u t͡ɕʰ i	구굴무치
구급차	k uː ɡ ɯ p̚ t͡ɕʰ a̠	구급차
구기자	k u ɡ i d͡ʑ a̠	구기자
구난	k uː n a̠ n	구난
구녕	k u ɲ j ʌ̹ ŋ	구녕
구더기	k u d ʌ̹ ɡ i	구더기
구덩이	k u d ʌ̹ ŋ i	구더이
구라파	k u ɾ a̠ pʰ a̠	구라파
구렁이	k u ɾ ʌ̹ ŋ i	구러이
구레나룻	k u ɾ e̞ n a̠ ɾ u t̚	구레나룯
구름	k u ɾ ɯ m	구름
구름다리	k u ɾ ɯ m d a̠ ɾ i	구름다리
구마	k u m a̠	구마
구멍	k u m ʌ̹ ŋ	구멍
구무	k u m u	구무
구미호	k u m i β o̞	구미호
구부리다	k u b u ɾ i d a̠	구부리다
구분	k u b u n	구분
구분자	k uː b u ɲ d͡ʑ a̠	구분자
구상	k u sʰ a̠ ŋ	구상
구성	k u sʰ ʌ̹ ŋ	구성
구성원	k u sʰ ʌ̹ ŋ w ʌ̹ n	구서원
구성하다	k u sʰ ʌ̹ ŋ ɦ a̠ d a̠	구성하다
구속	k u sʰ o̞ k̚	구속
구슬	k u sʰ ɯ ɭ	구슬
구십	k u ɕʰ i p̚	구십
구약	k u j a̠ k̚	구약
구약성경	k uː j a̠ k s͈ ʌ̹ ŋ ɡ j ʌ̹ ŋ	구약썽경
구요	k u j o	구요
구원	k uː w ʌ̹ n	구원
구이	k u i	구이
구입	k u i p̚	구입
구입처	k u i p̚ t͡ɕʰ ʌ̹	구입처
구절	k u d͡ʑ ʌ̹ ɭ	구절
구체적	k u t͡ɕʰ e̞ d͡ʑ ʌ̹ k̚	구체적
구축	k u t͡ɕʰ u k̚	구축
구출	k uː t͡ɕʰ u ɭ	구출
구취	k uː t͡ɕʰ ɥ i	구취
구치소	k u t͡ɕʰ i sʰ o̞	구치소
구타	k u tʰ a̠	구타
구토	k u tʰ o̞	구토
구현	k u ʝ j ʌ̹ n	구현
구호	k uː β o̞	구호
구호금	k uː β o̞ ɡ ɯ m	구호금
구혼	k u β o̞ n	구혼
국가	k u k̚ k͈ a̠	국까
국경	k u k̚ k͈ j ʌ̹ ŋ	국꼉
국립	k u ŋ n i p̚	궁닙
국면	k u ŋ m j ʌ̹ n	궁면
국물	k u ŋ m u ɭ	궁물
국민	k u ŋ m i n	궁민
국산	k u k s͈ a̠ n	국싼
국수주의	k u k s͈ u d͡ʑ u ɰ i	국쑤주의
국악	k u ɡ a̠ k̚	구각
국어	k u ɡ ʌ̹	구거
국영	k u ɡ j ʌ̹ ŋ	구경
국왕	k u ɡ w a̠ ŋ	구광
국유화	k u ɡ j u β w a̠	구규화
국자	k u k̚ t͡ɕ͈ a̠	국짜
국적	k u k̚ t͡ɕ͈ ʌ̹ k̚	국쩍
국제화	k u k̚ t͡ɕ͈ e̞ β w a̠	국쩨화
국토	k u k̚ tʰ o̞	국토
국한문	k u kʰ a̠ n m u n	구칸문
국화	k u kʰ w a̠	구콰
국회	k u kʰ w e̞	구쾨
군관	k u n ɡ w a̠ n	군관
군국주의	k u n ɡ u k̚ t͡ɕ͈ u ɰ i	군국쭈의
군단	k u n d a̠ n	군단
군데	k u n d e̞	군데
군데군데	k u n d e̞ ɡ u n d e̞	군데군데
군도	k u n d o̞	군도
군만두	k uː n m a̠ n d u	군만두
군복	k u n b o̞ k̚	군복
군소리	k uː n sʰ o̞ ɾ i	군소리
군인	k u n i n	구닌
군주제	k u ɲ d͡ʑ u d͡ʑ e̞	군주제
굳다	k u t̚ t͈ a̠	굳따
굴곡위	k u ɭ ɡ o̞ ɡ ɥ i	굴고귀
굴다	k u ɭ d a̠	굴다
굴뚝	k uː ɭ t͈ u k̚	굴뚝
굴레	k u ɭ ɭ e̞	굴레
굴비	k u ɭ b i	굴비
굴절	k u ʎ t͡ɕ͈ ʌ̹ ɭ	굴쩔
굴착기	k u ʎ t͡ɕʰ a̠ k̚ k͈ i	굴착끼
굶기다	k u m ɡ i d a̠	굼기다
굼벵이	k uː m b e̞ ŋ i	굼베이
굼실굼실	k u m ɕʰ i ɭ ɡ u m ɕʰ i ɭ	굼실굼실
굼적굼적	k u m d͡ʑ ʌ̹ k̚ k͈ u m d͡ʑ ʌ̹ k̚	굼적꿈적
굽이	k u b i	구비
굽히다	k u pʰ i d a̠	구피다
궁극적	k u ŋ ɡ ɯ k̚ t͡ɕ͈ ʌ̹ k̚	궁극쩍
궁금하다	k u ŋ ɡ ɯ m ɦ a̠ d a̠	궁금하다
궁수	k u ŋ sʰ u	궁수
궁전	k u ŋ d͡ʑ ʌ̹ n	궁전
궁정	k u ŋ d͡ʑ ʌ̹ ŋ	궁정
궁중	k u ŋ d͡ʑ u ŋ	궁중
궁핍	k u ŋ pʰ i p̚	궁핍
권고	k w ɘː n ɡ o̞	ㄱwㅓㄴ고
권당	k w ʌ̹ n d a̠ ŋ	권당
권력	k w ɘː ʎ ʎ j ʌ̹ k̚	ㄱwㅓㄹ력
권리	k w ʌ̹ ʎ ʎ i	궐리
권세	k w ʌ̹ n sʰ e̞	권세
권위	k w ʌ̹ n ɥ i	궈뉘
권투	k w ʌ̹ n tʰ u	권투
궤도	k w e̞ː d o̞	궤도
궤변	k w e̞ː b j ʌ̹ n	궤변
귀걸이	k ɥ i ɡ ʌ̹ ɾ i	귀거리
귀국	k ɥ iː ɡ u k̚	귀국
귀국하다	k ɥ iː ɡ u kʰ a̠ d a̠	귀구카다
귀뚜라미	k ɥ i t͈ u ɾ a̠ m i	귀뚜라미
귀뚤귀	k ɥ i t͈ u ɭ ɡ ɥ i	귀뚤귀
귀리	k ɥ iː ɾ i	귀리
귀신	k ɥ iː ɕʰ i n	귀신
귀양	k ɥ i j a̠ ŋ	귀양
귀엽다	k ɥ iː j ʌ̹ p̚ t͈ a̠	귀엽따
귀족	k ɥ i d͡ʑ o̞ k̚	귀족
귀주	k ɥ i d͡ʑ u	귀주
귀찮다	k ɥ i t͡ɕʰ a̠ n tʰ a̠	귀찬타
귀하다	k ɥ iː ɦ a̠ d a̠	귀하다
귀환	k ɥ iː β w a̠ n	귀환
귓불	k ɥ i t̚ p͈ u ɭ	귇뿔
규모	k j u m o̞	규모
규범	k j u b ʌ̹ m	규범
규약	k j u j a̠ k̚	규약
규율	k j u j u ɭ	규율
규정	k j u d͡ʑ ʌ̹ ŋ	규정
규제	k j u d͡ʑ e̞	규제
규칙	k j u t͡ɕʰ i k̚	규칙
규칙적	k j u t͡ɕʰ i k̚ t͡ɕ͈ ʌ̹ k̚	규칙쩍
균형	k j u n ʝ j ʌ̹ ŋ	균형
그것	k ɯ ɡ ʌ̹ t̚	그걷
그곳	k ɯ ɡ o̞ t̚	그곧
그끄저께	k ɯ k͈ ɯ d͡ʑ ʌ̹ k͈ e̞	그끄저께
그날	k ɯ n a̠ ɭ	그날
그냥	k ɯ ɲ j a̠ ŋ	그냥
그네	k ɯː n e̞	그네
그네들	k ɯ n e̞ d ɯ ɭ	그네들
그녀들	k ɯ ɲ j ʌ̹ d ɯ ɭ	그녀들
그늘	k ɯ n ɯ ɭ	그늘
그늘지다	k ɯ n ɯ ʎ d͡ʑ i d a̠	그늘지다
그다음	k ɯ d a̠ ɯ m	그다음
그다지	k ɯ d a̠ d͡ʑ i	그다지
그동안	k ɯ d o̞ ŋ a̠ n	그도안
그라프	k ɯ ɾ a̠ pʰ ɯ	그라프
그람	k ɯ ɾ a̠ m	그람
그러나	k ɯ ɾ ʌ̹ n a̠	그러나
그러니까	k ɯ ɾ ʌ̹ n i k͈ a̠	그러니까
그러다	k ɯ ɾ ʌ̹ d a̠	그러다
그러면	k ɯ ɾ ʌ̹ m j ʌ̹ n	그러면
그러므로	k ɯ ɾ ʌ̹ m ɯ ɾ o̞	그러므로
그러하다	k ɯ ɾ ʌ̹ ɦ a̠ d a̠	그러하다
그런	k ɯ ɾ ʌ̹ n	그런
그런데	k ɯ ɾ ʌ̹ n d e̞	그런데
그럼	k ɯ ɾ ʌ̹ m	그럼
그렇게	k ɯ ɾ ʌ̹ kʰ e̞	그러케
그렇지	k ɯ ɾ ʌ̹ t͡ɕʰ i	그러치
그렇지만	k ɯ ɾ ʌ̹ t͡ɕʰ i m a̠ n	그러치만
그레나다	k ɯ ɾ e̞ n a̠ d a̠	그레나다
그레이프프루트	k͈ ɯ ɾ e̞ i pʰ ɯ pʰ ɯ ɾ u tʰ ɯ	끄레이프프루트
그루	k ɯ ɾ u	그루
그루지야	k ɯ ɾ u d͡ʑ i j a̠	그루지야
그룹	k ɯ ɾ u p̚	그룹
그르다	k ɯ ɾ ɯ d a̠	그르다
그릇	k ɯ ɾ ɯ t̚	그륻
그릇되다	k ɯ ɾ ɯ t̚ t͈ w e̞ d a̠	그륻뙤다
그리	k ɯ ɾ i	그리
그리고	k ɯ ɾ i ɡ o̞	그리고
그리다	k ɯː ɾ i d a̠	그리다
그리스도	k ɯ ɾ i sʰ ɯ d o̞	그리스도
그리스도교	k ɯ ɾ i sʰ ɯ d o̞ ɡ j o	그리스도교
그리스어	k ɯ ɾ i sʰ ɯ ʌ̹	그리스어
그리움	k ɯ ɾ i u m	그리움
그리워하다	k ɯ ɾ i w ʌ̹ ɦ a̠ d a̠	그리워하다
그린란드	k ɯ ɾ i n n a̠ n d ɯ	그린난드
그림	k ɯː ɾ i m	그림
그림자	k ɯː ɾ i m d͡ʑ a̠	그림자
그립다	k ɯ ɾ i p̚ t͈ a̠	그립따
그만	k ɯ m a̠ n	그만
그만큼	k ɯ m a̠ n k x ɯ m	그만ㄱ흠
그만하다	k ɯ m a̠ n ɦ a̠ d a̠	그만하다
그물	k ɯ m u ɭ	그물
그믐	k ɯ m ɯ m	그믐
그믐날	k ɯ m ɯ m n a̠ ɭ	그믐날
그야말로	k ɯ j a̠ m a̠ ɭ ɭ o̞	그야말로
그윽하다	k ɯ ɯ kʰ a̠ d a̠	그으카다
그저	k ɯ d͡ʑ ʌ̹	그저
그저께	k ɯ d͡ʑ ʌ̹ k͈ e̞	그저께
그제	k ɯ d͡ʑ e̞	그제
그중	k ɯ d͡ʑ u ŋ	그중
그치다	k ɯ t͡ɕʰ i d a̠	그치다
그치만	k ɯ t͡ɕʰ i m a̠ n	그치만
그토록	k ɯ tʰ o̞ ɾ o̞ k̚	그토록
극단주의	k ɯ k̚ t͈ a̠ ɲ d͡ʑ u ɰ i	극딴주의
극동	k ɯ k̚ t͈ o̞ ŋ	극똥
극작가	k ɯ k̚ t͡ɕ͈ a̠ k̚ k͈ a̠	극짝까
극장	k ɯ k̚ t͡ɕ͈ a̠ ŋ	극짱
근교	k ɯː n ɡ j o	근교
근로자	k ɯː ɭ ɭ o̞ d͡ʑ a̠	글로자
근면	k ɯː n m j ʌ̹ n	근면
근무	k ɯː n m u	근무
근무하다	k ɯː n m u ɦ a̠ d a̠	근무하다
근본	k ɯ n b o̞ n	근본
근본적	k ɯ n b o̞ ɲ d͡ʑ ʌ̹ k̚	근본적
근삿값	k ɯː n sʰ a̠ t̚ k͈ a̠ p̚	근삳깝
근시	k ɯː n ɕʰ i	근시
근원	k ɯ n w ʌ̹ n	그눤
근육	k ɯ ɲ j u k̚	그뉵
근일점	k ɯː n i ʎ t͡ɕ͈ ʌ̹ m	그닐쩜
근접	k ɯː ɲ d͡ʑ ʌ̹ p̚	근접
근질근질하다	k ɯ ɲ d͡ʑ i ɭ ɡ ɯ ɲ d͡ʑ i ɾ ɦ a̠ d a̠	근질근질하다
근처	k ɯː ɲ t͡ɕʰ ʌ̹	근처
글꼴	k ɯ ɭ k͈ o̞ ɭ	글꼴
글라스	k ɯ ɭ ɭ a̠ sʰ ɯ	글라스
글라이더	k ɯ ɭ ɭ a̠ i d ʌ̹	글라이더
글루텐	k ɯ ɭ ɭ u tʰ e̞ n	글루텐
글리세롤	k ɯ ʎ ʎ i sʰ e̞ ɾ o̞ ɭ	글리세롤
글리세린	k ɯ ʎ ʎ i sʰ e̞ ɾ i n	글리세린
글쎄요	k ɯ ɭ s͈ e̞ j o	글쎄요
글쓰기	k ɯ ɭ s͈ ɯ ɡ i	글쓰기
글씨	k ɯ ɭ ɕ͈ i	글씨
글자	k ɯ ʎ t͡ɕ͈ a̠	글짜
글피	k ɯ ɭ pʰ i	글피
긁다	k ɯ k̚ t͈ a̠	극따
금고	k ɯ m ɡ o̞	금고
금메달	k ɯ m m e̞ d a̠ ɭ	금메달
금방	k ɯ m b a̠ ŋ	금방
금성	k ɯ m sʰ ʌ̹ ŋ	금성
금속	k ɯ m sʰ o̞ k̚	금속
금연	k ɯː m j ʌ̹ n	그면
금요일	k ɯ m j o i ɭ	그묘일
금융	k ɯ m ɲ j u ŋ	금늉
금일	k ɯ m i ɭ	그밀
금자탑	k ɯ m d͡ʑ a̠ tʰ a̠ p̚	금자탑
금전	k ɯ m d͡ʑ ʌ̹ n	금전
금지	k ɯː m d͡ʑ i	금지
급격	k ɯ p̚ k͈ j ʌ̹ k̚	급껵
급격하다	k ɯ p̚ k͈ j ʌ̹ kʰ a̠ d a̠	급껴카다
급기야	k ɯ p̚ k͈ i j a̠	급끼야
급료	k ɯ m ɲ j o	금뇨
급습	k ɯ p s͈ ɯ p̚	급씁
급여	k ɯ b j ʌ̹	그벼
급우	k ɯ b u	그부
급진주의	k ɯ p̚ t͡ɕ͈ i ɲ d͡ʑ u ɰ i	급찐주의
급하다	k ɯ pʰ a̠ d a̠	그파다
급히	k ɯ pʰ i	그피
긋다	k ɯː t̚ t͈ a̠	귿따
긍정적	k ɯː ŋ d͡ʑ ʌ̹ ŋ d͡ʑ ʌ̹ k̚	긍정적
기각	k i ɡ a̠ k̚	기각
기간	k i ɡ a̠ n	기간
기계	k i ɡ j e̞	기계
기계공	k i ɡ j e̞ ɡ o̞ ŋ	기계공
기공	k i ɡ o̞ ŋ	기공
기관	k i ɡ w a̠ n	기관
기관차	k i ɡ w a̠ ɲ t͡ɕʰ a̠	기관차
기관총	k i ɡ w a̠ ɲ t͡ɕʰ o̞ ŋ	기관총
기근	k i ɡ ɯ n	기근
기꺼이	k i k͈ ʌ̹ i	기꺼이
기녀	k iː ɲ j ʌ̹	기녀
기념관	k i ɲ j ʌ̹ m ɡ w a̠ n	기념관
기념물	k i ɲ j ʌ̹ m m u ɭ	기념물
기념일	k i ɲ j ʌ̹ m i ɭ	기녀밀
기념품	k i ɲ j ʌ̹ m pʰ u m	기념품
기능	k i n ɯ ŋ	기능
기니피그	k i n i pʰ i ɡ ɯ	기니피그
기도하다	k i d o̞ ɦ a̠ d a̠	기도하다
기독교	k i d o̞ k̚ k͈ j o	기독꾜
기독교도	k i d o̞ k̚ k͈ j o d o̞	기독꾜도
기라성	k i ɾ a̠ sʰ ʌ̹ ŋ	기라성
기러기	k i ɾ ʌ̹ ɡ i	기러기
기록	k i ɾ o̞ k̚	기록
기록하다	k i ɾ o̞ kʰ a̠ d a̠	기로카다
기르다	k i ɾ ɯ d a̠	기르다
기름	k i ɾ ɯ m	기름
기린	k i ɾ i n	기린
기린영양	k i ɾ i ɲ j ʌ̹ ŋ j a̠ ŋ	기리녀양
기마이	k i m a̠ i	기마이
기만하다	k i m a̠ n ɦ a̠ d a̠	기만하다
기모노	k i m o̞ n o̞	기모노
기물	k i m u ɭ	기물
기법	k i p͈ ʌ̹ p̚	기뻡
기병	k i b j ʌ̹ ŋ	기병
기본	k i b o̞ n	기본
기본적	k i b o̞ ɲ d͡ʑ ʌ̹ k̚	기본적
기뻐하다	k i p͈ ʌ̹ ɦ a̠ d a̠	기뻐하다
기쁘다	k i p͈ ɯ d a̠	기쁘다
기사	k i sʰ a̠	기사
기수사	k i sʰ u sʰ a̠	기수사
기수열외	k i sʰ u j ʌ̹ ɾ w e̞	기수여뢰
기숙사	k i sʰ u k s͈ a̠	기숙싸
기술	k i sʰ u ɭ	기술
기술자	k i sʰ u ʎ t͡ɕ͈ a̠	기술짜
기슭	k i sʰ ɯ k̚	기슥
기승위	k i sʰ ɯ ŋ ɥ i	기스위
기약	k i j a̠ k̚	기약
기억	k i ʌ̹ k̚	기억
기억나다	k i ʌ̹ ŋ n a̠ d a̠	기엉나다
기억력	k i ʌ̹ ŋ ɲ j ʌ̹ k̚	기엉녁
기억하다	k i ʌ̹ kʰ a̠ d a̠	기어카다
기업	k i ʌ̹ p̚	기업
기업가	k i ʌ̹ p̚ k͈ a̠	기업까
기업인	k i ʌ̹ b i n	기어빈
기여	k i j ʌ̹	기여
기여하다	k i j ʌ̹ ɦ a̠ d a̠	기여하다
기역	k i j ʌ̹ k̚	기역
기온	k i o̞ n	기온
기와	k i w a̠	기와
기운	k i u n	기운
기울다	k i u ɭ d a̠	기울다
기울이다	k i u ɾ i d a̠	기우리다
기원	k i w ʌ̹ n	기원
기원전	k i w ʌ̹ ɲ d͡ʑ ʌ̹ n	기원전
기윽	k i ɯ k̚	기윽
기입	k i i p̚	기입
기자	k i d͡ʑ a̠	기자
기저	k i d͡ʑ ʌ̹	기저
기절	k i d͡ʑ ʌ̹ ɭ	기절
기준	k i d͡ʑ u n	기준
기중기	k i d͡ʑ u ŋ ɡ i	기중기
기지	k i d͡ʑ i	기지
기차	k i t͡ɕʰ a̠	기차
기체	k i t͡ɕʰ e̞	기체
기총	k i t͡ɕʰ o̞ ŋ	기총
기치	k i t͡ɕʰ i	기치
기침	k i t͡ɕʰ i m	기침
기타	k i tʰ a̠	기타
기한	k i ɦ a̠ n	기한
기합	k i ɦ a̠ p̚	기합
기호	k i β o̞	기호
기회주의자	k i β w e̞ d͡ʑ u ɰ i d͡ʑ a̠	기회주의자
기후	k i β u	기후
긴꼬리꼬마쥐	k i n k͈ o̞ ɾ i k͈ o̞ m a̠ d͡ʑ ɥ i	긴꼬리꼬마쥐
긴장	k i ɲ d͡ʑ a̠ ŋ	긴장
긷다	k iː t̚ t͈ a̠	긷따
길가	k i ɭ ɡ a̠	길가
길거리	k i ɭ k͈ ʌ̹ ɾ i	길꺼리
길냥이	k iː ʎ ʎ j a̠ ŋ i	길랴이
길다	k iː ɭ d a̠	길다
길이	k i ɾ i	기리
김일성화	k i m i ɭ sʰ ʌ̹ ŋ β w a̠	기밀성화
김장	k i m d͡ʑ a̠ ŋ	김장
김정일화	k i m d͡ʑ ʌ̹ ŋ i ɾ β w a̠	김저일화
김치	k i m t͡ɕʰ i	김치
김치전	k i m t͡ɕʰ i d͡ʑ ʌ̹ n	김치전
깃발	k i t̚ p͈ a̠ ɭ	긷빨
깇다	k i t̚ t͈ a̠	긷따
깊다	k i p̚ t͈ a̠	깁따
깊이	k i pʰ i	기피
까닭	k͈ a̠ d a̠ k̚	까닥
까딸로그	k͈ a̠ t͈ a̠ ɭ ɭ o̞ ɡ ɯ	까딸로그
까마귀	k͈ a̠ m a̠ ɡ ɥ i	까마귀
까막눈	k͈ a̠ m a̠ ŋ n u n	까망눈
까맣다	k͈ a̠ː m a̠ tʰ a̠	까마타
까벨	k͈ a̠ b e̞ ɭ	까벨
까불다	k͈ a̠ b u ɭ d a̠	까불다
까지	k͈ a̠ d͡ʑ i	까지
까치	k͈ a̠ t͡ɕʰ i	까치
까치복	k͈ a̠ː t͡ɕʰ i b o̞ k̚	까치복
까히라	k͈ a̠ ʝ i ɾ a̠	까히라
깍두기	k͈ a̠ k̚ t͈ u ɡ i	깍뚜기
깎다	k͈ a̠ k̚ t͈ a̠	깍따
깔끔하다	k͈ a̠ ɭ k͈ ɯ m ɦ a̠ d a̠	깔끔하다
깔리다	k͈ a̠ ʎ ʎ i d a̠	깔리다
깜박	k͈ a̠ m b a̠ k̚	깜박
깜박깜박	k͈ a̠ m b a̠ k̚ k͈ a̠ m b a̠ k̚	깜박깜박
깜빡	k͈ a̠ m p͈ a̠ k̚	깜빡
깜빡깜빡	k͈ a̠ m p͈ a̠ k̚ k͈ a̠ m p͈ a̠ k̚	깜빡깜빡
깜작	k͈ a̠ m d͡ʑ a̠ k̚	깜작
깜짝	k͈ a̠ m t͡ɕ͈ a̠ k̚	깜짝
깡통	k͈ a̠ ŋ tʰ o̞ ŋ	깡통
깨지다	k͈ ɛː d͡ʑ i d a̠	깨지다
꺼리다	k͈ ɘː ɾ i d a̠	꺼리다
꺼지다	k͈ ʌ̹ d͡ʑ i d a̠	꺼지다
꺼풀	k͈ ʌ̹ pʰ u ɭ	꺼풀
꺽지	k͈ ʌ̹ k̚ t͡ɕ͈ i	꺽찌
꺾다	k͈ ʌ̹ k̚ t͈ a̠	꺽따
꺾어지다	k͈ ʌ̹ k͈ ʌ̹ d͡ʑ i d a̠	꺼꺼지다
껌벅껌벅	k͈ ʌ̹ m b ʌ̹ k̚ k͈ ʌ̹ m b ʌ̹ k̚	껌벅껌벅
껌뻑껌뻑	k͈ ʌ̹ m p͈ ʌ̹ k̚ k͈ ʌ̹ m p͈ ʌ̹ k̚	껌뻑껌뻑
껍질	k͈ ʌ̹ p̚ t͡ɕ͈ i ɭ	껍찔
께서	k͈ e̞ sʰ ʌ̹	께서
꼬르륵	k͈ o̞ ɾ ɯ ɾ ɯ k̚	꼬르륵
꼬르륵꼬르륵	k͈ o̞ ɾ ɯ ɾ ɯ k̚ k͈ o̞ ɾ ɯ ɾ ɯ k̚	꼬르륵꼬르륵
꼬리	k͈ o̞ ɾ i	꼬리
꼬리지느러미	k͈ o̞ ɾ i d͡ʑ i n ɯ ɾ ʌ̹ m i	꼬리지느러미
꼬리표	k͈ o̞ ɾ i pʰ j o	꼬리표
꼬마	k͈ o̞ m a̠	꼬마
꼬물꼬물	k͈ o̞ m u ɭ k͈ o̞ m u ɭ	꼬물꼬물
꼬치	k͈ o̞ t͡ɕʰ i	꼬치
꼬치구이	k͈ o̞ t͡ɕʰ i ɡ u i	꼬치구이
꼭두각시	k͈ o̞ k̚ t͈ u ɡ a̠ k ɕ͈ i	꼭뚜각씨
꼭지이응	k͈ o̞ k̚ t͡ɕ͈ i i ɯ ŋ	꼭찌이응
꼴꼴	k͈ o̞ ɭ k͈ o̞ ɭ	꼴꼴
꼼수	k͈ o̞ m sʰ u	꼼수
꼼실꼼실	k͈ o̞ m ɕʰ i ɭ k͈ o̞ m ɕʰ i ɭ	꼼실꼼실
꼼작꼼작	k͈ o̞ m d͡ʑ a̠ k̚ k͈ o̞ m d͡ʑ a̠ k̚	꼼작꼼작
꼼지락꼼지락	k͈ o̞ m d͡ʑ i ɾ a̠ k̚ k͈ o̞ m d͡ʑ i ɾ a̠ k̚	꼼지락꼼지락
꼼짝	k͈ o̞ m t͡ɕ͈ a̠ k̚	꼼짝
꼼트락꼼트락	k͈ o̞ m tʰ ɯ ɾ a̠ k̚ k͈ o̞ m tʰ ɯ ɾ a̠ k̚	꼼트락꼼트락
꽁무니	k͈ o̞ ŋ m u n i	꽁무니
꽁치	k͈ o̞ ŋ t͡ɕʰ i	꽁치
꽂다	k͈ o̞ t̚ t͈ a̠	꼳따
꽃가루	k͈ o̞ t̚ k͈ a̠ ɾ u	꼳까루
꽃꽂이	k͈ o̞ t̚ k͈ o̞ d͡ʑ i	꼳꼬지
꽃다발	k͈ o̞ t̚ t͈ a̠ b a̠ ɭ	꼳따발
꽃병	k͈ o̞ t̚ p͈ j ʌ̹ ŋ	꼳뼝
꽃봉오리	k͈ o̞ t̚ p͈ o̞ ŋ o̞ ɾ i	꼳뽀오리
꽃잎	k͈ o̞ n n i p̚	꼰닙
꽃집	k͈ o̞ t̚ t͡ɕ͈ i p̚	꼳찝
꽈리	k͈ w a̠ ɾ i	꽈리
꽈잘	k͈ w a̠ d͡ʑ a̠ ɭ	꽈잘
꾀꼬리	k͈ w e̞ k͈ o̞ ɾ i	꾀꼬리
꾀병	k͈ w e̞ b j ʌ̹ ŋ	꾀병
꾸러미	k͈ u ɾ ʌ̹ m i	꾸러미
꾸르륵	k͈ u ɾ ɯ ɾ ɯ k̚	꾸르륵
꾸리다	k͈ u ɾ i d a̠	꾸리다
꾸물꾸물	k͈ u m u ɭ k͈ u m u ɭ	꾸물꾸물
꾸짖다	k͈ u d͡ʑ i t̚ t͈ a̠	꾸짇따
꿀밤	k͈ u ɭ b a̠ m	꿀밤
꿀벌	k͈ u ɭ b ʌ̹ ɭ	꿀벌
꿈꾸다	k͈ u m k͈ u d a̠	꿈꾸다
꿈적	k͈ u m d͡ʑ ʌ̹ k̚	꿈적
꿈지럭꿈지럭	k͈ u m d͡ʑ i ɾ ʌ̹ k̚ k͈ u m d͡ʑ i ɾ ʌ̹ k̚	꿈지럭꿈지럭
꿈쩍	k͈ u m t͡ɕ͈ ʌ̹ k̚	꿈쩍
꿈쩍꿈쩍	k͈ u m t͡ɕ͈ ʌ̹ k̚ k͈ u m t͡ɕ͈ ʌ̹ k̚	꿈쩍꿈쩍
꿈틀	k͈ u m tʰ ɯ ɭ	꿈틀
끄집다	k͈ ɯː d͡ʑ i p̚ t͈ a̠	끄집따
끈기	k͈ ɯ n ɡ i	끈기
끊다	k͈ ɯ n tʰ a̠	끈타
끊임없이	k͈ ɯ n i m ʌ̹ p ɕ͈ i	끄니멉씨
끌신	k͈ ɯː ɭ ɕʰ i n	끌신
끌어안다	k͈ ɯː ɾ ʌ̹ a̠ n t͈ a̠	끄러안따
끓이다	k͈ ɯː ɾ i d a̠	끄리다
끔벅	k͈ ɯ m b ʌ̹ k̚	끔벅
끔벅끔벅	k͈ ɯ m b ʌ̹ k̚ k͈ ɯ m b ʌ̹ k̚	끔벅끔벅
끔뻑끔뻑	k͈ ɯ m p͈ ʌ̹ k̚ k͈ ɯ m p͈ ʌ̹ k̚	끔뻑끔뻑
끔적끔적	k͈ ɯ m d͡ʑ ʌ̹ k̚ k͈ ɯ m d͡ʑ ʌ̹ k̚	끔적끔적
끔쩍	k͈ ɯ m t͡ɕ͈ ʌ̹ k̚	끔쩍
끔찍하다	k͈ ɯ m t͡ɕ͈ i kʰ a̠ d a̠	끔찌카다
끝장	k͈ ɯ t̚ t͡ɕ͈ a̠ ŋ	끋짱
끼니	k͈ i n i	끼니
끼다	k͈ i d a̠	끼다
끼리	k͈ i ɾ i	끼리
끼우다	k͈ i u d a̠	끼우다
끼치다	k͈ i t͡ɕʰ i d a̠	끼치다
나가다	n a̠ ɡ a̠ d a̠	나가다
나나니	n a̠ n a̠ n i	나나니
나누다	n a̠ n u d a̠	나누다
나다	n a̠ d a̠	나다
나라	n a̠ ɾ a̠	나라
나라님	n a̠ ɾ a̠ n i m	나라님
나라말	n a̠ ɾ a̠ m a̠ ɭ	나라말
나란히	n a̠ ɾ a̠ n ʝ i	나란히
나랑	n a̠ ɾ a̠ ŋ	나랑
나름	n a̠ ɾ ɯ m	나름
나리	n a̠ ɾ i	나리
나머지	n a̠ m ʌ̹ d͡ʑ i	나머지
나무	n a̠ m u	나무
나물	n a̠ m u ɭ	나물
나뭇가지	n a̠ m u t̚ k͈ a̠ d͡ʑ i	나묻까지
나미비아	n a̠ m i b i a̠	나미비아
나방	n a̠ b a̠ ŋ	나방
나비	n a̠ b i	나비
나쁘다	n a̠ p͈ ɯ d a̠	나쁘다
나사	n a̠ sʰ a̠	나사
나서다	n a̠ sʰ ʌ̹ d a̠	나서다
나선형	n a̠ sʰ ʌ̹ n ʝ j ʌ̹ ŋ	나선형
나소	n a̠ sʰ o̞	나소
나시	n a̠ ɕʰ i	나시
나아가다	n a̠ a̠ ɡ a̠ d a̠	나아가다
나오다	n a̠ o̞ d a̠	나오다
나우루	n a̠ u ɾ u	나우루
나의	n a̠ ɰ i	나의
나이	n a̠ i	나이
나이로비	n a̠ i ɾ o̞ b i	나이로비
나이오븀	n a̠ i o̞ b j u m	나이오븀
나이지리아	n a̠ i d͡ʑ i ɾ i a̠	나이지리아
나이트	n a̠ i tʰ ɯ	나이트
나이프	n a̠ i pʰ ɯ	나이프
나일론	n a̠ i ɭ ɭ o̞ n	나일론
나일틸라피아	n a̠ i ɭ tʰ i ɭ ɭ a̠ pʰ i a̠	나일틸라피아
나중	n a̠ː d͡ʑ u ŋ	나중
나찰	n a̠ t͡ɕʰ a̠ ɭ	나찰
나치	n a̠ t͡ɕʰ i	나치
나치즘	n a̠ t͡ɕʰ i d͡ʑ ɯ m	나치즘
나침반	n a̠ t͡ɕʰ i m b a̠ n	나침반
나타나다	n a̠ tʰ a̠ n a̠ d a̠	나타나다
나트륨	n a̠ tʰ ɯ ɾ j u m	나트륨
나팔꽃	n a̠ pʰ a̠ ɭ k͈ o̞ t̚	나팔꼳
나포	n a̠ː pʰ o̞	나포
나폴리	n a̠ pʰ o̞ ʎ ʎ i	나폴리
나한	n a̠ ɦ a̠ n	나한
나홋카	n a̠ β o̞ t̚ kʰ a̠	나혿카
나환자	n a̠ː β w a̠ ɲ d͡ʑ a̠	나환자
나흘	n a̠ ɣ ɯ ɭ	나ɣㅡㄹ
낙동강	n a̠ k̚ t͈ o̞ ŋ ɡ a̠ ŋ	낙똥강
낙엽	n a̠ ɡ j ʌ̹ p̚	나겹
낙인	n a̠ ɡ i n	나긴
낙지	n a̠ k̚ t͡ɕ͈ i	낙찌
낙타	n a̠ k̚ tʰ a̠	낙타
낙하산	n a̠ kʰ a̠ sʰ a̠ n	나카산
낙하하다	n a̠ kʰ a̠ ɦ a̠ d a̠	나카하다
낚다	n a̠ k̚ t͈ a̠	낙따
낚시	n a̠ k ɕ͈ i	낙씨
낚시꾼	n a̠ k ɕ͈ i k͈ u n	낙씨꾼
낚시터	n a̠ k ɕ͈ i tʰ ʌ̹	낙씨터
난간	n a̠ n ɡ a̠ n	난간
난로	n a̠ː ɭ ɭ o̞	날로
난리	n a̠ː ʎ ʎ i	날리
난민	n a̠ n m i n	난민
난방	n a̠ n b a̠ ŋ	난방
난센스	n a̠ n sʰ e̞ n sʰ ɯ	난센스
난소	n a̠ n sʰ o̞	난소
난수	n a̠ n sʰ u	난수
난시	n a̠ː n ɕʰ i	난시
난자	n a̠ː ɲ d͡ʑ a̠	난자
난초	n a̠ ɲ t͡ɕʰ o̞	난초
난추니	n a̠ː ɲ t͡ɕʰ u n i	난추니
난치	n a̠ ɲ t͡ɕʰ i	난치
날것	n a̠ ɭ ɡ ʌ̹ t̚	날걷
날고기	n a̠ ɭ ɡ o̞ ɡ i	날고기
날다	n a̠ ɭ d a̠	날다
날리다	n a̠ ʎ ʎ i d a̠	날리다
날마다	n a̠ ɭ m a̠ d a̠	날마다
날아오르다	n a̠ ɾ a̠ o̞ ɾ ɯ d a̠	나라오르다
날짜	n a̠ ʎ t͡ɕ͈ a̠	날짜
날카롭다	n a̠ ɭ kʰ a̠ ɾ o̞ p̚ t͈ a̠	날카롭따
남극	n a̠ m ɡ ɯ k̚	남극
남녀	n a̠ m ɲ j ʌ̹	남녀
남녀노소	n a̠ m ɲ j ʌ̹ n o̞ sʰ o̞	남녀노소
남루	n a̠ː m n u	남누
남미	n a̠ m m i	남미
남반구	n a̠ː m b a̠ n ɡ u	남반구
남방	n a̠ m b a̠ ŋ	남방
남방동사리	n a̠ m b a̠ ŋ d o̞ ŋ sʰ a̠ ɾ i	남방동사리
남벌	n a̠ː m b ʌ̹ ɭ	남벌
남부	n a̠ m b u	남부
남빙양	n a̠ m b i ŋ ɲ j a̠ ŋ	남빙냥
남서부	n a̠ m sʰ ʌ̹ b u	남서부
남성	n a̠ m sʰ ʌ̹ ŋ	남성
남아메리카	n a̠ m a̠ m e̞ ɾ i kʰ a̠	나마메리카
남아프리카	n a̠ m a̠ pʰ ɯ ɾ i kʰ a̠	나마프리카
남용	n a̠ː m j o ŋ	나묭
남자답다	n a̠ m d͡ʑ a̠ d a̠ p̚ t͈ a̠	남자답따
남자아이	n a̠ m d͡ʑ a̠ a̠ i	남자아이
남작	n a̠ m d͡ʑ a̠ k̚	남작
남장	n a̠ m d͡ʑ a̠ ŋ	남장
남조선	n a̠ m d͡ʑ o̞ sʰ ʌ̹ n	남조선
남쪽	n a̠ m t͡ɕ͈ o̞ k̚	남쪽
남체	n a̠ m t͡ɕʰ e̞	남체
남초	n a̠ m t͡ɕʰ o̞	남초
남측	n a̠ m t͡ɕʰ ɯ k̚	남측
남편	n a̠ m pʰ j ʌ̹ n	남편
남포	n a̠ m pʰ o̞	남포
남프릭	n a̠ m pʰ ɯ ɾ i k̚	남프릭
남한	n a̠ m ɦ a̠ n	남한
납세자	n a̠ p s͈ e̞ d͡ʑ a̠	납쎄자
납작하다	n a̠ p̚ t͡ɕ͈ a̠ kʰ a̠ d a̠	납짜카다
납지리	n a̠ p̚ t͡ɕ͈ i ɾ i	납찌리
납치	n a̠ p̚ t͡ɕʰ i	납치
납품하다	n a̠ p̚ pʰ u m ɦ a̠ d a̠	납품하다
낫다	n a̠ː t̚ t͈ a̠	낟따
낭비	n a̠ː ŋ b i	낭비
낭인	n a̠ː ŋ i n	나인
낮다	n a̠ t̚ t͈ a̠	낟따
낮아지다	n a̠ d͡ʑ a̠ d͡ʑ i d a̠	나자지다
낮잠	n a̠ t̚ t͡ɕ͈ a̠ m	낟짬
낮추다	n a̠ t̚ t͡ɕʰ u d a̠	낟추다
낯가리다	n a̠ t̚ k͈ a̠ ɾ i d a̠	낟까리다
낯익다	n a̠ n n i k̚ t͈ a̠	난닉따
낱낱이	n a̠ː n n a̠ t͡ɕʰ i	난나치
낱말	n a̠ː n m a̠ ɭ	난말
낳다	n a̠ tʰ a̠	나타
내과	n ɛː k͈ w a̠	내꽈
내국인	n ɛː ɡ u ɡ i n	내구긴
내륙	n ɛː ɾ j u k̚	내륙
내몽고	n ɛː m o̞ ŋ ɡ o̞	내몽고
내밀다	n ɛː m i ɭ d a̠	내밀다
내부	n ɛː b u	내부
내심	n ɛː ɕʰ i m	내심
내야수	n ɛː j a̠ sʰ u	내야수
내외	n ɛː w e̞	내외
내용	n ɛː j o ŋ	내용
내장	n ɛː d͡ʑ a̠ ŋ	내장
내전	n ɛː d͡ʑ ʌ̹ n	내전
내주	n ɛː d͡ʑ u	내주
내주다	n ɛː d͡ʑ u d a̠	내주다
내측광근	n ɛː t͡ɕʰ ɯ k̚ k͈ w a̠ ŋ ɡ ɯ n	내측꽝근
내한	n ɛː ɦ a̠ n	내한
냉기	n ɛː ŋ ɡ i	냉기
냉동	n ɛː ŋ d o̞ ŋ	냉동
냉동고	n ɛː ŋ d o̞ ŋ ɡ o̞	냉동고
냉수	n ɛː ŋ sʰ u	냉수
냉장고	n ɛː ŋ d͡ʑ a̠ ŋ ɡ o̞	냉장고
냉전	n ɛː ŋ d͡ʑ ʌ̹ n	냉전
냠냠	ɲ j a̠ m ɲ j a̠ m	냠냠
너그럽다	n ʌ̹ ɡ ɯ ɾ ʌ̹ p̚ t͈ a̠	너그럽따
너나들이	n ʌ̹ n a̠ d ɯ ɾ i	너나드리
너네	n ʌ̹ n e̞	너네
너덧	n ʌ̹ d ʌ̹ t̚	너덛
너머	n ʌ̹ m ʌ̹	너머
너머로	n ʌ̹ m ʌ̹ ɾ o̞	너머로
너무	n ʌ̹ m u	너무
너무나	n ʌ̹ m u n a̠	너무나
너비아니	n ʌ̹ b i a̠ n i	너비아니
너트	n ʌ̹ tʰ ɯ	너트
너희	n ʌ̹ ʝ i	너히
널다	n ɘː ɭ d a̠	널다
널뛰기	n ʌ̹ ɭ t͈ ɥ i ɡ i	널뛰기
널리	n ʌ̹ ʎ ʎ i	널리
넓다	n ʌ̹ ɭ t͈ a̠	널따
넓이	n ʌ̹ ɭ b i	널비
넓적다리	n ʌ̹ p̚ t͡ɕ͈ ʌ̹ k̚ t͈ a̠ ɾ i	넙쩍따리
넘기다	n ʌ̹ m ɡ i d a̠	넘기다
넘다	n ɘː m t͈ a̠	넘따
넘실트리다	n ʌ̹ m ɕʰ i ɭ tʰ ɯ ɾ i d a̠	넘실트리다
넘치다	n ɘː m t͡ɕʰ i d a̠	넘치다
넙치	n ʌ̹ p̚ t͡ɕʰ i	넙치
넣다	n ɘː tʰ a̠	너타
네거리	n e̞ː ɡ ʌ̹ ɾ i	네거리
네다섯	n e̞ː d a̠ sʰ ʌ̹ t̚	네다섣
네모	n e̞ː m o̞	네모
네모꼴	n e̞ː m o̞ k͈ o̞ ɭ	네모꼴
네바다	n e̞ b a̠ d a̠	네바다
네오나치	n e̞ o̞ n a̠ t͡ɕʰ i	네오나치
네이멍구	n e̞ i m ʌ̹ ŋ ɡ u	네이멍구
네트워크	n e̞ tʰ ɯ w ʌ̹ k x ɯ	네트웍흐
네티즌	n e̞ tʰ i d͡ʑ ɯ n	네티즌
네피도	n e̞ pʰ i d o̞	네피도
넥타이	n e̞ k̚ tʰ a̠ i	넥타이
넵투늄	n e̞ p̚ tʰ u ɲ j u m	넵투늄
녀석	ɲ j ʌ̹ sʰ ʌ̹ k̚	녀석
녀성중음	ɲ j ʌ̹ sʰ ʌ̹ ŋ d͡ʑ u ŋ ɯ m	녀성주음
녀신	ɲ j ʌ̹ ɕʰ i n	녀신
녀인	ɲ j ʌ̹ i n	녀인
년도	ɲ j ʌ̹ n d o̞	년도
노고지리	n o̞ ɡ o̞ d͡ʑ i ɾ i	노고지리
노끈	n o̞ k͈ ɯ n	노끈
노네인	n o̞ n e̞ i n	노네인
노년	n o̞ː ɲ j ʌ̹ n	노년
노동	n o̞ d o̞ ŋ	노동
노동계급	n o̞ d o̞ ŋ ɡ j e̞ ɡ ɯ p̚	노동계급
노동법	n o̞ d o̞ ŋ p͈ ʌ̹ p̚	노동뻡
노동자	n o̞ d o̞ ŋ d͡ʑ a̠	노동자
노랑	n o̞ ɾ a̠ ŋ	노랑
노랗다	n o̞ː ɾ a̠ tʰ a̠	노라타
노려보다	n o̞ ɾ j ʌ̹ b o̞ d a̠	노려보다
노력	n o̞ ɾ j ʌ̹ k̚	노력
노력하다	n o̞ ɾ j ʌ̹ kʰ a̠ d a̠	노려카다
노루	n o̞ ɾ u	노루
노르마	n o̞ ɾ ɯ m a̠	노르마
노르웨이	n o̞ ɾ ɯ w e̞ i	노르웨이
노르웨이어	n o̞ ɾ ɯ w e̞ i ʌ̹	노르웨이어
노른자	n o̞ ɾ ɯ ɲ d͡ʑ a̠	노른자
노른자위	n o̞ ɾ ɯ ɲ d͡ʑ a̠ ɥ i	노른자위
노름	n o̞ ɾ ɯ m	노름
노리다	n o̞ ɾ i d a̠	노리다
노망	n o̞ː m a̠ ŋ	노망
노면	n o̞ m j ʌ̹ n	노면
노면전차	n o̞ m j ʌ̹ ɲ d͡ʑ ʌ̹ ɲ t͡ɕʰ a̠	노면전차
노병	n o̞ː b j ʌ̹ ŋ	노병
노보시비르스크	n o̞ b o̞ ɕʰ i b i ɾ ɯ sʰ ɯ k x ɯ	노보시비르슥흐
노사	n o̞ː sʰ a̠	노사
노서아	n o̞ sʰ ʌ̹ a̠	노서아
노선	n o̞ː sʰ ʌ̹ n	노선
노선도	n o̞ː sʰ ʌ̹ n d o̞	노선도
노쇠	n o̞ː sʰ w e̞	노쇠
노숙자	n o̞ sʰ u k̚ t͡ɕ͈ a̠	노숙짜
노아	n o̞ a̠	노아
노안	n o̞ː a̠ n	노안
노어	n o̞ ʌ̹	노어
노여움	n o̞ː j ʌ̹ u m	노여움
노엽다	n o̞ː j ʌ̹ p̚ t͈ a̠	노엽따
노예	n o̞ j e̞	노예
노워스티	n o̞ w ʌ̹ sʰ ɯ tʰ i	노워스티
노이로제	n o̞ i ɾ o̞ d͡ʑ e̞	노이로제
노인	n o̞ː i n	노인
노인학	n o̞ː i n ɦ a̠ k̚	노인학
노처녀	n o̞ː t͡ɕʰ ʌ̹ ɲ j ʌ̹	노처녀
노천	n o̞ t͡ɕʰ ʌ̹ n	노천
노크	n o̞ k x ɯ	녹흐
노트	n o̞ tʰ ɯ	노트
노트북	n o̞ tʰ ɯ b u k̚	노트북
노파	n o̞ː pʰ a̠	노파
노파심	n o̞ː pʰ a̠ ɕʰ i m	노파심
노환	n o̞ː β w a̠ n	노환
녹말	n o̞ ŋ m a̠ ɭ	농말
녹음	n o̞ ɡ ɯ m	노금
녹음기	n o̞ ɡ ɯ m ɡ i	노금기
녹음실	n o̞ ɡ ɯ m ɕʰ i ɭ	노금실
녹차	n o̞ k̚ t͡ɕʰ a̠	녹차
논다니	n o̞ː n d a̠ n i	논다니
논리	n o̞ ʎ ʎ i	놀리
논문	n o̞ n m u n	논문
논병아리	n o̞ n b j ʌ̹ ŋ a̠ ɾ i	논벼아리
논어	n o̞ n ʌ̹	노너
논의	n o̞ n ɰ i	노늬
논의하다	n o̞ n ɰ i ɦ a̠ d a̠	노늬하다
논평	n o̞ n pʰ j ʌ̹ ŋ	논평
논하다	n o̞ n ɦ a̠ d a̠	논하다
놀라움	n o̞ː ɭ ɭ a̠ u m	놀라움
놀랍다	n o̞ː ɭ ɭ a̠ p̚ t͈ a̠	놀랍따
놀이	n o̞ ɾ i	노리
놀이감	n o̞ ɾ i ɡ a̠ m	노리감
놀이터	n o̞ ɾ i tʰ ʌ̹	노리터
농경	n o̞ ŋ ɡ j ʌ̹ ŋ	농경
농구	n o̞ ŋ ɡ u	농구
농민	n o̞ ŋ m i n	농민
농부	n o̞ ŋ b u	농부
농사	n o̞ ŋ sʰ a̠	농사
농산물	n o̞ ŋ sʰ a̠ n m u ɭ	농산물
농어	n o̞ ŋ ʌ̹	노어
농업	n o̞ ŋ ʌ̹ p̚	노업
농장	n o̞ ŋ d͡ʑ a̠ ŋ	농장
농촌	n o̞ ŋ t͡ɕʰ o̞ n	농촌
높다	n o̞ p̚ t͈ a̠	놉따
높이	n o̞ pʰ i	노피
높이다	n o̞ pʰ i d a̠	노피다
놓다	n o̞ tʰ a̠	노타
놓이다	n o̞ i d a̠	노이다
뇌관	n w e̞ ɡ w a̠ n	뇌관
뇌물	n w e̞ m u ɭ	뇌물
뇌우	n w e̞ u	뇌우
뇌피셜	n w e̞ pʰ i ɕʰ ʌ̹ ɭ	뇌피설
누계	n uː ɡ j e̞	누계
누구	n u ɡ u	누구
누구세요	n u ɡ u sʰ e̞ j o	누구세요
누군가	n u ɡ u n ɡ a̠	누군가
누나	n uː n a̠	누나
누님	n u n i m	누님
누두	n uː d u	누두
누들	n u d ɯ ɭ	누들
누르다	n uː ɾ ɯ d a̠	누르다
누리	n u ɾ i	누리
누리꾼	n u ɾ i k͈ u n	누리꾼
누리집	n u ɾ i d͡ʑ i p̚	누리집
누설	n uː sʰ ʌ̹ ɭ	누설
누악쇼트	n u a̠ k ɕ͈ o tʰ ɯ	누악쑈트
누에	n u e̞	누에
누이	n u i	누이
누적	n uː d͡ʑ ʌ̹ k̚	누적
누치	n u t͡ɕʰ i	누치
눈곱	n u n k͈ o̞ p̚	눈꼽
눈길	n u n k͈ i ɭ	눈낄
눈꺼풀	n u n k͈ ʌ̹ pʰ u ɭ	눈꺼풀
눈꼴사납다	n u n k͈ o̞ ɭ sʰ a̠ n a̠ p̚ t͈ a̠	눈꼴사납따
눈꽃	n uː n k͈ o̞ t̚	눈꼳
눈다랑어	n u n d a̠ ɾ a̠ ŋ ʌ̹	눈다라어
눈물	n u n m u ɭ	눈물
눈보라	n u n b o̞ ɾ a̠	눈보라
눈빛	n u n p͈ i t̚	눈삗
눈사람	n uː n s͈ a̠ ɾ a̠ m	눈싸람
눈송이	n uː n s͈ o̞ ŋ i	눈쏘이
눈앞	n u n a̠ p̚	누납
눈엣가시	n u n e̞ t̚ k͈ a̠ ɕʰ i	누넫까시
눈웃음	n u n u sʰ ɯ m	누누슴
뉴델리	ɲ j u d e̞ ʎ ʎ i	뉴델리
뉴런	ɲ j u ɾ ʌ̹ n	뉴런
뉴스	ɲ j u s͈ ɯ	뉴쓰
뉴욕	ɲ j u j o k̚	뉴욕
뉴트리아	ɲ j u tʰ ɯ ɾ i a̠	뉴트리아
느끼다	n ɯ k͈ i d a̠	느끼다
느낌	n ɯ k͈ i m	느낌
느리다	n ɯ ɾ i d a̠	느리다
는다	n ɯ n d a̠	는다
는데	n ɯ n d e̞	는데
는지	n ɯ ɲ d͡ʑ i	는지
늘리다	n ɯ ʎ ʎ i d a̠	늘리다
늘어나다	n ɯ ɾ ʌ̹ n a̠ d a̠	느러나다
늙다	n ɯ k̚ t͈ a̠	늑따
능가	n ɯ ŋ ɡ a̠	능가
능력	n ɯ ŋ ɲ j ʌ̹ k̚	능녁
능률	n ɯ ŋ ɲ j u ɭ	능뉼
능하다	n ɯ ŋ ɦ a̠ d a̠	능하다
능히	n ɯ ŋ ʝ i	능히
늦가을	n ɯ t̚ k͈ a̠ ɯ ɭ	늗까을
늦다	n ɯ t̚ t͈ a̠	늗따
늦잠	n ɯ t̚ t͡ɕ͈ a̠ m	늗짬
니은	n i ɯ n	니은
니제르	n i d͡ʑ e̞ ɾ ɯ	니제르
니카라과	n i kʰ a̠ ɾ a̠ ɡ w a̠	니카라과
니켈	n i kʰ e̞ ɭ	니켈
니코틴	n i kʰ o̞ tʰ i n	니코틴
니트릴	n i tʰ ɯ ɾ i ɭ	니트릴
니호늄	n i β o̞ ɲ j u m	니호늄
닉네임	n i ŋ n e̞ i m	닝네임
닌자	n i ɲ d͡ʑ a̠	닌자
닝샤	n i ŋ ɕʰ a̠	닝사
다가오다	t a̠ ɡ a̠ o̞ d a̠	다가오다
다과	t a̠ ɡ w a̠	다과
다니다	t a̠ n i d a̠	다니다
다다미	t a̠ d a̠ m i	다다미
다들	t a̠ d ɯ ɭ	다들
다듬다	t a̠ d ɯ m t͈ a̠	다듬따
다락	t a̠ ɾ a̠ k̚	다락
다락방	t a̠ ɾ a̠ k̚ p͈ a̠ ŋ	다락빵
다람쥐	t a̠ ɾ a̠ m d͡ʑ ɥ i	다람쥐
다랗다	t a̠ ɾ a̠ tʰ a̠	다라타
다롄	t a̠ ɾ j e̞ n	다롄
다루다	t a̠ ɾ u d a̠	다루다
다르다	t a̠ ɾ ɯ d a̠	다르다
다른	t a̠ ɾ ɯ n	다른
다리	t a̠ ɾ i	다리
다리미	t a̠ ɾ i m i	다리미
다림질	t a̠ ɾ i m d͡ʑ i ɭ	다림질
다마네기	t a̠ m a̠ n e̞ ɡ i	다마네기
다마스쿠스	t a̠ m a̠ sʰ ɯ kʰ u sʰ ɯ	다마스쿠스
다만	t a̠ː m a̠ n	다만
다문화	t a̠ m u n β w a̠	다문화
다발	t a̠ b a̠ ɭ	다발
다부지다	t a̠ b u d͡ʑ i d a̠	다부지다
다섯	t a̠ sʰ ʌ̹ t̚	다섣
다소	t a̠ sʰ o̞	다소
다수	t a̠ sʰ u	다수
다스	t a̠ sʰ ɯ	다스
다시	t a̠ ɕʰ i	다시
다양	t a̠ j a̠ ŋ	다양
다양하다	t a̠ j a̠ ŋ ɦ a̠ d a̠	다양하다
다엽	t a̠ j ʌ̹ p̚	다엽
다운로드	t a̠ u n n o̞ d ɯ	다운노드
다윗	t a̠ ɥ i t̚	다윋
다이아몬드	t a̠ i a̠ m o̞ n d ɯ	다이아몬드
다이어트	t a̠ i ʌ̹ tʰ ɯ	다이어트
다이오드	t a̠ i o̞ d ɯ	다이오드
다정하다	t a̠ d͡ʑ ʌ̹ ŋ ɦ a̠ d a̠	다정하다
다정히	t a̠ d͡ʑ ʌ̹ ŋ ʝ i	다정히
다지다	t a̠ d͡ʑ i d a̠	다지다
다짐	t a̠ d͡ʑ i m	다짐
다치다	t a̠ t͡ɕʰ i d a̠	다치다
다카	t a̠ kʰ a̠	다카
다크서클	t a̠ k x ɯ s͈ ʌ̹ k x ɯ ɭ	닥흐썩흘
다투다	t a̠ tʰ u d a̠	다투다
다툼	t a̠ tʰ u m	다툼
닥나무	t a̠ ŋ n a̠ m u	당나무
닦다	t a̠ k̚ t͈ a̠	닥따
단계	t a̠ n ɡ j e̞	단계
단고기	t a̠ n ɡ o̞ ɡ i	단고기
단골	t a̠ n ɡ o̞ ɭ	단골
단념	t a̠ː n ɲ j ʌ̹ m	단념
단념하다	t a̠ː n ɲ j ʌ̹ m ɦ a̠ d a̠	단념하다
단단하다	t a̠ n d a̠ n ɦ a̠ d a̠	단단하다
단락	t a̠ ɭ ɭ a̠ k̚	달락
단수	t a̠ n sʰ u	단수
단순	t a̠ n sʰ u n	단순
단순하다	t a̠ n sʰ u n ɦ a̠ d a̠	단순하다
단순히	t a̠ n sʰ u n ʝ i	단순히
단어	t a̠ n ʌ̹	다너
단위	t a̠ n ɥ i	다뉘
단일	t a̠ n i ɭ	다닐
단자	t a̠ ɲ d͡ʑ a̠	단자
단지	t a̠ ɲ d͡ʑ i	단지
단천	t a̠ ɲ t͡ɕʰ ʌ̹ n	단천
단풍	t a̠ n pʰ u ŋ	단풍
단풍국	t a̠ n pʰ u ŋ ɡ u k̚	단풍국
달걀	t a̠ ɭ ɡ j a̠ ɭ	달걀
달구다	t a̠ ɭ ɡ u d a̠	달구다
달려가다	t a̠ ʎ ʎ j ʌ̹ ɡ a̠ d a̠	달려가다
달력	t a̠ ʎ ʎ j ʌ̹ k̚	달력
달리	t a̠ ʎ ʎ i	달리
달리다	t a̠ ʎ ʎ i d a̠	달리다
달마다	t a̠ ɭ m a̠ d a̠	달마다
달맞이	t a̠ ɭ m a̠ d͡ʑ i	달마지
달비	t a̠ ɭ b i	달비
달빛	t a̠ ɭ p͈ i t̚	달삗
달성	t a̠ ɭ s͈ ʌ̹ ŋ	달썽
달아나다	t a̠ ɾ a̠ n a̠ d a̠	다라나다
달인	t a̠ ɾ i n	다린
달콤하다	t a̠ ɭ kʰ o̞ m ɦ a̠ d a̠	달콤하다
닭고기	t a̠ k̚ k͈ o̞ ɡ i	닥꼬기
닭발	t a̠ k̚ p͈ a̠ ɭ	닥빨
닭살	t a̠ k s͈ a̠ ɭ	닥쌀
닳다	t a̠ ɭ tʰ a̠	달타
담다	t a̠ː m t͈ a̠	담따
담담하다	t a̠ m d a̠ m ɦ a̠ d a̠	담담하다
담당	t a̠ m d a̠ ŋ	담당
담당하다	t a̠ m d a̠ ŋ ɦ a̠ d a̠	담당하다
담벼락	t a̠ m p͈ j ʌ̹ ɾ a̠ k̚	담뼈락
담요	t a̠ː m ɲ j o	담뇨
담임	t a̠ m i m	다밈
답다	t a̠ p̚ t͈ a̠	답따
답답하다	t a̠ p̚ t͈ a̠ pʰ a̠ d a̠	답따파다
답변	t a̠ p̚ p͈ j ʌ̹ n	답뼌
답사	t a̠ p s͈ a̠	답싸
답습	t a̠ p s͈ ɯ p̚	답씁
답장	t a̠ p̚ t͡ɕ͈ a̠ ŋ	답짱
답정너	t a̠ p̚ t͡ɕ͈ ʌ̹ ŋ n ʌ̹	답쩡너
당구	t a̠ ŋ ɡ u	당구
당국	t a̠ ŋ ɡ u k̚	당국
당근	t a̠ ŋ ɡ ɯ n	당근
당나귀	t a̠ ŋ n a̠ ɡ ɥ i	당나귀
당뇨병	t a̠ ŋ ɲ j o p͈ j ʌ̹ ŋ	당뇨뼝
당당하다	t a̠ ŋ d a̠ ŋ ɦ a̠ d a̠	당당하다
당류	t a̠ ŋ ɲ j u	당뉴
당면	t a̠ ŋ m j ʌ̹ n	당면
당시	t a̠ ŋ ɕʰ i	당시
당연	t a̠ ŋ j ʌ̹ n	다연
당연하다	t a̠ ŋ j ʌ̹ n ɦ a̠ d a̠	다연하다
당연히	t a̠ ŋ j ʌ̹ n ʝ i	다연히
당중앙	t a̠ ŋ d͡ʑ u ŋ a̠ ŋ	당주앙
당질	t a̠ ŋ d͡ʑ i ɭ	당질
당황	t a̠ ŋ β w a̠ ŋ	당황
닿다	t a̠ː tʰ a̠	다타
대검집	t ɛː ɡ ʌ̹ m d͡ʑ i p̚	대검집
대관령	t ɛː ɡ w a̠ ʎ ʎ j ʌ̹ ŋ	대괄령
대국	t ɛː ɡ u k̚	대국
대궐	t ɛː ɡ w ʌ̹ ɭ	대궐
대규모	t ɛː ɡ j u m o̞	대규모
대기	t ɛː ɡ i	대기
대기실	t ɛː ɡ i ɕʰ i ɭ	대기실
대기업	t ɛː ɡ i ʌ̹ p̚	대기업
대기하다	t ɛː ɡ i ɦ a̠ d a̠	대기하다
대다	t ɛː d a̠	대다
대단하다	t ɛː d a̠ n ɦ a̠ d a̠	대단하다
대단히	t ɛː d a̠ n ʝ i	대단히
대답	t ɛː d a̠ p̚	대답
대동강	t ɛː d o̞ ŋ ɡ a̠ ŋ	대동강
대두	t ɛː d u	대두
대략	t ɛː ɾ j a̠ k̚	대략
대량	t ɛː ɾ j a̠ ŋ	대량
대령	t ɛː ɾ j ʌ̹ ŋ	대령
대륙	t ɛː ɾ j u k̚	대륙
대리석	t ɛː ɾ i sʰ ʌ̹ k̚	대리석
대리인	t ɛː ɾ i i n	대리인
대리점	t ɛː ɾ i d͡ʑ ʌ̹ m	대리점
대마	t ɛː m a̠	대마
대명사	t ɛː m j ʌ̹ ŋ sʰ a̠	대명사
대모	t ɛː m o̞	대모
대문	t ɛː m u n	대문
대박	t ɛː b a̠ k̚	대박
대변	t ɛː b j ʌ̹ n	대변
대보름	t ɛː b o̞ ɾ ɯ m	대보름
대부분	t ɛː b u b u n	대부분
대비하다	t ɛː b i ɦ a̠ d a̠	대비하다
대사	t ɛː sʰ a̠	대사
대사관	t ɛː sʰ a̠ ɡ w a̠ n	대사관
대상	t ɛː sʰ a̠ ŋ	대상
대서양	t ɛː sʰ ʌ̹ j a̠ ŋ	대서양
대성당	t ɛː sʰ ʌ̹ ŋ d a̠ ŋ	대성당
대수	t ɛː sʰ u	대수
대신	t ɛː ɕʰ i n	대신
대양	t ɛː j a̠ ŋ	대양
대여섯	t ɛː j ʌ̹ sʰ ʌ̹ t̚	대여섣
대역죄	t ɛː j ʌ̹ k̚ t͡ɕ͈ w e̞	대역쬐
대영제국	t ɛː j ʌ̹ ŋ d͡ʑ e̞ ɡ u k̚	대영제국
대우	t ɛː u	대우
대원수	t ɛː w ʌ̹ n sʰ u	대원수
대위	t ɛː ɥ i	대위
대응	t ɛː ɯ ŋ	대응
대자보	t ɛː d͡ʑ a̠ b o̞	대자보
대작자	t ɛː d͡ʑ a̠ k̚ t͡ɕ͈ a̠	대작짜
대장	t ɛː d͡ʑ a̠ ŋ	대장
대전	t ɛː d͡ʑ ʌ̹ n	대전
대접	t ɛː d͡ʑ ʌ̹ p̚	대접
대접하다	t ɛː d͡ʑ ʌ̹ pʰ a̠ d a̠	대저파다
대주교	t ɛː d͡ʑ u ɡ j o	대주교
대중	t ɛː d͡ʑ u ŋ	대중
대중교통	t ɛː d͡ʑ u ŋ ɡ j o tʰ o̞ ŋ	대중교통
대중문화	t ɛː d͡ʑ u ŋ m u n β w a̠	대중문화
대중음악	t ɛː d͡ʑ u ŋ ɯ m a̠ k̚	대주으막
대지	t ɛː d͡ʑ i	대지
대체로	t ɛː t͡ɕʰ e̞ ɾ o̞	대체로
대출	t ɛː t͡ɕʰ u ɭ	대출
대충	t ɛː t͡ɕʰ u ŋ	대충
대치	t ɛː t͡ɕʰ i	대치
대퇴	t ɛː tʰ w e̞	대퇴
대포	t ɛː pʰ o̞	대포
대폭적	t ɛː pʰ o̞ k̚ t͡ɕ͈ ʌ̹ k̚	대폭쩍
대표	t ɛː pʰ j o	대표
대표단	t ɛː pʰ j o d a̠ n	대표단
대표적	t ɛː pʰ j o d͡ʑ ʌ̹ k̚	대표적
대학	t ɛː ɦ a̠ k̚	대학
대학교	t ɛː ɦ a̠ k̚ k͈ j o	대학꾜
대학수학능력시험	t ɛː ɦ a̠ k s͈ u ɦ a̠ ŋ n ɯ ŋ ɲ j ʌ̹ k ɕ͈ i ɦ ʌ̹ m	대학쑤항능녁씨험
대학원	t ɛː ɦ a̠ ɡ w ʌ̹ n	대하권
대한민국	t ɛː ɦ a̠ n m i n ɡ u k̚	대한민국
대한제국	t ɛː ɦ a̠ ɲ d͡ʑ e̞ ɡ u k̚	대한제국
대합실	t ɛː ɦ a̠ p ɕ͈ i ɭ	대합씰
대회	t ɛː β w e̞	대회
더듬다	t ʌ̹ d ɯ m t͈ a̠	더듬따
더듬이	t ʌ̹ d ɯ m i	더드미
더러워지다	t ɘː ɾ ʌ̹ w ʌ̹ d͡ʑ i d a̠	더러워지다
더럽다	t ɘː ɾ ʌ̹ p̚ t͈ a̠	더럽따
더미	t ʌ̹ m i	더미
더불다	t ʌ̹ b u ɭ d a̠	더불다
더불어	t ʌ̹ b u ɾ ʌ̹	더부러
더블린	t ʌ̹ b ɯ ʎ ʎ i n	더블린
더빙	t ʌ̹ b i ŋ	더빙
더욱	t ʌ̹ u k̚	더욱
더욱이	t ʌ̹ u ɡ i	더우기
더위	t ʌ̹ ɥ i	더위
더위팔기	t ʌ̹ ɥ i pʰ a̠ ɭ ɡ i	더위팔기
더하기	t ʌ̹ ɦ a̠ ɡ i	더하기
더하다	t ʌ̹ ɦ a̠ d a̠	더하다
덕분	t ʌ̹ k̚ p͈ u n	덕뿐
덕트	t ʌ̹ k̚ tʰ ɯ	덕트
던데	t ʌ̹ n d e̞	던데
던지다	t ʌ̹ ɲ d͡ʑ i d a̠	던지다
던지럽다	t ɘː ɲ d͡ʑ i ɾ ʌ̹ p̚ t͈ a̠	던지럽따
덧글	t ʌ̹ t̚ k͈ ɯ ɭ	덛끌
덧머리	t ʌ̹ n m ʌ̹ ɾ i	던머리
덩어리	t ʌ̹ ŋ ʌ̹ ɾ i	더어리
덮이다	t ʌ̹ pʰ i d a̠	더피다
데릴사위	t e̞ ɾ i ɭ s͈ a̠ ɥ i	데릴싸위
데모	t e̞ m o̞	데모
데이터	t e̞ i tʰ ʌ̹	데이터
데이터베이스	t e̞ i tʰ ʌ̹ b e̞ i sʰ ɯ	데이터베이스
데이트	t e̞ i tʰ ɯ	데이트
덴마크	t e̞ n m a̠ k x ɯ	덴막흐
덴마크어	t e̞ n m a̠ k x ɯ ʌ̹	덴막흐어
덴뿌라	t e̞ n p͈ u ɾ a̠	덴뿌라
델리	t e̞ ʎ ʎ i	델리
도가니	t o̞ ɡ a̠ n i	도가니
도교	t o̞ː ɡ j o	도교
도구	t o̞ː ɡ u	도구
도금	t o̞ː ɡ ɯ m	도금
도기	t o̞ ɡ i	도기
도꾜	t o̞ k͈ j o	도꾜
도끼	t o̞ k͈ i	도끼
도난	t o̞ n a̠ n	도난
도넛	t o̞ n ʌ̹ t̚	도넏
도다리	t o̞ d a̠ ɾ i	도다리
도달	t o̞ː d a̠ ɭ	도달
도달하다	t o̞ː d a̠ ɾ ɦ a̠ d a̠	도달하다
도덕	t o̞ː d ʌ̹ k̚	도덕
도도마	t o̞ d o̞ m a̠	도도마
도둑	t o̞ d u k̚	도둑
도랑	t o̞ ɾ a̠ ŋ	도랑
도로	t o̞ː ɾ o̞	도로
도료	t o̞ ɾ j o	도료
도루	t o̞ ɾ u	도루
도륙	t o̞ ɾ j u k̚	도륙
도리어	t o̞ ɾ i ʌ̹	도리어
도망	t o̞ m a̠ ŋ	도망
도망치다	t o̞ m a̠ ŋ t͡ɕʰ i d a̠	도망치다
도메인	t o̞ m e̞ i n	도메인
도모	t o̞ m o̞	도모
도모하다	t o̞ m o̞ ɦ a̠ d a̠	도모하다
도미니카	t o̞ m i n i kʰ a̠	도미니카
도박	t o̞ b a̠ k̚	도박
도벽	t o̞ b j ʌ̹ k̚	도벽
도시	t o̞ ɕʰ i	도시
도시락	t o̞ ɕʰ i ɾ a̠ k̚	도시락
도예	t o̞ j e̞	도예
도우미	t o̞ u m i	도우미
도움	t o̞ u m	도움
도입	t o̞ː i p̚	도입
도입부	t o̞ i p̚ p͈ u	도입뿌
도자기	t o̞ d͡ʑ a̠ ɡ i	도자기
도작	t o̞ d͡ʑ a̠ k̚	도작
도장	t o̞ d͡ʑ a̠ ŋ	도장
도저히	t o̞ː d͡ʑ ʌ̹ ʝ i	도저히
도적	t o̞ d͡ʑ ʌ̹ k̚	도적
도전	t o̞ d͡ʑ ʌ̹ n	도전
도청	t o̞ː t͡ɕʰ ʌ̹ ŋ	도청
도청기	t o̞ t͡ɕʰ ʌ̹ ŋ ɡ i	도청기
도체	t o̞ː t͡ɕʰ e̞	도체
도파민	t o̞ pʰ a̠ m i n	도파민
도표	t o̞ pʰ j o	도표
도하	t o̞ ɦ a̠	도하
도회인	t o̞ β w e̞ i n	도회인
독감	t o̞ k̚ k͈ a̠ m	독깜
독극물	t o̞ k̚ k͈ ɯ ŋ m u ɭ	독끙물
독도	t o̞ k̚ t͈ o̞	독또
독립	t o̞ ŋ n i p̚	동닙
독립성	t o̞ ŋ n i p s͈ ʌ̹ ŋ	동닙썽
독물	t o̞ ŋ m u ɭ	동물
독방	t o̞ k̚ p͈ a̠ ŋ	독빵
독사	t o̞ k s͈ a̠	독싸
독살	t o̞ k s͈ a̠ ɭ	독쌀
독서	t o̞ k s͈ ʌ̹	독써
독서실	t o̞ k s͈ ʌ̹ ɕʰ i ɭ	독써실
독소	t o̞ k s͈ o̞	독쏘
독수리	t o̞ k s͈ u ɾ i	독쑤리
독신	t o̞ k ɕ͈ i n	독씬
독신자	t o̞ k ɕ͈ i ɲ d͡ʑ a̠	독씬자
독음	t o̞ ɡ ɯ m	도금
독일	t o̞ ɡ i ɭ	도길
독일어	t o̞ ɡ i ɾ ʌ̹	도기러
독자	t o̞ k̚ t͡ɕ͈ a̠	독짜
독점	t o̞ k̚ t͡ɕ͈ ʌ̹ m	독쩜
독주	t o̞ k̚ t͡ɕ͈ u	독쭈
독특하다	t o̞ k̚ tʰ ɯ kʰ a̠ d a̠	독트카다
돋다	t o̞ t̚ t͈ a̠	돋따
돋보기	t o̞ t̚ p͈ o̞ ɡ i	돋뽀기
돌격	t o̞ ɭ ɡ j ʌ̹ k̚	돌격
돌고기	t o̞ ɭ ɡ o̞ ɡ i	돌고기
돌돔	t o̞ː ɭ d o̞ m	돌돔
돌드	t o̞ ɭ d ɯ	돌드
돌리다	t o̞ ʎ ʎ i d a̠	돌리다
돌멩이	t o̞ː ɭ m e̞ ŋ i	돌메이
돌보다	t o̞ː ɭ b o̞ d a̠	돌보다
돌상어	t o̞ ɭ sʰ a̠ ŋ ʌ̹	돌사어
돌솥	t o̞ː ɭ sʰ o̞ t̚	돌솓
돌아가다	t o̞ ɾ a̠ ɡ a̠ d a̠	도라가다
돌아가시다	t o̞ ɾ a̠ ɡ a̠ ɕʰ i d a̠	도라가시다
돌아오다	t o̞ ɾ a̠ o̞ d a̠	도라오다
돌연	t o̞ ɾ j ʌ̹ n	도련
돌연변이	t o̞ ɾ j ʌ̹ n b j ʌ̹ n i	도련벼니
돌잡이	t o̞ ʎ d͡ʑ a̠ b i	돌자비
돌팔이	t o̞ː ɭ pʰ a̠ ɾ i	돌파리
돌하르방	t o̞ː ɾ ɦ a̠ ɾ ɯ b a̠ ŋ	돌하르방
돕다	t o̞ː p̚ t͈ a̠	돕따
돗자리	t o̞ t̚ t͡ɕ͈ a̠ ɾ i	돋짜리
동갑	t o̞ ŋ ɡ a̠ p̚	동갑
동거	t o̞ ŋ ɡ ʌ̹	동거
동거인	t o̞ ŋ ɡ ʌ̹ i n	동거인
동경	t o̞ ŋ ɡ j ʌ̹ ŋ	동경
동공	t o̞ː ŋ ɡ o̞ ŋ	동공
동그라미	t o̞ ŋ ɡ ɯ ɾ a̠ m i	동그라미
동글	t o̞ ŋ ɡ ɯ ɭ	동글
동글다	t o̞ ŋ ɡ ɯ ɭ d a̠	동글다
동기	t o̞ ŋ ɡ i	동기
동남아시아	t o̞ ŋ n a̠ m a̠ ɕʰ i a̠	동나마시아
동네	t o̞ː ŋ n e̞	동네
동력	t o̞ː ŋ ɲ j ʌ̹ k̚	동녁
동료	t o̞ ŋ ɲ j o	동뇨
동무	t o̞ ŋ m u	동무
동문서답	t o̞ ŋ m u n sʰ ʌ̹ d a̠ p̚	동문서답
동물	t o̞ː ŋ m u ɭ	동물
동물학	t o̞ː ŋ m u ɾ ɦ a̠ k̚	동물학
동반자	t o̞ ŋ b a̠ ɲ d͡ʑ a̠	동반자
동부	t o̞ ŋ b u	동부
동사리	t o̞ ŋ sʰ a̠ ɾ i	동사리
동산	t o̞ ŋ sʰ a̠ n	동산
동성	t o̞ ŋ sʰ ʌ̹ ŋ	동성
동시	t o̞ ŋ ɕʰ i	동시
동아리	t o̞ ŋ a̠ ɾ i	도아리
동안	t o̞ ŋ a̠ n	도안
동양	t o̞ ŋ j a̠ ŋ	도양
동업자	t o̞ ŋ ʌ̹ p̚ t͡ɕ͈ a̠	도업짜
동의	t o̞ ŋ ɰ i	도의
동의어	t o̞ ŋ ɰ i ʌ̹	도의어
동일하다	t o̞ ŋ i ɾ ɦ a̠ d a̠	도일하다
동작	t o̞ː ŋ d͡ʑ a̠ k̚	동작
동전	t o̞ ŋ d͡ʑ ʌ̹ n	동전
동정	t o̞ ŋ d͡ʑ ʌ̹ ŋ	동정
동지	t o̞ ŋ d͡ʑ i	동지
동쪽	t o̞ ŋ t͡ɕ͈ o̞ k̚	동쪽
동창	t o̞ ŋ t͡ɕʰ a̠ ŋ	동창
동포	t o̞ ŋ pʰ o̞	동포
동호회	t o̞ ŋ β o̞ β w e̞	동호회
동화	t o̞ː ŋ β w a̠	동화
돼지	t w ɛː d͡ʑ i	돼지
돼지꿈	t w ɛː d͡ʑ i k͈ u m	돼지꿈
되게	t w e̞ː ɡ e̞	되게
되놈	t w e̞ n o̞ m	되놈
되다	t w e̞ d a̠	되다
되찾다	t w e̞ t͡ɕʰ a̠ t̚ t͈ a̠	되찯따
되풀이	t w e̞ pʰ u ɾ i	되푸리
되풀이하다	t w e̞ pʰ u ɾ i ɦ a̠ d a̠	되푸리하다
된디읃	t w e̞ n d i ɯ t̚	된디읃
된비읍	t w e̞ n b i ɯ p̚	된비읍
된장	t w e̞ː ɲ d͡ʑ a̠ ŋ	된장
된장녀	t w e̞ː ɲ d͡ʑ a̠ ŋ ɲ j ʌ̹	된장녀
된장풀	t w e̞ ɲ d͡ʑ a̠ ŋ pʰ u ɭ	된장풀
됨됨	t w e̞ m d w e̞ m	됨됨
됨됨이	t w e̞ m d w e̞ m i	됨되미
두건	t u ɡ ʌ̹ n	두건
두견	t u ɡ j ʌ̹ n	두견
두근거리다	t u ɡ ɯ n ɡ ʌ̹ ɾ i d a̠	두근거리다
두근두근	t u ɡ ɯ n d u ɡ ɯ n	두근두근
두꺼비	t u k͈ ʌ̹ b i	두꺼비
두뇌	t u n w e̞	두뇌
두더지	t u d ʌ̹ d͡ʑ i	두더지
두드러기	t u d ɯ ɾ ʌ̹ ɡ i	두드러기
두드러지다	t u d ɯ ɾ ʌ̹ d͡ʑ i d a̠	두드러지다
두드리다	t u d ɯ ɾ i d a̠	두드리다
두려움	t u ɾ j ʌ̹ u m	두려움
두렵다	t u ɾ j ʌ̹ p̚ t͈ a̠	두렵따
두루미	t u ɾ u m i	두루미
두르다	t u ɾ ɯ d a̠	두르다
두마	t u m a̠	두마
두만강	t u m a̠ n ɡ a̠ ŋ	두만강
두만강자그사니	t u m a̠ n ɡ a̠ ŋ d͡ʑ a̠ ɡ ɯ sʰ a̠ n i	두만강자그사니
두목	t u m o̞ k̚	두목
두바이	t u b a̠ i	두바이
두반장	t u b a̠ ɲ d͡ʑ a̠ ŋ	두반장
두발	t u b a̠ ɭ	두발
두벌식	t u b ʌ̹ ɭ ɕʰ i k̚	두벌식
두부	t u b u	두부
두상	t u sʰ a̠ ŋ	두상
두서너	t u sʰ ʌ̹ n ʌ̹	두서너
두서넛	t u sʰ ʌ̹ n ʌ̹ t̚	두서넏
두세	t u sʰ e̞	두세
두어	t u ʌ̹	두어
두연	t u j ʌ̹ n	두연
두음	t u ɯ m	두음
두음법칙	t u ɯ m b ʌ̹ p̚ t͡ɕʰ i k̚	두음법칙
두절	t u d͡ʑ ʌ̹ ɭ	두절
두줄망둑	t uː d͡ʑ u ɭ m a̠ ŋ d u k̚	두줄망둑
두통	t u tʰ o̞ ŋ	두통
둔치다	t u ɲ t͡ɕʰ i d a̠	둔치다
둘러보다	t u ɭ ɭ ʌ̹ b o̞ d a̠	둘러보다
둘러싸다	t u ɭ ɭ ʌ̹ s͈ a̠ d a̠	둘러싸다
둘치	t u ʎ t͡ɕʰ i	둘치
둥지	t u ŋ d͡ʑ i	둥지
둥치	t u ŋ t͡ɕʰ i	둥치
뒤늦다	t ɥ iː n ɯ t̚ t͈ a̠	뒤늗따
뒤지다	t ɥ i d͡ʑ i d a̠	뒤지다
뒤집다	t ɥ i d͡ʑ i p̚ t͈ a̠	뒤집따
뒤쫓다	t ɥ iː t͡ɕ͈ o̞ t̚ t͈ a̠	뒤쫃따
뒷간	t ɥ iː t̚ k͈ a̠ n	뒫깐
뒷다리	t ɥ iː t̚ t͈ a̠ ɾ i	뒫따리
뒷마당	t ɥ iː n m a̠ d a̠ ŋ	뒨마당
뒷면	t ɥ iː n m j ʌ̹ n	뒨면
뒷모습	t ɥ iː n m o̞ sʰ ɯ p̚	뒨모습
뒹굴뒹굴	t ɥ i ŋ ɡ u ɭ d ɥ i ŋ ɡ u ɭ	뒹굴뒹굴
듀엣	t j u e̞ t̚	듀엗
듀오	t j u o̞	듀오
드라이브하다	t ɯ ɾ a̠ i b ɯ ɦ a̠ d a̠	드라이브하다
드럼	t ɯ ɾ ʌ̹ m	드럼
드르렁	t ɯ ɾ ɯ ɾ ʌ̹ ŋ	드르렁
드립	t ɯ ɾ i p̚	드립
드물다	t ɯ m u ɭ d a̠	드물다
득남	t ɯ ŋ n a̠ m	등남
득녀	t ɯ ŋ ɲ j ʌ̹	등녀
득점	t ɯ k̚ t͡ɕ͈ ʌ̹ m	득쩜
듣다	t ɯ t̚ t͈ a̠	듣따
들기름	t ɯ ɭ ɡ i ɾ ɯ m	들기름
들꿩	t ɯ ɭ k͈ w ʌ̹ ŋ	들꿩
들끓다	t ɯ ɭ k͈ ɯ ɭ tʰ a̠	들끌타
들다	t ɯ ɭ d a̠	들다
들러리	t ɯ ɭ ɭ ʌ̹ ɾ i	들러리
들르다	t ɯ ɭ ɭ ɯ d a̠	들르다
들어가다	t ɯ ɾ ʌ̹ ɡ a̠ d a̠	드러가다
들어서다	t ɯ ɾ ʌ̹ sʰ ʌ̹ d a̠	드러서다
들이다	t ɯ ɾ i d a̠	드리다
들쭉날쭉하다	t ɯ ʎ t͡ɕ͈ u ŋ n a̠ ʎ t͡ɕ͈ u kʰ a̠ d a̠	들쭝날쭈카다
듯이	t ɯ ɕʰ i	드시
등급	t ɯ ŋ ɡ ɯ p̚	등급
등등	t ɯː ŋ d ɯ ŋ	등등
등받이	t ɯ ŋ b a̠ d i	등바디
등불	t ɯ ŋ p͈ u ɭ	등뿔
등산	t ɯ ŋ sʰ a̠ n	등산
등심	t ɯ ŋ ɕʰ i m	등심
등유	t ɯ ŋ j u	드유
등자	t ɯ ŋ d͡ʑ a̠	등자
등장	t ɯ ŋ d͡ʑ a̠ ŋ	등장
등장인물	t ɯ ŋ d͡ʑ a̠ ŋ i n m u ɭ	등자인물
등줄숭어	t ɯ ŋ t͡ɕ͈ u ɭ sʰ u ŋ ʌ̹	등쭐수어
디귿	t i ɡ ɯ t̚	디귿
디디다	t i d i d a̠	디디다
디바이스	t i b a̠ i s͈ ɯ	디바이쓰
디스켓	t i sʰ ɯ kʰ e̞ t̚	디스켇
디스코	t i sʰ ɯ kʰ o̞	디스코
디스크	t i sʰ ɯ k x ɯ	디슥흐
디스플레이	t i sʰ ɯ pʰ ɯ ɭ ɭ e̞ i	디스플레이
디엔에이	t i e̞ n e̞ i	디에네이
디자인	t i d͡ʑ a̠ i n	디자인
디저트	t i d͡ʑ ʌ̹ tʰ ɯ	디저트
디지털	t i d͡ʑ i tʰ ʌ̹ ɭ	디지털
딩딩	t i ŋ d i ŋ	딩딩
따님	t͈ a̠ n i m	따님
따다	t͈ a̠ d a̠	따다
따뜻	t͈ a̠ t͈ ɯ t̚	따뜯
따뜻하다	t͈ a̠ t͈ ɯ tʰ a̠ d a̠	따뜨타다
따라가다	t͈ a̠ ɾ a̠ ɡ a̠ d a̠	따라가다
따라서	t͈ a̠ ɾ a̠ sʰ ʌ̹	따라서
따라하다	t͈ a̠ ɾ a̠ ɦ a̠ d a̠	따라하다
따로	t͈ a̠ ɾ o̞	따로
따르다	t͈ a̠ ɾ ɯ d a̠	따르다
따르릉	t͈ a̠ ɾ ɯ ɾ ɯ ŋ	따르릉
따름	t͈ a̠ ɾ ɯ m	따름
따오기	t͈ a̠ o̞ ɡ i	따오기
따위	t͈ a̠ ɥ i	따위
따이	t͈ a̠ i	따이
따지다	t͈ a̠ d͡ʑ i d a̠	따지다
딱딱하다	t͈ a̠ k̚ t͈ a̠ kʰ a̠ d a̠	딱따카다
딱지	t͈ a̠ k̚ t͡ɕ͈ i	딱찌
딸기	t͈ a̠ː ɭ ɡ i	딸기
딸꾹질	t͈ a̠ ɭ k͈ u k̚ t͡ɕ͈ i ɭ	딸꾹찔
땅크병	t͈ a̠ ŋ k x ɯ b j ʌ̹ ŋ	땅ㄱ흐병
땋다	t͈ a̠ː tʰ a̠	따타
땜납	t͈ ɛː m n a̠ p̚	땜납
떠다니다	t͈ ʌ̹ d a̠ n i d a̠	떠다니다
떠돌다	t͈ ʌ̹ d o̞ ɭ d a̠	떠돌다
떠들다	t͈ ɘː d ɯ ɭ d a̠	떠들다
떠들썩하다	t͈ ʌ̹ d ɯ ɭ s͈ ʌ̹ kʰ a̠ d a̠	떠들써카다
떠오르다	t͈ ʌ̹ o̞ ɾ ɯ d a̠	떠오르다
떡국	t͈ ʌ̹ k̚ k͈ u k̚	떡꾹
떡볶이	t͈ ʌ̹ k̚ p͈ o̞ k͈ i	떡뽀끼
떨다	t͈ ɘː ɭ d a̠	떨다
떨리다	t͈ ʌ̹ ʎ ʎ i d a̠	떨리다
떨어뜨리다	t͈ ʌ̹ ɾ ʌ̹ t͈ ɯ ɾ i d a̠	떠러뜨리다
떨어지다	t͈ ʌ̹ ɾ ʌ̹ d͡ʑ i d a̠	떠러지다
떨치다	t͈ ʌ̹ ʎ t͡ɕʰ i d a̠	떨치다
떳떳하다	t͈ ʌ̹ t̚ t͈ ʌ̹ tʰ a̠ d a̠	떧떠타다
떼지어	t͈ e̞ d͡ʑ i ʌ̹	떼지어
또는	t͈ o̞ n ɯ n	또는
또다시	t͈ o̞ d a̠ ɕʰ i	또다시
똑같다	t͈ o̞ k̚ k͈ a̠ t̚ t͈ a̠	똑깓따
똑같이	t͈ o̞ k̚ k͈ a̠ t͡ɕʰ i	똑까치
똑똑	t͈ o̞ k̚ t͈ o̞ k̚	똑똑
똑바로	t͈ o̞ k̚ p͈ a̠ ɾ o̞	똑빠로
똥침	t͈ o̞ ŋ t͡ɕʰ i m	똥침
똥파리	t͈ o̞ ŋ pʰ a̠ ɾ i	똥파리
뙤약볕	t͈ w e̞ j a̠ k̚ p͈ j ʌ̹ t̚	뙤약뼏
뚜렷하다	t͈ u ɾ j ʌ̹ tʰ a̠ d a̠	뚜려타다
뚱뚱하다	t͈ u ŋ t͈ u ŋ ɦ a̠ d a̠	뚱뚱하다
뛰다	t͈ ɥ i d a̠	뛰다
뛰어가다	t͈ ɥ i ʌ̹ ɡ a̠ d a̠	뛰어가다
뛰어나다	t͈ ɥ i ʌ̹ n a̠ d a̠	뛰어나다
뛰어다니다	t͈ ɥ i ʌ̹ d a̠ n i d a̠	뛰어다니다
뛰어들다	t͈ ɥ i ʌ̹ d ɯ ɭ d a̠	뛰어들다
뜨겁다	t͈ ɯ ɡ ʌ̹ p̚ t͈ a̠	뜨겁따
뜨다	t͈ ɯ d a̠	뜨다
뜯다	t͈ ɯ t̚ t͈ a̠	뜯따
뜸하다	t͈ ɯ m ɦ a̠ d a̠	뜸하다
뜻밖에	t͈ ɯ t̚ p͈ a̠ k͈ e̞	뜯빠께
뜻하다	t͈ ɯ tʰ a̠ d a̠	뜨타다
띄어쓰기	t͈ i ʌ̹ s͈ ɯ ɡ i	띠어쓰기
라고	ɾ a̠ ɡ o̞	라고
라고스	ɾ a̠ ɡ o̞ sʰ ɯ	라고스
라니	ɾ a̠ n i	라니
라돈	ɾ a̠ d o̞ n	라돈
라듐	ɾ a̠ d j u m	라듐
라디에이터	ɾ a̠ d i e̞ i tʰ ʌ̹	라디에이터
라디오	ɾ a̠ d i o̞	라디오
라며	ɾ a̠ m j ʌ̹	라며
라면	ɾ a̠ m j ʌ̹ n	라면
라바트	ɾ a̠ b a̠ tʰ ɯ	라바트
라벨	ɾ a̠ b e̞ ɭ	라벨
라볶이	ɾ a̠ b o̞ k͈ i	라보끼
라선	ɾ a̠ sʰ ʌ̹ n	라선
라오스	ɾ a̠ o̞ sʰ ɯ	라오스
라우터	ɾ a̠ u tʰ ʌ̹	라우터
라운지	ɾ a̠ u ɲ d͡ʑ i	라운지
라이벌	ɾ a̠ i b ʌ̹ ɭ	라이벌
라이베리아	ɾ a̠ i b e̞ ɾ i a̠	라이베리아
라이선스	ɾ a̠ i sʰ ʌ̹ n sʰ ɯ	라이선스
라이터	ɾ a̠ i tʰ ʌ̹	라이터
라이플	ɾ a̠ i pʰ ɯ ɭ	라이플
라인	ɾ a̠ i n	라인
라임	ɾ a̠ i m	라임
라트비아	ɾ a̠ tʰ ɯ b i a̠	라트비아
라트비아어	ɾ a̠ tʰ ɯ b i a̠ ʌ̹	라트비아어
라틴	ɾ a̠ tʰ i n	라틴
라파스	ɾ a̠ pʰ a̠ sʰ ɯ	라파스
락타	ɾ a̠ k̚ tʰ a̠	락타
랭면	ɾ ɛː ŋ m j ʌ̹ n	랭면
량강도	ɾ j a̠ ŋ ɡ a̠ ŋ d o̞	량강도
러시아어	ɾ ʌ̹ ɕʰ i a̠ ʌ̹	러시아어
러시아인	ɾ ʌ̹ ɕʰ i a̠ i n	러시아인
레몬	ɾ e̞ m o̞ n	레몬
레바논	ɾ e̞ b a̠ n o̞ n	레바논
레소토	ɾ e̞ sʰ o̞ tʰ o̞	레소토
레스토랑	ɾ e̞ sʰ ɯ tʰ o̞ ɾ a̠ ŋ	레스토랑
레슬링	ɾ e̞ sʰ ɯ ʎ ʎ i ŋ	레슬링
레위니옹	ɾ e̞ ɥ i n i o̞ ŋ	레위니옹
레이스	ɾ e̞ i sʰ ɯ	레이스
레이저	ɾ e̞ i d͡ʑ ʌ̹	레이저
레즈비언	ɾ e̞ d͡ʑ ɯ b i ʌ̹ n	레즈비언
레퍼토리	ɾ e̞ pʰ ʌ̹ tʰ o̞ ɾ i	레퍼토리
렌즈	ɾ e̞ ɲ d͡ʑ ɯ	렌즈
려관	ɾ j ʌ̹ ɡ w a̠ n	려관
련락	ɾ j ʌ̹ ɭ ɭ a̠ k̚	렬락
련습	ɾ j ɘː n sʰ ɯ p̚	련습
련합	ɾ j ʌ̹ n ɦ a̠ p̚	련합
령도자	ɾ j ʌ̹ ŋ d o̞ d͡ʑ a̠	령도자
로고	ɾ o̞ ɡ o̞	로고
로국	ɾ o̞ ɡ u k̚	로국
로그	ɾ o̞ ɡ ɯ	로그
로그인	ɾ o̞ ɡ ɯ i n	로그인
로또	ɾ o̞ t͈ o̞	로또
로렌슘	ɾ o̞ ɾ e̞ n ɕʰ u m	로렌숨
로마	ɾ o̞ m a̠	로마
로망	ɾ o̞ m a̠ ŋ	로망
로므니아	ɾ o̞ m ɯ n i a̠	로므니아
로보트	ɾ o̞ b o̞ tʰ ɯ	로보트
로사리오	ɾ o̞ sʰ a̠ ɾ i o̞	로사리오
로씨야	ɾ o̞ ɕ͈ i j a̠	로씨야
로어	ɾ o̞ ʌ̹	로어
로켓	ɾ o̞ kʰ e̞ t̚	로켇
로토	ɾ o̞ tʰ o̞	로토
로획	ɾ o̞ β w e̞ k̚	로획
롤러코스터	ɾ o̞ ɭ ɭ ʌ̹ kʰ o̞ sʰ ɯ tʰ ʌ̹	롤러코스터
뢴트겐	ɾ w e̞ n tʰ ɯ ɡ e̞ n	뢴트겐
료법	ɾ j o b ʌ̹ p̚	료법
루마니아	ɾ u m a̠ n i a̠	루마니아
루마니아어	ɾ u m a̠ n i a̠ ʌ̹	루마니아어
루머	ɾ u m ʌ̹	루머
루블	ɾ u b ɯ ɭ	루블
루사카	ɾ u sʰ a̠ kʰ a̠	루사카
루저	ɾ u d͡ʑ ʌ̹	루저
루카	ɾ u kʰ a̠	루카
루테늄	ɾ u tʰ e̞ ɲ j u m	루테늄
루테튬	ɾ u tʰ e̞ tʰ j u m	루테튬
루프	ɾ u pʰ ɯ	루프
룩셈부르크	ɾ u k s͈ e̞ m b u ɾ ɯ k x ɯ	룩쎔부륵흐
룰렛	ɾ u ɭ ɭ e̞ t̚	룰렏
류월	ɾ j u w ʌ̹ ɭ	류월
륙지	ɾ j u k̚ t͡ɕ͈ i	륙찌
르네상스	ɾ ɯ n e̞ sʰ a̠ ŋ sʰ ɯ	르네상스
르완다	ɾ ɯ w a̠ n d a̠	르완다
리가	ɾ i ɡ a̠	리가
리그	ɾ i ɡ ɯ	리그
리눅스	ɾ i n u k s͈ ɯ	리눅쓰
리듬	ɾ i d ɯ m	리듬
리모컨	ɾ i m o̞ kʰ ʌ̹ n	리모컨
리무진	ɾ i m u d͡ʑ i n	리무진
리믹스	ɾ i m i k s͈ ɯ	리믹쓰
리버모륨	ɾ i b ʌ̹ m o̞ ɾ j u m	리버모륨
리비아	ɾ i b i a̠	리비아
리셉션	ɾ i s͈ e̞ p ɕ͈ ʌ̹ n	리쎕썬
리스본	ɾ i sʰ ɯ b o̞ n	리스본
리야드	ɾ i j a̠ d ɯ	리야드
리어카	ɾ i ʌ̹ kʰ a̠	리어카
리얼	ɾ i ʌ̹ ɭ	리얼
리옹	ɾ i o̞ ŋ	리옹
리왕조	ɾ i w a̠ ŋ d͡ʑ o̞	리왕조
리우데자네이루	ɾ i u d e̞ d͡ʑ a̠ n e̞ i ɾ u	리우데자네이루
리원	ɾ i w ʌ̹ n	리원
리터	ɾ i tʰ ʌ̹	리터
리투아니아	ɾ i tʰ u a̠ n i a̠	리투아니아
리튬	ɾ i tʰ j u m	리튬
리포트	ɾ i pʰ o̞ tʰ ɯ	리포트
리히텐슈타인	ɾ i ʝ i tʰ e̞ n ɕʰ u tʰ a̠ i n	리히텐수타인
린스	ɾ i n s͈ ɯ	린쓰
릴리스	ɾ i ʎ ʎ i sʰ ɯ	릴리스
립스틱	ɾ i p s͈ ɯ tʰ i k̚	립쓰틱
링귀네	ɾ i ŋ ɡ ɥ i n e̞	링귀네
링크	ɾ i ŋ k x ɯ	링ㄱ흐
마구	m a̠ ɡ u	마구
마구간	m a̠ː ɡ u k͈ a̠ n	마구깐
마귀	m a̠ ɡ ɥ i	마귀
마나과	m a̠ n a̠ ɡ w a̠	마나과
마나마	m a̠ n a̠ m a̠	마나마
마녀	m a̠ ɲ j ʌ̹	마녀
마누라	m a̠ n u ɾ a̠	마누라
마늘	m a̠ n ɯ ɭ	마늘
마니	m a̠ n i	마니
마닐라	m a̠ n i ɭ ɭ a̠	마닐라
마다	m a̠ d a̠	마다
마다가스카르	m a̠ d a̠ ɡ a̠ sʰ ɯ kʰ a̠ ɾ ɯ	마다가스카르
마달	m a̠ d a̠ ɭ	마달
마더	m a̠ d ʌ̹	마더
마드리드	m a̠ d ɯ ɾ i d ɯ	마드리드
마땅하다	m a̠ t͈ a̠ ŋ ɦ a̠ d a̠	마땅하다
마라톤	m a̠ ɾ a̠ tʰ o̞ n	마라톤
마력	m a̠ː ɾ j ʌ̹ k̚	마력
마련	m a̠ ɾ j ʌ̹ n	마련
마련하다	m a̠ ɾ j ʌ̹ n ɦ a̠ d a̠	마련하다
마루	m a̠ ɾ u	마루
마르멜로	m a̠ ɾ ɯ m e̞ ɭ ɭ o̞	마르멜로
마르스	m a̠ ɾ ɯ sʰ ɯ	마르스
마르코	m a̠ ɾ ɯ kʰ o̞	마르코
마르크스주의	m a̠ ɾ ɯ k x ɯ sʰ ɯ d͡ʑ u ɰ i	마륵흐스주의
마르티니크	m a̠ ɾ ɯ tʰ i n i k x ɯ	마르티닉흐
마름모	m a̠ ɾ ɯ m m o̞	마름모
마리	m a̠ ɾ i	마리
마마	m a̠ː m a̠	마마
마무르다	m a̠ m u ɾ ɯ d a̠	마무르다
마무리	m a̠ m u ɾ i	마무리
마법	m a̠ b ʌ̹ p̚	마법
마법사	m a̠ b ʌ̹ p s͈ a̠	마법싸
마사지	m a̠ sʰ a̠ d͡ʑ i	마사지
마소	m a̠ sʰ o̞	마소
마술	m a̠ sʰ u ɭ	마술
마술사	m a̠ sʰ u ɭ s͈ a̠	마술싸
마스다	m a̠ sʰ ɯ d a̠	마스다
마스크	m a̠ sʰ ɯ k x ɯ	마슥흐
마스터베이션	m a̠ sʰ ɯ tʰ ʌ̹ b e̞ i ɕʰ ʌ̹ n	마스터베이선
마시다	m a̠ ɕʰ i d a̠	마시다
마약	m a̠ j a̠ k̚	마약
마우스	m a̠ u s͈ ɯ	마우쓰
마유	m a̠ː j u	마유
마을	m a̠ ɯ ɭ	마을
마을버스	m a̠ ɯ ɭ b ʌ̹ sʰ ɯ	마을버스
마음	m a̠ ɯ m	마음
마음속	m a̠ ɯ m s͈ o̞ k̚	마음쏙
마음씨	m a̠ ɯ m ɕ͈ i	마음씨
마이너스	m a̠ i n ʌ̹ s͈ ɯ	마이너쓰
마이웨이	m a̠ i w e̞ i	마이웨이
마이크	m a̠ i k x ɯ	마익흐
마이크로소프트	m a̠ i k x ɯ ɾ o̞ sʰ o̞ pʰ ɯ tʰ ɯ	마익흐로소프트
마이크로파	m a̠ i k x ɯ ɾ o̞ pʰ a̠	마익흐로파
마일	m a̠ i ɭ	마일
마작	m a̠ː d͡ʑ a̠ k̚	마작
마주	m a̠ d͡ʑ u	마주
마중	m a̠ d͡ʑ u ŋ	마중
마지막	m a̠ d͡ʑ i m a̠ k̚	마지막
마차	m a̠ː t͡ɕʰ a̠	마차
마찬가지	m a̠ t͡ɕʰ a̠ n ɡ a̠ d͡ʑ i	마찬가지
마찰	m a̠ t͡ɕʰ a̠ ɭ	마찰
마천루	m a̠ t͡ɕʰ ʌ̹ ɭ ɭ u	마철루
마취	m a̠ t͡ɕʰ ɥ i	마취
마침	m a̠ t͡ɕʰ i m	마침
마카로니	m a̠ kʰ a̠ ɾ o̞ n i	마카로니
마케도니아	m a̠ kʰ e̞ d o̞ n i a̠	마케도니아
마케팅	m a̠ kʰ e̞ tʰ i ŋ	마케팅
마켓	m a̠ kʰ e̞ t̚	마켇
마트	m a̠ tʰ ɯ	마트
마트료시카	m a̠ tʰ ɯ ɾ j o ɕʰ i kʰ a̠	마트료시카
마팔디네	m a̠ pʰ a̠ ɭ d i n e̞	마팔디네
마푸토	m a̠ pʰ u tʰ o̞	마푸토
마피아	m a̠ pʰ i a̠	마피아
마흐디	m a̠ ɣ ɯ d i	마ɣㅡ디
마흔	m a̠ ɣ ɯ n	마ɣㅡㄴ
막다	m a̠ k̚ t͈ a̠	막따
막다르다	m a̠ k̚ t͈ a̠ ɾ ɯ d a̠	막따르다
막바지	m a̠ k̚ p͈ a̠ d͡ʑ i	막빠지
막차	m a̠ k̚ t͡ɕʰ a̠	막차
만나기	m a̠ n n a̠ ɡ i	만나기
만나다	m a̠ n n a̠ d a̠	만나다
만날	m a̠ː n n a̠ ɭ	만날
만남	m a̠ n n a̠ m	만남
만년	m a̠ː n ɲ j ʌ̹ n	만년
만년필	m a̠ː n ɲ j ʌ̹ n pʰ i ɭ	만년필
만능	m a̠ː n n ɯ ŋ	만능
만들다	m a̠ n d ɯ ɭ d a̠	만들다
만리장성	m a̠ː ʎ ʎ i d͡ʑ a̠ ŋ sʰ ʌ̹ ŋ	말리장성
만물	m a̠ː n m u ɭ	만물
만성	m a̠ n sʰ ʌ̹ ŋ	만성
만약	m a̠ː ɲ j a̠ k̚	마냑
만유	m a̠ː ɲ j u	마뉴
만유인력	m a̠ː ɲ j u i ʎ ʎ j ʌ̹ k̚	마뉴일력
만일	m a̠ː n i ɭ	마닐
만족	m a̠ ɲ d͡ʑ o̞ k̚	만족
만주	m a̠ ɲ d͡ʑ u	만주
만주국	m a̠ ɲ d͡ʑ u ɡ u k̚	만주국
만지다	m a̠ ɲ d͡ʑ i d a̠	만지다
만큼	m a̠ n k x ɯ m	만ㄱ흠
만하다	m a̠ n ɦ a̠ d a̠	만하다
만화	m a̠ː n β w a̠	만화
많은	m a̠ː n ɯ n	마는
많이	m a̠ː n i	마니
맏아들	m a̠ d a̠ d ɯ ɭ	마다들
맏이	m a̠ d͡ʑ i	마지
맏형	m a̠ tʰ j ʌ̹ ŋ	마텽
말고기	m a̠ ɭ ɡ o̞ ɡ i	말고기
말기	m a̠ ɭ ɡ i	말기
말다툼	m a̠ː ɭ d a̠ tʰ u m	말다툼
말뚝	m a̠ ɭ t͈ u k̚	말뚝
말라보	m a̠ ɭ ɭ a̠ b o̞	말라보
말라위	m a̠ ɭ ɭ a̠ ɥ i	말라위
말레	m a̠ ɭ ɭ e̞	말레
말레이시아	m a̠ ɭ ɭ e̞ i ɕʰ i a̠	말레이시아
말레이어	m a̠ ɭ ɭ e̞ i ʌ̹	말레이어
말리	m a̠ ʎ ʎ i	말리
말미	m a̠ ɭ m i	말미
말벌	m a̠ ɭ b ʌ̹ ɭ	말벌
말살하다	m a̠ ɭ s͈ a̠ ɾ ɦ a̠ d a̠	말쌀하다
말솜씨	m a̠ː ɭ s͈ o̞ m ɕ͈ i	말쏨씨
말썽꾸러기	m a̠ː ɭ s͈ ʌ̹ ŋ k͈ u ɾ ʌ̹ ɡ i	말썽꾸러기
말씀	m a̠ː ɭ s͈ ɯ m	말씀
말하다	m a̠ː ɾ ɦ a̠ d a̠	말하다
맑다	m a̠ k̚ t͈ a̠	막따
맑스주의	m a̠ k s͈ ɯ d͡ʑ u ɰ i	막쓰주의
맛있다	m a̠ ɕʰ i t̚ t͈ a̠	마싣따
망간	m a̠ ŋ ɡ a̠ n	망간
망고	m a̠ ŋ ɡ o̞	망고
망둑	m a̠ ŋ d u k̚	망둑
망령	m a̠ ŋ ɲ j ʌ̹ ŋ	망녕
망막	m a̠ ŋ m a̠ k̚	망막
망상	m a̠ ŋ sʰ a̠ ŋ	망상
망설이다	m a̠ ŋ sʰ ʌ̹ ɾ i d a̠	망서리다
망시민	m a̠ ŋ ɕʰ i m i n	망시민
망치	m a̠ ŋ t͡ɕʰ i	망치
망치다	m a̠ ŋ t͡ɕʰ i d a̠	망치다
망토	m a̠ ŋ tʰ o̞	망토
맞벌이	m a̠ t̚ p͈ ʌ̹ ɾ i	맏뻐리
맞부딪치다	m a̠ t̚ p͈ u d i t̚ t͡ɕʰ i d a̠	맏뿌딛치다
맞이	m a̠ d͡ʑ i	마지
맞추다	m a̠ t̚ t͡ɕʰ u d a̠	맏추다
맞춤	m a̠ t̚ t͡ɕʰ u m	맏춤
맞흥정	m a̠ tʰ ɯ ŋ d͡ʑ ʌ̹ ŋ	마틍정
맡다	m a̠ t̚ t͈ a̠	맏따
매국노	m ɛː ɡ u ŋ n o̞	매궁노
매년	m ɛː ɲ j ʌ̹ n	매년
매달리다	m ɛː d a̠ ʎ ʎ i d a̠	매달리다
매미	m ɛː m i	매미
매월	m ɛː w ʌ̹ ɭ	매월
매일	m ɛː i ɭ	매일
매장	m ɛː d͡ʑ a̠ ŋ	매장
매점	m ɛː d͡ʑ ʌ̹ m	매점
매주	m ɛː d͡ʑ u	매주
매춘부	m ɛː t͡ɕʰ u n b u	매춘부
매출	m ɛː t͡ɕʰ u ɭ	매출
매표구	m ɛː pʰ j o ɡ u	매표구
맨날	m ɛː n n a̠ ɭ	맨날
맹세	m ɛː ŋ sʰ e̞	맹세
맹인	m ɛː ŋ i n	매인
맹자	m ɛː ŋ d͡ʑ a̠	맹자
먄마	m j a̠ n m a̠	먄마
머구리	m ʌ̹ ɡ u ɾ i	머구리
머그잔	m ʌ̹ ɡ ɯ d͡ʑ a̠ n	머그잔
머리	m ʌ̹ ɾ i	머리
머리띠	m ʌ̹ ɾ i t͈ i	머리띠
머리카락	m ʌ̹ ɾ i kʰ a̠ ɾ a̠ k̚	머리카락
머리칼	m ʌ̹ ɾ i kʰ a̠ ɭ	머리칼
머리털	m ʌ̹ ɾ i tʰ ʌ̹ ɭ	머리털
머리통	m ʌ̹ ɾ i tʰ o̞ ŋ	머리통
머무르다	m ʌ̹ m u ɾ ɯ d a̠	머무르다
머물다	m ʌ̹ m u ɭ d a̠	머물다
머뭇거리다	m ʌ̹ m u t̚ k͈ ʌ̹ ɾ i d a̠	머묻꺼리다
머슴	m ʌ̹ sʰ ɯ m	머슴
머시마	m ʌ̹ ɕʰ i m a̠	머시마
머핀	m ʌ̹ pʰ i n	머핀
먹다	m ʌ̹ k̚ t͈ a̠	먹따
먹물	m ʌ̹ ŋ m u ɭ	멍물
먹이	m ʌ̹ ɡ i	머기
먹이다	m ʌ̹ ɡ i d a̠	머기다
먼저	m ʌ̹ ɲ d͡ʑ ʌ̹	먼저
먼지	m ʌ̹ ɲ d͡ʑ i	먼지
멀다	m ɘː ɭ d a̠	멀다
멀리	m ɘː ʎ ʎ i	멀리
멀미	m ʌ̹ ɭ m i	멀미
멀어지다	m ɘː ɾ ʌ̹ d͡ʑ i d a̠	머러지다
멀쩡	m ʌ̹ ʎ t͡ɕ͈ ʌ̹ ŋ	멀쩡
멀쩡하다	m ʌ̹ ʎ t͡ɕ͈ ʌ̹ ŋ ɦ a̠ d a̠	멀쩡하다
멀찌감치	m ʌ̹ ʎ t͡ɕ͈ i ɡ a̠ m t͡ɕʰ i	멀찌감치
멈추다	m ʌ̹ m t͡ɕʰ u d a̠	멈추다
멋없다	m ʌ̹ d ʌ̹ p̚ t͈ a̠	머덥따
멋있다	m ʌ̹ ɕʰ i t̚ t͈ a̠	머싣따
멋지다	m ʌ̹ t̚ t͡ɕ͈ i d a̠	먿찌다
멍에	m ʌ̹ ŋ e̞	머에
멍텅구리	m ʌ̹ ŋ tʰ ʌ̹ ŋ ɡ u ɾ i	멍텅구리
메가나	m e̞ ɡ a̠ n a̠	메가나
메기	m e̞ː ɡ i	메기
메뉴	m e̞ ɲ j u	메뉴
메달	m e̞ d a̠ ɭ	메달
메뚜기	m e̞ t͈ u ɡ i	메뚜기
메모	m e̞ m o̞	메모
메모리	m e̞ m o̞ ɾ i	메모리
메밀	m e̞ m i ɭ	메밀
메서드	m e̞ sʰ ʌ̹ d ɯ	메서드
메소드	m e̞ sʰ o̞ d ɯ	메소드
메시아	m e̞ ɕʰ i a̠	메시아
메이스	m e̞ i sʰ ɯ	메이스
메일	m e̞ i ɭ	메일
메카	m e̞ kʰ a̠	메카
메탄	m e̞ tʰ a̠ n	메탄
메터	m e̞ tʰ ʌ̹	메터
메토끼	m e̞ tʰ o̞ k͈ i	메토끼
멕시코시티	m e̞ k ɕ͈ i kʰ o̞ ɕʰ i tʰ i	멕씨코시티
멜라닌	m e̞ ɭ ɭ a̠ n i n	멜라닌
멜로	m e̞ ɭ ɭ o̞	멜로
멜로드라마	m e̞ ɭ ɭ o̞ d ɯ ɾ a̠ m a̠	멜로드라마
멜론	m e̞ ɭ ɭ o̞ n	멜론
멜버른	m e̞ ɭ b ʌ̹ ɾ ɯ n	멜버른
멧닭	m e̞ t̚ t͈ a̠ k̚	멛딱
며느리	m j ʌ̹ n ɯ ɾ i	며느리
며칠	m j ʌ̹ t͡ɕʰ i ɭ	며칠
멱살	m j ʌ̹ k s͈ a̠ ɭ	멱쌀
면도기	m j ɘː n d o̞ ɡ i	면도기
면도칼	m j ɘː n d o̞ kʰ a̠ ɭ	면도칼
면도하다	m j ɘː n d o̞ ɦ a̠ d a̠	면도하다
면발	m j ʌ̹ n b a̠ ɭ	면발
면서	m j ʌ̹ n sʰ ʌ̹	면서
면세	m j ɘː n sʰ e̞	면세
면역학	m j ɘː ɲ j ʌ̹ kʰ a̠ k̚	며녀칵
면적	m j ɘː ɲ d͡ʑ ʌ̹ k̚	면적
면전	m j ʌ̹ ɲ d͡ʑ ʌ̹ n	면전
면접	m j ɘː ɲ d͡ʑ ʌ̹ p̚	면접
면허증	m j ɘː n ɦ ʌ̹ t͡ɕ͈ ɯ ŋ	면허쯩
멸망	m j ʌ̹ ɭ m a̠ ŋ	멸망
멸종	m j ʌ̹ ʎ t͡ɕ͈ o̞ ŋ	멸쫑
멸치	m j ʌ̹ ʎ t͡ɕʰ i	멸치
명곡	m j ʌ̹ ŋ ɡ o̞ k̚	명곡
명관	m j ʌ̹ ŋ ɡ w a̠ n	명관
명단	m j ʌ̹ ŋ d a̠ n	명단
명동	m j ʌ̹ ŋ d o̞ ŋ	명동
명령하다	m j ɘː ŋ ɲ j ʌ̹ ŋ ɦ a̠ d a̠	명녕하다
명말청초	m j ʌ̹ ŋ m a̠ ʎ t͡ɕʰ ʌ̹ ŋ t͡ɕʰ o̞	명말청초
명부	m j ʌ̹ ŋ b u	명부
명사	m j ʌ̹ ŋ sʰ a̠	명사
명성	m j ʌ̹ ŋ sʰ ʌ̹ ŋ	명성
명소	m j ʌ̹ ŋ sʰ o̞	명소
명예	m j ʌ̹ ŋ j e̞	며예
명왕성	m j ʌ̹ ŋ w a̠ ŋ sʰ ʌ̹ ŋ	며왕성
명의	m j ʌ̹ ŋ ɰ i	며의
명인	m j ʌ̹ ŋ i n	며인
명일	m j ʌ̹ ŋ i ɭ	며일
명절	m j ʌ̹ ŋ d͡ʑ ʌ̹ ɭ	명절
명주	m j ʌ̹ ŋ d͡ʑ u	명주
명중	m j ɘː ŋ d͡ʑ u ŋ	명중
명칭	m j ʌ̹ ŋ t͡ɕʰ i ŋ	명칭
명하다	m j ɘː ŋ ɦ a̠ d a̠	명하다
명함	m j ʌ̹ ŋ ɦ a̠ m	명함
몇몇	m j ʌ̹ n m j ʌ̹ t̚	면멷
모가디슈	m o̞ ɡ a̠ d i ɕʰ u	모가디수
모과	m o̞ː ɡ w a̠	모과
모교	m o̞ː ɡ j o	모교
모국	m o̞ː ɡ u k̚	모국
모금	m o̞ ɡ ɯ m	모금
모나코	m o̞ n a̠ kʰ o̞	모나코
모니터링	m o̞ n i tʰ ʌ̹ ɾ i ŋ	모니터링
모델	m o̞ d e̞ ɭ	모델
모뎀	m o̞ d e̞ m	모뎀
모독	m o̞ː d o̞ k̚	모독
모두	m o̞ d u	모두
모듈	m o̞ d j u ɭ	모듈
모드	m o̞ d ɯ	모드
모든	m o̞ː d ɯ n	모든
모듬	m o̞ d ɯ m	모듬
모란	m o̞ ɾ a̠ n	모란
모란봉	m o̞ ɾ a̠ n b o̞ ŋ	모란봉
모로코	m o̞ ɾ o̞ kʰ o̞	모로코
모루	m o̞ː ɾ u	모루
모르핀	m o̞ ɾ ɯ pʰ i n	모르핀
모리셔스	m o̞ ɾ i ɕʰ ʌ̹ sʰ ɯ	모리서스
모방	m o̞ b a̠ ŋ	모방
모사	m o̞ sʰ a̠	모사
모서리	m o̞ sʰ ʌ̹ ɾ i	모서리
모세혈관	m o̞ sʰ e̞ ʝ j ʌ̹ ɭ ɡ w a̠ n	모세혈관
모순	m o̞ sʰ u n	모순
모스코븀	m o̞ sʰ ɯ kʰ o̞ b j u m	모스코븀
모스크	m o̞ sʰ ɯ k x ɯ	모슥흐
모스크바	m o̞ sʰ ɯ k x ɯ b a̠	모슥흐바
모습	m o̞ sʰ ɯ p̚	모습
모시다	m o̞ː ɕʰ i d a̠	모시다
모양	m o̞ j a̠ ŋ	모양
모어	m o̞ː ʌ̹	모어
모에	m o̞ e̞	모에
모오케	m o̞ o̞ kʰ e̞	모오케
모욕	m o̞ː j o k̚	모욕
모으다	m o̞ ɯ d a̠	모으다
모음	m o̞ː ɯ m	모음
모음조화	m o̞ː ɯ m d͡ʑ o̞ β w a̠	모음조화
모이	m o̞ i	모이
모이다	m o̞ i d a̠	모이다
모임	m o̞ i m	모임
모자라다	m o̞ː d͡ʑ a̠ ɾ a̠ d a̠	모자라다
모잠비크	m o̞ d͡ʑ a̠ m b i k x ɯ	모잠빅흐
모전	m o̞ d͡ʑ ʌ̹ n	모전
모조리	m o̞ d͡ʑ o̞ ɾ i	모조리
모처럼	m o̞ t͡ɕʰ ʌ̹ ɾ ʌ̹ m	모처럼
모터보트	m o̞ tʰ ʌ̹ b o̞ tʰ ɯ	모터보트
모텔	m o̞ tʰ e̞ ɭ	모텔
모토	m o̞ tʰ o̞	모토
모퉁이	m o̞ tʰ u ŋ i	모투이
모피	m o̞ pʰ i	모피
모험	m o̞ː ɦ ʌ̹ m	모험
모형	m o̞ ʝ j ʌ̹ ŋ	모형
모호하다	m o̞ β o̞ ɦ a̠ d a̠	모호하다
목격자	m o̞ k̚ k͈ j ʌ̹ k̚ t͡ɕ͈ a̠	목껵짜
목구멍	m o̞ k̚ k͈ u m ʌ̹ ŋ	목꾸멍
목란	m o̞ ŋ n a̠ n	몽난
목련	m o̞ ŋ ɲ j ʌ̹ n	몽년
목마	m o̞ ŋ m a̠	몽마
목마르다	m o̞ ŋ m a̠ ɾ ɯ d a̠	몽마르다
목발	m o̞ k̚ p͈ a̠ ɭ	목빨
목사	m o̞ k s͈ a̠	목싸
목사님	m o̞ k s͈ a̠ n i m	목싸님
목석	m o̞ k s͈ ʌ̹ k̚	목썩
목수	m o̞ k s͈ u	목쑤
목슈권	m o̞ k ɕ͈ u ɡ w ʌ̹ n	목쑤권
목요일	m o̞ ɡ j o i ɭ	모교일
목욕	m o̞ ɡ j o k̚	모굑
목욕탕	m o̞ ɡ j o k̚ tʰ a̠ ŋ	모굑탕
목장	m o̞ k̚ t͡ɕ͈ a̠ ŋ	목짱
목적	m o̞ k̚ t͡ɕ͈ ʌ̹ k̚	목쩍
목전	m o̞ k̚ t͡ɕ͈ ʌ̹ n	목쩐
목젖	m o̞ k̚ t͡ɕ͈ ʌ̹ t̚	목쩓
목차	m o̞ k̚ t͡ɕʰ a̠	목차
목청	m o̞ k̚ t͡ɕʰ ʌ̹ ŋ	목청
목청껏	m o̞ k̚ t͡ɕʰ ʌ̹ ŋ k͈ ʌ̹ t̚	목청껃
목표	m o̞ k̚ pʰ j o	목표
몫몫이	m o̞ ŋ m o̞ k ɕ͈ i	몽목씨
몬로비아	m o̞ ɭ ɭ o̞ b i a̠	몰로비아
몬순	m o̞ n sʰ u n	몬순
몬테네그로	m o̞ n tʰ e̞ n e̞ ɡ ɯ ɾ o̞	몬테네그로
몬테비데오	m o̞ n tʰ e̞ b i d e̞ o̞	몬테비데오
몬트리올	m o̞ n tʰ ɯ ɾ i o̞ ɭ	몬트리올
몰골	m o̞ ɭ ɡ o̞ ɭ	몰골
몰다	m o̞ː ɭ d a̠	몰다
몰도바	m o̞ ɭ d o̞ b a̠	몰도바
몰디브	m o̞ ɭ d i b ɯ	몰디브
몰라	m o̞ ɭ ɭ a̠	몰라
몰상식	m o̞ ɭ s͈ a̠ ŋ ɕʰ i k̚	몰쌍식
몰카	m o̞ ɭ kʰ a̠	몰카
몰타	m o̞ ɭ tʰ a̠	몰타
몰타어	m o̞ ɭ tʰ a̠ ʌ̹	몰타어
몸살	m o̞ m sʰ a̠ ɭ	몸살
몸소	m o̞ m sʰ o̞	몸소
몸조리	m o̞ m d͡ʑ o̞ ɾ i	몸조리
몸짓	m o̞ m t͡ɕ͈ i t̚	몸찓
몸통	m o̞ m tʰ o̞ ŋ	몸통
몹시	m o̞ː p ɕ͈ i	몹씨
못지않다	m o̞ː t̚ t͡ɕ͈ i a̠ n tʰ a̠	몯찌안타
못하다	m o̞ tʰ a̠ d a̠	모타다
몽고	m o̞ ŋ ɡ o̞	몽고
몽골	m o̞ ŋ ɡ o̞ ɭ	몽골
몽둥이	m o̞ ŋ d u ŋ i	몽두이
몽따쥬	m o̞ ŋ t͈ a̠ d͡ʑ u	몽따주
몽어	m o̞ ŋ ʌ̹	모어
몽정	m o̞ː ŋ d͡ʑ ʌ̹ ŋ	몽정
몽타주	m o̞ ŋ tʰ a̠ d͡ʑ u	몽타주
묘미	m j oː m i	묘미
묘사	m j oː sʰ a̠	묘사
묘사하다	m j oː sʰ a̠ ɦ a̠ d a̠	묘사하다
묘지	m j oː d͡ʑ i	묘지
무겁다	m u ɡ ʌ̹ p̚ t͈ a̠	무겁따
무게	m u ɡ e̞	무게
무국적	m u ɡ u k̚ t͡ɕ͈ ʌ̹ k̚	무국쩍
무궁화	m u ɡ u ŋ β w a̠	무궁화
무기고	m uː ɡ i ɡ o̞	무기고
무너지다	m u n ʌ̹ d͡ʑ i d a̠	무너지다
무능	m u n ɯ ŋ	무능
무늬	m u n i	무니
무당	m uː d a̠ ŋ	무당
무덥다	m u d ʌ̹ p̚ t͈ a̠	무덥따
무디다	m u d i d a̠	무디다
무뚝뚝하다	m u t͈ u k̚ t͈ u kʰ a̠ d a̠	무뚝뚜카다
무려	m u ɾ j ʌ̹	무려
무력	m u ɾ j ʌ̹ k̚	무력
무렵	m u ɾ j ʌ̹ p̚	무렵
무례	m u ɾ j e̞	무례
무료	m u ɾ j o	무료
무르다	m u ɾ ɯ d a̠	무르다
무릇	m u ɾ ɯ t̚	무륻
무릎	m u ɾ ɯ p̚	무릅
무리	m u ɾ i	무리
무리하다	m u ɾ i ɦ a̠ d a̠	무리하다
무마	m u m a̠	무마
무명	m u m j ʌ̹ ŋ	무명
무모하다	m u m o̞ ɦ a̠ d a̠	무모하다
무빙워크	m u b i ŋ w ʌ̹ k x ɯ	무비웍흐
무서움	m u sʰ ʌ̹ u m	무서움
무선	m u sʰ ʌ̹ n	무선
무선전화	m u sʰ ʌ̹ ɲ d͡ʑ ʌ̹ n β w a̠	무선전화
무섭다	m u sʰ ʌ̹ p̚ t͈ a̠	무섭따
무속	m uː sʰ o̞ k̚	무속
무속인	m uː sʰ o̞ ɡ i n	무소긴
무쇠	m u sʰ w e̞	무쇠
무술	m uː sʰ u ɭ	무술
무스카트	m u sʰ ɯ kʰ a̠ tʰ ɯ	무스카트
무승부	m u sʰ ɯ ŋ b u	무승부
무시하다	m u ɕʰ i ɦ a̠ d a̠	무시하다
무신론	m u ɕʰ i n n o̞ n	무신논
무언가	m u ʌ̹ n ɡ a̠	무언가
무언증	m u ʌ̹ ɲ t͡ɕ͈ ɯ ŋ	무언쯩
무얼	m u ʌ̹ ɭ	무얼
무엇	m u ʌ̹ t̚	무얻
무역	m uː j ʌ̹ k̚	무역
무예	m uː j e̞	무예
무인도	m u i n d o̞	무인도
무인점포	m u i ɲ d͡ʑ ʌ̹ m pʰ o̞	무인점포
무장하다	m uː d͡ʑ a̠ ŋ ɦ a̠ d a̠	무장하다
무정부주의	m u d͡ʑ ʌ̹ ŋ b u d͡ʑ u ɰ i	무정부주의
무제한	m u d͡ʑ e̞ ɦ a̠ n	무제한
무조건	m u d͡ʑ o̞ k͈ ʌ̹ n	무조껀
무죄	m u d͡ʑ w e̞	무죄
무중력	m u d͡ʑ u ŋ ɲ j ʌ̹ k̚	무중녁
무지하다	m u d͡ʑ i ɦ a̠ d a̠	무지하다
무진	m u d͡ʑ i n	무진
무진장	m u d͡ʑ i ɲ d͡ʑ a̠ ŋ	무진장
무찌르다	m u t͡ɕ͈ i ɾ ɯ d a̠	무찌르다
무척	m u t͡ɕʰ ʌ̹ k̚	무척
무치다	m u t͡ɕʰ i d a̠	무치다
무쿠리	m u kʰ u ɾ i	무쿠리
무탈	m u tʰ a̠ ɭ	무탈
무한	m u ɦ a̠ n	무한
무화과	m u β w a̠ ɡ w a̠	무화과
묵가	m u k̚ k͈ a̠	묵까
묵은지	m u ɡ ɯ ɲ d͡ʑ i	무근지
묶음	m u k͈ ɯ m	무끔
문과	m u n k͈ w a̠	문꽈
문구	m u n ɡ u	문구
문둥이	m u n d u ŋ i	문두이
문란	m uː ɭ ɭ a̠ n	물란
문명	m u n m j ʌ̹ ŋ	문명
문바람	m u n b a̠ ɾ a̠ m	문바람
문방	m u n b a̠ ŋ	문방
문법	m u n p͈ ʌ̹ p̚	문뻡
문어	m u n ʌ̹	무너
문제	m uː ɲ d͡ʑ e̞	문제
문제점	m u ɲ d͡ʑ e̞ d͡ʑ ʌ̹ m	문제점
문진	m u ɲ d͡ʑ i n	문진
문턱	m u n tʰ ʌ̹ k̚	문턱
문학	m u n ɦ a̠ k̚	문학
문헌	m u n ɦ ʌ̹ n	문헌
문혁	m u n ʝ j ʌ̹ k̚	문혁
문화	m u n β w a̠	문화
문화어	m u n β w a̠ ʌ̹	문화어
문화적	m u n β w a̠ d͡ʑ ʌ̹ k̚	문화적
물가	m u ɭ k͈ a̠	물까
물건	m u ɭ ɡ ʌ̹ n	물건
물결길이	m u ɭ ɡ j ʌ̹ ɭ ɡ i ɾ i	물결기리
물고기알	m u ɭ ɡ o̞ ɡ i a̠ ɭ	물고기알
물기	m u ɭ k͈ i	물끼
물놀이장	m u ɭ ɭ o̞ ɾ i d͡ʑ a̠ ŋ	물로리장
물들다	m u ɭ d ɯ ɭ d a̠	물들다
물들이다	m u ɭ d ɯ ɾ i d a̠	물드리다
물러나다	m u ɭ ɭ ʌ̹ n a̠ d a̠	물러나다
물러서다	m u ɭ ɭ ʌ̹ sʰ ʌ̹ d a̠	물러서다
물레	m u ɭ ɭ e̞	물레
물리학	m u ʎ ʎ i ɦ a̠ k̚	물리학
물리학자	m u ʎ ʎ i ɦ a̠ k̚ t͡ɕ͈ a̠	물리학짜
물리화학	m u ʎ ʎ i β w a̠ ɦ a̠ k̚	물리화학
물만두	m u ɭ m a̠ n d u	물만두
물망초	m u ɭ m a̠ ŋ t͡ɕʰ o̞	물망초
물방울	m u ɭ p͈ a̠ ŋ u ɭ	물빠울
물범	m u ɭ b ʌ̹ m	물범
물소	m u ɭ s͈ o̞	물쏘
물수리	m u ɭ s͈ u ɾ i	물쑤리
물시계	m u ɭ ɕ͈ i ɡ j e̞	물씨계
물어뜯다	m u ɾ ʌ̹ t͈ ɯ t̚ t͈ a̠	무러뜯따
물어보다	m u ɾ ʌ̹ b o̞ d a̠	무러보다
물음	m u ɾ ɯ m	무름
물증	m u ʎ d͡ʑ ɯ ŋ	물증
물질	m u ʎ t͡ɕ͈ i ɭ	물찔
물체	m u ʎ t͡ɕʰ e̞	물체
물통	m u ɭ tʰ o̞ ŋ	물통
물푸레나무	m u ɭ pʰ u ɾ e̞ n a̠ m u	물푸레나무
묽다	m u k̚ t͈ a̠	묵따
뭄바이	m u m b a̠ i	뭄바이
뮌헨	m ɥ i n ɦ e̞ n	뮌헨
미각	m i ɡ a̠ k̚	미각
미국	m i ɡ u k̚	미국
미국오리	m i ɡ u ɡ o̞ ɾ i	미구고리
미국인	m i ɡ u ɡ i n	미구긴
미꾸라지	m i k͈ u ɾ a̠ d͡ʑ i	미꾸라지
미끄럽다	m i k͈ ɯ ɾ ʌ̹ p̚ t͈ a̠	미끄럽따
미나리	m i n a̠ ɾ i	미나리
미남	m iː n a̠ m	미남
미녀	m iː ɲ j ʌ̹	미녀
미니버스	m i n i b ʌ̹ sʰ ɯ	미니버스
미니스커트	m i n i sʰ ɯ kʰ ʌ̹ tʰ ɯ	미니스커트
미덕	m iː d ʌ̹ k̚	미덕
미디어	m i d i ʌ̹	미디어
미라	m i ɾ a̠	미라
미루다	m i ɾ u d a̠	미루다
미르	m i ɾ ɯ	미르
미륵	m i ɾ ɯ k̚	미륵
미리보기	m i ɾ i b o̞ ɡ i	미리보기
미모	m iː m o̞	미모
미분	m i b u n	미분
미사	m i sʰ a̠	미사
미사일	m i sʰ a̠ i ɭ	미사일
미상	m iː sʰ a̠ ŋ	미상
미성	m iː sʰ ʌ̹ ŋ	미성
미성숙하다	m iː sʰ ʌ̹ ŋ sʰ u kʰ a̠ d a̠	미성수카다
미소녀	m iː sʰ o̞ ɲ j ʌ̹	미소녀
미소짓다	m i sʰ o̞ d͡ʑ i t̚ t͈ a̠	미소짇따
미수	m i sʰ u	미수
미술	m iː sʰ u ɭ	미술
미술관	m iː sʰ u ɭ ɡ w a̠ n	미술관
미스	m i sʰ ɯ	미스
미스터	m i sʰ ɯ tʰ ʌ̹	미스터
미아	m i a̠	미아
미안	m i a̠ n	미안
미얀마	m i j a̠ n m a̠	미얀마
미어	m i ʌ̹	미어
미어지다	m i ʌ̹ d͡ʑ i d a̠	미어지다
미역	m i j ʌ̹ k̚	미역
미역국	m i j ʌ̹ k̚ k͈ u k̚	미역꾹
미용실	m iː j o ŋ ɕʰ i ɭ	미용실
미적분	m i d͡ʑ ʌ̹ k̚ p͈ u n	미적뿐
미적지근하다	m i d͡ʑ ʌ̹ k̚ t͡ɕ͈ i ɡ ɯ n ɦ a̠ d a̠	미적찌근하다
미주	m i d͡ʑ u	미주
미주알	m i d͡ʑ u a̠ ɭ	미주알
미주알고주알	m i d͡ʑ u a̠ ɭ ɡ o̞ d͡ʑ u a̠ ɭ	미주알고주알
미지수	m iː d͡ʑ i sʰ u	미지수
미처	m i t͡ɕʰ ʌ̹	미처
미치광이	m i t͡ɕʰ i ɡ w a̠ ŋ i	미치과이
미치다	m i t͡ɕʰ i d a̠	미치다
미카엘	m i kʰ a̠ e̞ ɭ	미카엘
미터	m i tʰ ʌ̹	미터
미팅	m i tʰ i ŋ	미팅
미학	m iː ɦ a̠ k̚	미학
미합중국	m i ɦ a̠ p̚ t͡ɕ͈ u ŋ ɡ u k̚	미합쭝국
미혼모	m iː β o̞ n m o̞	미혼모
민간	m i n ɡ a̠ n	민간
민감	m i n ɡ a̠ m	민감
민감하다	m i n ɡ a̠ m ɦ a̠ d a̠	민감하다
민국	m i n ɡ u k̚	민국
민낯	m i n n a̠ t̚	민낟
민망	m i n m a̠ ŋ	민망
민병	m i n b j ʌ̹ ŋ	민병
민서	m i n s͈ ʌ̹	민써
민속	m i n sʰ o̞ k̚	민속
민요	m i ɲ j o	미뇨
민족주의	m i ɲ d͡ʑ o̞ k̚ t͡ɕ͈ u ɰ i	민족쭈의
민주	m i ɲ d͡ʑ u	민주
민주주의	m i ɲ d͡ʑ u d͡ʑ u ɰ i	민주주의
민중	m i ɲ d͡ʑ u ŋ	민중
민화	m i n β w a̠	민화
믿다	m i t̚ t͈ a̠	믿따
믿음	m i d ɯ m	미듬
밀가루	m i ɭ k͈ a̠ ɾ u	밀까루
밀도	m i ɭ t͈ o̞	밀또
밀랍	m i ɭ ɭ a̠ p̚	밀랍
밀리다	m i ʎ ʎ i d a̠	밀리다
밀리미터	m i ʎ ʎ i m i tʰ ʌ̹	밀리미터
밀림	m i ʎ ʎ i m	밀림
밀어	m i ɾ ʌ̹	미러
밀월	m i ɾ w ʌ̹ ɭ	미뤌
밀치다	m iː ʎ t͡ɕʰ i d a̠	밀치다
밀크	m i ɭ k x ɯ	밀ㄱ흐
밉다	m iː p̚ t͈ a̠	밉따
바게트	p͈ a̠ ɡ e̞ tʰ ɯ	빠게트
바곤	p a̠ ɡ o̞ n	바곤
바구니	p a̠ ɡ u n i	바구니
바그다드	p a̠ ɡ ɯ d a̠ d ɯ	바그다드
바그르르	p a̠ ɡ ɯ ɾ ɯ ɾ ɯ	바그르르
바글바글	p a̠ ɡ ɯ ɭ b a̠ ɡ ɯ ɭ	바글바글
바깥	p a̠ k͈ a̠ t̚	바깓
바깥어른	p a̠ k͈ a̠ d ʌ̹ ɾ ɯ n	바까더른
바깥쪽	p a̠ k͈ a̠ t̚ t͡ɕ͈ o̞ k̚	바깓쪽
바뀌다	p a̠ k͈ ɥ i d a̠	바뀌다
바누아투	p a̠ n u a̠ tʰ u	바누아투
바늘	p a̠ n ɯ ɭ	바늘
바다	p a̠ d a̠	바다
바다사자	p a̠ d a̠ sʰ a̠ d͡ʑ a̠	바다사자
바다코끼리	p a̠ d a̠ kʰ o̞ k͈ i ɾ i	바다코끼리
바다표범	p a̠ d a̠ pʰ j o b ʌ̹ m	바다표범
바닷가	p a̠ d a̠ t̚ k͈ a̠	바닫까
바닷물	p a̠ d a̠ n m u ɭ	바단물
바둑	p a̠ d u k̚	바둑
바라다	p a̠ ɾ a̠ d a̠	바라다
바라보다	p a̠ ɾ a̠ b o̞ d a̠	바라보다
바람	p a̠ ɾ a̠ m	바람
바람둥이	p a̠ ɾ a̠ m d u ŋ i	바람두이
바람직하다	p a̠ ɾ a̠ m d͡ʑ i kʰ a̠ d a̠	바람지카다
바레인	p a̠ ɾ e̞ i n	바레인
바로	p a̠ ɾ o̞	바로
바로잡다	p a̠ ɾ o̞ d͡ʑ a̠ p̚ t͈ a̠	바로잡따
바륨	p a̠ ɾ j u m	바륨
바르다	p a̠ ɾ ɯ d a̠	바르다
바르샤바	p a̠ ɾ ɯ ɕʰ a̠ b a̠	바르사바
바리	p a̠ ɾ i	바리
바마코	p a̠ m a̠ kʰ o̞	바마코
바베이도스	p a̠ b e̞ i d o̞ sʰ ɯ	바베이도스
바보	p a̠ː b o̞	바보
바쁘다	p a̠ p͈ ɯ d a̠	바쁘다
바수다	p a̠ sʰ u d a̠	바수다
바스라기	p a̠ sʰ ɯ ɾ a̠ ɡ i	바스라기
바스락바스락	p a̠ sʰ ɯ ɾ a̠ k̚ p͈ a̠ sʰ ɯ ɾ a̠ k̚	바스락빠스락
바싹	p a̠ s͈ a̠ k̚	바싹
바알	p a̠ a̠ ɭ	바알
바오로	p a̠ o̞ ɾ o̞	바오로
바오즈	p a̠ o̞ d͡ʑ ɯ	바오즈
바위	p a̠ ɥ i	바위
바이든	p a̠ i d ɯ n	바이든
바이러스	p a̠ i ɾ ʌ̹ sʰ ɯ	바이러스
바이블	p a̠ i b ɯ ɭ	바이블
바이슨	p a̠ i sʰ ɯ n	바이슨
바이오	p a̠ i o̞	바이오
바이올린	p a̠ i o̞ ʎ ʎ i n	바이올린
바이트	p a̠ i tʰ ɯ	바이트
바자회	p a̠ d͡ʑ a̠ β w e̞	바자회
바지	p a̠ d͡ʑ i	바지
바지락	p a̠ d͡ʑ i ɾ a̠ k̚	바지락
바질	p a̠ d͡ʑ i ɭ	바질
바쿠	p a̠ kʰ u	바쿠
바퀴	p a̠ kʰ ɥ i	바퀴
바탕	p a̠ tʰ a̠ ŋ	바탕
바텐더	p a̠ tʰ e̞ n d ʌ̹	바텐더
바티칸	p a̠ tʰ i kʰ a̠ n	바티칸
바하마	p a̠ ɦ a̠ m a̠	바하마
박동	p a̠ k̚ t͈ o̞ ŋ	박똥
박람회	p a̠ ŋ n a̠ m β w e̞	방남회
박물관	p a̠ ŋ m u ɭ ɡ w a̠ n	방물관
박사	p a̠ k s͈ a̠	박싸
박수	p a̠ k s͈ u	박쑤
박스	p a̠ k s͈ ɯ	박쓰
박이	p a̠ ɡ i	바기
박제	p a̠ k̚ t͡ɕ͈ e̞	박쩨
박쥐	p a̠ː k̚ t͡ɕ͈ ɥ i	박쮜
박차	p a̠ k̚ t͡ɕʰ a̠	박차
박치기	p a̠ k̚ t͡ɕʰ i ɡ i	박치기
박테리아	p a̠ k̚ tʰ e̞ ɾ i a̠	박테리아
박하	p a̠ kʰ a̠	바카
밖에	p a̠ k͈ e̞	바께
반경	p a̠ː n ɡ j ʌ̹ ŋ	반경
반구	p a̠ː n ɡ u	반구
반년	p a̠ː n ɲ j ʌ̹ n	반년
반도	p a̠ː n d o̞	반도
반도체	p a̠ː n d o̞ t͡ɕʰ e̞	반도체
반드시	p a̠ n d ɯ ɕʰ i	반드시
반듯이	p a̠ n d ɯ ɕʰ i	반드시
반듯하다	p a̠ n d ɯ tʰ a̠ d a̠	반드타다
반딧불	p a̠ n d i t̚ p͈ u ɭ	반딛뿔
반딧불이	p a̠ n d i t̚ p͈ u ɾ i	반딛뿌리
반려	p a̠ː ʎ ʎ j ʌ̹	발려
반말	p a̠ n m a̠ ɭ	반말
반면	p a̠ː n m j ʌ̹ n	반면
반바지	p a̠ː n b a̠ d͡ʑ i	반바지
반박	p a̠ː n b a̠ k̚	반박
반반	p a̠ː n b a̠ n	반반
반발	p a̠ː n b a̠ ɭ	반발
반복	p a̠ː n b o̞ k̚	반복
반복하다	p a̠ n b o̞ kʰ a̠ d a̠	반보카다
반사	p a̠ː n sʰ a̠	반사
반시옷	p a̠ n ɕʰ i o̞ t̚	반시옫
반시읏	p a̠ː n ɕʰ i ɯ t̚	반시읃
반신반인	p a̠ː n ɕʰ i n b a̠ n i n	반신바닌
반역	p a̠ː ɲ j ʌ̹ k̚	바녁
반영	p a̠ː ɲ j ʌ̹ ŋ	바녕
반올림	p a̠ː n o̞ ʎ ʎ i m	바놀림
반응	p a̠ː n ɯ ŋ	바능
반의어	p a̠ː n ɰ i ʌ̹	바늬어
반장	p a̠ ɲ d͡ʑ a̠ ŋ	반장
반절	p a̠ː ɲ d͡ʑ ʌ̹ ɭ	반절
반죽	p a̠ ɲ d͡ʑ u k̚	반죽
반지름	p a̠ː ɲ d͡ʑ i ɾ ɯ m	반지름
반지하	p a̠ː ɲ d͡ʑ i ɦ a̠	반지하
반짝	p a̠ ɲ t͡ɕ͈ a̠ k̚	반짝
반짝반짝	p a̠ ɲ t͡ɕ͈ a̠ k̚ p͈ a̠ ɲ t͡ɕ͈ a̠ k̚	반짝빤짝
반짝이다	p a̠ ɲ t͡ɕ͈ a̠ ɡ i d a̠	반짜기다
반찬	p a̠ ɲ t͡ɕʰ a̠ n	반찬
반창고	p a̠ ɲ t͡ɕʰ a̠ ŋ ɡ o̞	반창고
반추	p a̠ː ɲ t͡ɕʰ u	반추
반치음	p a̠ː ɲ t͡ɕʰ i ɯ m	반치음
반포	p a̠ n pʰ o̞	반포
반품	p a̠ː n pʰ u m	반품
반항하다	p a̠ n ɦ a̠ ŋ ɦ a̠ d a̠	반항하다
받다	p a̠ t̚ t͈ a̠	받따
받아들이다	p a̠ d a̠ d ɯ ɾ i d a̠	바다드리다
받아쓰기	p a̠ d a̠ s͈ ɯ ɡ i	바다쓰기
받침	p a̠ t̚ t͡ɕʰ i m	받침
발가락	p a̠ ɭ k͈ a̠ ɾ a̠ k̚	발까락
발간	p a̠ ɭ ɡ a̠ n	발간
발견	p a̠ ɭ ɡ j ʌ̹ n	발견
발견되다	p a̠ ɭ ɡ j ʌ̹ n d w e̞ d a̠	발견되다
발견하다	p a̠ ɭ ɡ j ʌ̹ n ɦ a̠ d a̠	발견하다
발기	p a̠ ɭ ɡ i	발기
발기부전	p a̠ ɭ ɡ i b u d͡ʑ ʌ̹ n	발기부전
발꿈치	p a̠ ɭ k͈ u m t͡ɕʰ i	발꿈치
발끝	p a̠ ɭ k͈ ɯ t̚	발끋
발뒤꿈치	p a̠ ɭ t͈ ɥ i k͈ u m t͡ɕʰ i	발뛰꿈치
발라드	p a̠ ɭ ɭ a̠ d ɯ	발라드
발란	p a̠ː ɭ ɭ a̠ n	발란
발레	p a̠ ɭ ɭ e̞	발레
발리볼	p a̠ ʎ ʎ i b o̞ ɭ	발리볼
발명	p a̠ ɭ m j ʌ̹ ŋ	발명
발목	p a̠ ɭ m o̞ k̚	발목
발바닥	p a̠ ɭ p͈ a̠ d a̠ k̚	발빠닥
발열	p a̠ ɾ j ʌ̹ ɭ	바렬
발음	p a̠ ɾ ɯ m	바름
발음하다	p a̠ ɾ ɯ m ɦ a̠ d a̠	바름하다
발인	p a̠ ɾ i n	바린
발자국	p a̠ ʎ t͡ɕ͈ a̠ ɡ u k̚	발짜국
발전하다	p a̠ ʎ t͡ɕ͈ ʌ̹ n ɦ a̠ d a̠	발쩐하다
발정	p a̠ ʎ t͡ɕ͈ ʌ̹ ŋ	발쩡
발코니	p a̠ ɭ kʰ o̞ n i	발코니
발탁	p a̠ ɭ tʰ a̠ k̚	발탁
발톱	p a̠ ɭ tʰ o̞ p̚	발톱
발표	p a̠ ɭ pʰ j o	발표
발효	p a̠ ɾ ʝ j o	발효
발휘하다	p a̠ ɾ ɦ ɥ i ɦ a̠ d a̠	발휘하다
밝다	p a̠ k̚ t͈ a̠	박따
밤낮	p a̠ m n a̠ t̚	밤낟
밤하늘	p a̠ m ɦ a̠ n ɯ ɭ	밤하늘
밥벌이	p a̠ p̚ p͈ ʌ̹ ɾ i	밥뻐리
밥상	p a̠ p s͈ a̠ ŋ	밥쌍
밥솥	p a̠ p s͈ o̞ t̚	밥쏟
밥집	p a̠ p̚ t͡ɕ͈ i p̚	밥찝
방과후	p a̠ː ŋ ɡ w a̠ β u	방과후
방광	p a̠ ŋ ɡ w a̠ ŋ	방광
방광암	p a̠ ŋ ɡ w a̠ ŋ a̠ m	방과암
방광염	p a̠ ŋ ɡ w a̠ ŋ ɲ j ʌ̹ m	방광념
방구	p a̠ ŋ ɡ u	방구
방귀	p a̠ː ŋ ɡ ɥ i	방귀
방글라데시	p a̠ ŋ ɡ ɯ ɭ ɭ a̠ d e̞ ɕʰ i	방글라데시
방금	p a̠ ŋ ɡ ɯ m	방금
방망이	p a̠ ŋ m a̠ ŋ i	방마이
방면	p a̠ ŋ m j ʌ̹ n	방면
방문	p a̠ː ŋ m u n	방문
방법	p a̠ ŋ b ʌ̹ p̚	방법
방법론	p a̠ ŋ b ʌ̹ m n o̞ n	방범논
방사능	p a̠ː ŋ sʰ a̠ n ɯ ŋ	방사능
방사선	p a̠ː ŋ sʰ a̠ sʰ ʌ̹ n	방사선
방석집	p a̠ ŋ sʰ ʌ̹ k̚ t͡ɕ͈ i p̚	방석찝
방송	p a̠ː ŋ sʰ o̞ ŋ	방송
방송간섭	p a̠ː ŋ sʰ o̞ ŋ ɡ a̠ n sʰ ʌ̹ p̚	방송간섭
방송국	p a̠ː ŋ sʰ o̞ ŋ ɡ u k̚	방송국
방송원	p a̠ː ŋ sʰ o̞ ŋ w ʌ̹ n	방소원
방숭이	p a̠ː ŋ sʰ u ŋ i	방수이
방식	p a̠ ŋ ɕʰ i k̚	방식
방심	p a̠ ŋ ɕʰ i m	방심
방아	p a̠ ŋ a̠	바아
방아쇠	p a̠ ŋ a̠ sʰ w e̞	바아쇠
방앗간	p a̠ ŋ a̠ t̚ k͈ a̠ n	바앋깐
방어	p a̠ ŋ ʌ̹	바어
방어하다	p a̠ ŋ ʌ̹ ɦ a̠ d a̠	바어하다
방언	p a̠ ŋ ʌ̹ n	바언
방역	p a̠ ŋ j ʌ̹ k̚	바역
방영	p a̠ː ŋ j ʌ̹ ŋ	바영
방위각	p a̠ ŋ ɥ i ɡ a̠ k̚	바위각
방위산업체	p a̠ ŋ ɥ i sʰ a̠ n ʌ̹ p̚ t͡ɕʰ e̞	바위사넙체
방점	p a̠ ŋ t͡ɕ͈ ʌ̹ m	방쩜
방정식	p a̠ ŋ d͡ʑ ʌ̹ ŋ ɕʰ i k̚	방정식
방조	p a̠ ŋ d͡ʑ o̞	방조
방주	p a̠ ŋ d͡ʑ u	방주
방지	p a̠ ŋ d͡ʑ i	방지
방출	p a̠ː ŋ t͡ɕʰ u ɭ	방출
방탄	p a̠ ŋ tʰ a̠ n	방탄
방편	p a̠ ŋ pʰ j ʌ̹ n	방편
방학	p a̠ ŋ ɦ a̠ k̚	방학
방향	p a̠ ŋ ʝ j a̠ ŋ	방향
배경	p ɛː ɡ j ʌ̹ ŋ	배경
배교	p ɛː ɡ j o	배교
배낭	p ɛː n a̠ ŋ	배낭
배다	p ɛː d a̠	배다
배달	p ɛː d a̠ ɭ	배달
배당	p ɛː d a̠ ŋ	배당
배반하다	p ɛː b a̠ n ɦ a̠ d a̠	배반하다
배부	p ɛː b u	배부
배송	p ɛː sʰ o̞ ŋ	배송
배수관	p ɛː sʰ u ɡ w a̠ n	배수관
배신	p ɛː ɕʰ i n	배신
배신하다	p ɛː ɕʰ i n ɦ a̠ d a̠	배신하다
배심	p ɛː ɕʰ i m	배심
배심원	p ɛː ɕʰ i m w ʌ̹ n	배시뭔
배우자	p ɛː u d͡ʑ a̠	배우자
배추	p ɛː t͡ɕʰ u	배추
뱀장어	p ɛː m d͡ʑ a̠ ŋ ʌ̹	뱀자어
뱅어	p ɛː ŋ ʌ̹	배어
뱉다	p ɛː t̚ t͈ a̠	밷따
버거	p ʌ̹ ɡ ʌ̹	버거
버그	p ʌ̹ ɡ ɯ	버그
버그르르	p ʌ̹ ɡ ɯ ɾ ɯ ɾ ɯ	버그르르
버들가지	p ʌ̹ d ɯ ɭ ɡ a̠ d͡ʑ i	버들가지
버들붕어	p ʌ̹ d ɯ ɭ b u ŋ ʌ̹	버들부어
버러지	p ʌ̹ ɾ ʌ̹ d͡ʑ i	버러지
버리다	p ʌ̹ ɾ i d a̠	버리다
버마	p ʌ̹ m a̠	버마
버무리다	p ʌ̹ m u ɾ i d a̠	버무리다
버미	p ɘː m i	버미
버버리	p ʌ̹ b ʌ̹ ɾ i	버버리
버선	p ʌ̹ sʰ ʌ̹ n	버선
버섯	p ʌ̹ sʰ ʌ̹ t̚	버섣
버전	p ʌ̹ d͡ʑ ʌ̹ n	버전
버지니아	p ʌ̹ d͡ʑ i n i a̠	버지니아
버클	p ʌ̹ k x ɯ ɭ	벅흘
버티다	p ʌ̹ tʰ i d a̠	버티다
버팔로	p ʌ̹ pʰ a̠ ɭ ɭ o̞	버팔로
벅차다	p ʌ̹ k̚ t͡ɕʰ a̠ d a̠	벅차다
번데기	p ʌ̹ n d e̞ ɡ i	번데기
번역	p ʌ̹ ɲ j ʌ̹ k̚	버녁
번역가	p ʌ̹ ɲ j ʌ̹ k̚ k͈ a̠	버녁까
번영	p ʌ̹ ɲ j ʌ̹ ŋ	버녕
번쩍번쩍	p ʌ̹ ɲ t͡ɕ͈ ʌ̹ k̚ p͈ ʌ̹ ɲ t͡ɕ͈ ʌ̹ k̚	번쩍뻔쩍
번호	p ʌ̹ n β o̞	번호
벌거벗다	p ʌ̹ ɭ ɡ ʌ̹ b ʌ̹ t̚ t͈ a̠	벌거벋따
벌꿀	p ɘː ɭ k͈ u ɭ	벌꿀
벌다	p ɘː ɭ d a̠	벌다
벌떡	p ʌ̹ ɭ t͈ ʌ̹ k̚	벌떡
벌써	p ʌ̹ ɭ s͈ ʌ̹	벌써
벌어지다	p ɘː ɾ ʌ̹ d͡ʑ i d a̠	버러지다
범부	p ɘː m b u	범부
범아귀	p ɘː m a̠ ɡ ɥ i	버마귀
범위	p ɘː m ɥ i	버뮈
범인	p ɘː m i n	버민
범죄	p ɘː m d͡ʑ w e̞	범죄
범죄자	p ɘː m d͡ʑ w e̞ d͡ʑ a̠	범죄자
범주	p ɘː m d͡ʑ u	범주
법가	p ʌ̹ p̚ k͈ a̠	법까
법관	p ʌ̹ p̚ k͈ w a̠ n	법꽌
법랑질	p ʌ̹ m n a̠ ŋ d͡ʑ i ɭ	범낭질
법령	p ʌ̹ m ɲ j ʌ̹ ŋ	범녕
법륜	p ʌ̹ m ɲ j u n	범뉸
법률	p ʌ̹ m ɲ j u ɭ	범뉼
법률학	p ʌ̹ m ɲ j u ɾ ɦ a̠ k̚	범뉼학
법무부	p ʌ̹ m m u b u	범무부
법안	p ʌ̹ b a̠ n	버반
법원	p ʌ̹ b w ʌ̹ n	버붠
법인	p ʌ̹ b i n	버빈
법정	p ʌ̹ p̚ t͡ɕ͈ ʌ̹ ŋ	법쩡
법학	p ʌ̹ pʰ a̠ k̚	버팍
벗겨지다	p ʌ̹ t̚ k͈ j ʌ̹ d͡ʑ i d a̠	벋껴지다
벙어리	p ʌ̹ ŋ ʌ̹ ɾ i	버어리
벚꽃	p ʌ̹ t̚ k͈ o̞ t̚	벋꼳
베네수엘라	p e̞ n e̞ sʰ u e̞ ɭ ɭ a̠	베네수엘라
베니스	p e̞ n i sʰ ɯ	베니스
베닌	p e̞ n i n	베닌
베드로	p e̞ d ɯ ɾ o̞	베드로
베를린	p e̞ ɾ ɯ ʎ ʎ i n	베를린
베스트셀러	p e̞ sʰ ɯ tʰ ɯ sʰ e̞ ɭ ɭ ʌ̹	베스트셀러
베스푸치	p e̞ sʰ ɯ pʰ u t͡ɕʰ i	베스푸치
베오그라드	p e̞ o̞ ɡ ɯ ɾ a̠ d ɯ	베오그라드
베이루트	p e̞ i ɾ u tʰ ɯ	베이루트
베이징	p e̞ i d͡ʑ i ŋ	베이징
베이컨	p e̞ i kʰ ʌ̹ n	베이컨
베짱이	p e̞ t͡ɕ͈ a̠ ŋ i	베짜이
베트남	p e̞ tʰ ɯ n a̠ m	베트남
베트남어	p e̞ tʰ ɯ n a̠ m ʌ̹	베트나머
베풀다	p e̞ pʰ u ɭ d a̠	베풀다
벤젠	p e̞ ɲ d͡ʑ e̞ n	벤젠
벤질기	p e̞ ɲ d͡ʑ i ɭ ɡ i	벤질기
벤치	p e̞ ɲ t͡ɕʰ i	벤치
벨기에	p e̞ ɭ ɡ i e̞	벨기에
벨라루스	p e̞ ɭ ɭ a̠ ɾ u sʰ ɯ	벨라루스
벨리즈	p e̞ ʎ ʎ i d͡ʑ ɯ	벨리즈
벨모판	p e̞ ɭ m o̞ pʰ a̠ n	벨모판
벨벳	p e̞ ɭ b e̞ t̚	벨벧
벨트	p e̞ ɭ tʰ ɯ	벨트
벼락	p j ʌ̹ ɾ a̠ k̚	벼락
벼락부자	p j ʌ̹ ɾ a̠ k̚ p͈ u d͡ʑ a̠	벼락뿌자
벼랑	p j ʌ̹ ɾ a̠ ŋ	벼랑
벼리다	p j ʌ̹ ɾ i d a̠	벼리다
벼슬	p j ʌ̹ sʰ ɯ ɭ	벼슬
벽자	p j ʌ̹ k̚ t͡ɕ͈ a̠	벽짜
벽장	p j ʌ̹ k̚ t͡ɕ͈ a̠ ŋ	벽짱
변기	p j ʌ̹ n ɡ i	변기
변동	p j ɘː n d o̞ ŋ	변동
변변하다	p j ʌ̹ n b j ʌ̹ n ɦ a̠ d a̠	변변하다
변비	p j ʌ̹ n b i	변비
변소	p j ʌ̹ n sʰ o̞	변소
변수	p j ɘː n sʰ u	변수
변압기	p j ʌ̹ n a̠ p̚ k͈ i	벼납끼
변이하다	p j ɘː n i ɦ a̠ d a̠	벼니하다
변한	p j ɘː n ɦ a̠ n	변한
변형	p j ɘː n ʝ j ʌ̹ ŋ	변형
변호사	p j ɘː n β o̞ sʰ a̠	변호사
변화	p j ɘː n β w a̠	변화
변환	p j ɘː n β w a̠ n	변환
별거	p j ʌ̹ ɭ ɡ ʌ̹	별거
별다르다	p j ʌ̹ ɭ d a̠ ɾ ɯ d a̠	별다르다
별도	p j ʌ̹ ɭ t͈ o̞	별또
별명	p j ʌ̹ ɭ m j ʌ̹ ŋ	별명
별별	p j ʌ̹ ɭ b j ʌ̹ ɭ	별별
별빛	p j ɘː ɭ p͈ i t̚	별삗
별세	p j ʌ̹ ɭ s͈ e̞	별쎄
별세하다	p j ʌ̹ ɭ s͈ e̞ ɦ a̠ d a̠	별쎄하다
별실	p j ʌ̹ ɭ ɕ͈ i ɭ	별씰
별일	p j ʌ̹ ɾ i ɭ	벼릴
별표	p j ɘː ɭ pʰ j o	별표
볏짚	p j ʌ̹ t̚ t͡ɕ͈ i p̚	볃찝
병기고	p j ʌ̹ ŋ ɡ i ɡ o̞	병기고
병들다	p j ɘː ŋ d ɯ ɭ d a̠	병들다
병리학	p j ɘː ŋ n i ɦ a̠ k̚	병니학
병법	p j ʌ̹ ŋ p͈ ʌ̹ p̚	병뻡
병사	p j ʌ̹ ŋ sʰ a̠	병사
병신	p j ɘː ŋ ɕʰ i n	병신
병아리	p j ʌ̹ ŋ a̠ ɾ i	벼아리
병역	p j ʌ̹ ŋ j ʌ̹ k̚	벼역
병원	p j ɘː ŋ w ʌ̹ n	벼원
병풍	p j ʌ̹ ŋ pʰ u ŋ	병풍
병합	p j ɘː ŋ ɦ a̠ p̚	병합
보건	p o̞ː ɡ ʌ̹ n	보건
보건소	p o̞ː ɡ ʌ̹ n sʰ o̞	보건소
보고	p o̞ː ɡ o̞	보고
보고서	p o̞ː ɡ o̞ sʰ ʌ̹	보고서
보고타	p o̞ ɡ o̞ tʰ a̠	보고타
보고하다	p o̞ː ɡ o̞ ɦ a̠ d a̠	보고하다
보관	p o̞ː ɡ w a̠ n	보관
보그르르	p o̞ ɡ ɯ ɾ ɯ ɾ ɯ	보그르르
보글보글	p o̞ ɡ ɯ ɭ b o̞ ɡ ɯ ɭ	보글보글
보기	p o̞ ɡ i	보기
보너스	p o̞ n ʌ̹ sʰ ɯ	보너스
보닛	p o̞ n i t̚	보닏
보다	p o̞ d a̠	보다
보다도	p o̞ d a̠ d o̞	보다도
보드	p o̞ d ɯ	보드
보드카	p o̞ d ɯ kʰ a̠	보드카
보디빌딩	p o̞ d i b i ɭ d i ŋ	보디빌딩
보따리	p o̞ t͈ a̠ ɾ i	보따리
보라	p o̞ ɾ a̠	보라
보람	p o̞ ɾ a̠ m	보람
보름	p o̞ ɾ ɯ m	보름
보름날	p o̞ ɾ ɯ m n a̠ ɭ	보름날
보리	p o̞ ɾ i	보리
보물	p o̞ː m u ɭ	보물
보병	p o̞ː b j ʌ̹ ŋ	보병
보복	p o̞ː b o̞ k̚	보복
보사삭	p o̞ sʰ a̠ sʰ a̠ k̚	보사삭
보살	p o̞ sʰ a̠ ɭ	보살
보살피다	p o̞ sʰ a̠ ɭ pʰ i d a̠	보살피다
보상	p o̞ː sʰ a̠ ŋ	보상
보상하다	p o̞ː sʰ a̠ ŋ ɦ a̠ d a̠	보상하다
보석	p o̞ː sʰ ʌ̹ k̚	보석
보수주의	p o̞ː sʰ u d͡ʑ u ɰ i	보수주의
보스니아	p o̞ sʰ ɯ n i a̠	보스니아
보슬보슬	p o̞ sʰ ɯ ɭ b o̞ sʰ ɯ ɭ	보슬보슬
보신탕	p o̞ː ɕʰ i n tʰ a̠ ŋ	보신탕
보안	p o̞ː a̠ n	보안
보온병	p o̞ː o̞ n b j ʌ̹ ŋ	보온병
보일러	p o̞ i ɭ ɭ ʌ̹	보일러
보잉	p o̞ i ŋ	보잉
보잘것없다	p o̞ d͡ʑ a̠ ɭ k͈ ʌ̹ sʰ ʌ̹ p̚ t͈ a̠	보잘꺼섭따
보증	p o̞ d͡ʑ ɯ ŋ	보증
보지	p o̞ː d͡ʑ i	보지
보충하다	p o̞ː t͡ɕʰ u ŋ ɦ a̠ d a̠	보충하다
보츠와나	p o̞ t͡ɕʰ ɯ w a̠ n a̠	보츠와나
보통	p o̞ː tʰ o̞ ŋ	보통
보편적	p o̞ː pʰ j ʌ̹ ɲ d͡ʑ ʌ̹ k̚	보편적
보험	p o̞ː ɦ ʌ̹ m	보험
보호	p o̞ː β o̞	보호
보호하다	p o̞ː β o̞ ɦ a̠ d a̠	보호하다
복건성	p o̞ k̚ k͈ ʌ̹ n sʰ ʌ̹ ŋ	복껀성
복권	p o̞ k̚ k͈ w ʌ̹ n	복꿘
복날	p o̞ ŋ n a̠ ɭ	봉날
복도	p o̞ k̚ t͈ o̞	복또
복력	p o̞ ŋ ɲ j ʌ̹ k̚	봉녁
복병	p o̞ k̚ p͈ j ʌ̹ ŋ	복뼝
복불복	p o̞ k̚ p͈ u ɭ b o̞ k̚	복뿔복
복사	p o̞ k s͈ a̠	복싸
복사기	p o̞ k s͈ a̠ ɡ i	복싸기
복선	p o̞ k s͈ ʌ̹ n	복썬
복소수	p o̞ k s͈ o̞ s͈ u	복쏘쑤
복수	p o̞ k s͈ u	복쑤
복수전	p o̞ k s͈ u d͡ʑ ʌ̹ n	복쑤전
복수하다	p o̞ k s͈ u ɦ a̠ d a̠	복쑤하다
복숭아	p o̞ k s͈ u ŋ a̠	복쑤아
복스럽다	p o̞ k s͈ ɯ ɾ ʌ̹ p̚ t͈ a̠	복쓰럽따
복습	p o̞ k s͈ ɯ p̚	복씁
복싱	p o̞ k ɕ͈ i ŋ	복씽
복엽기	p o̞ ɡ j ʌ̹ p̚ k͈ i	보겹끼
복음서	p o̞ ɡ ɯ m sʰ ʌ̹	보금서
복잡	p o̞ k̚ t͡ɕ͈ a̠ p̚	복짭
복제	p o̞ k̚ t͡ɕ͈ e̞	복쩨
복호	p o̞ kʰ o̞	보코
볶다	p o̞ k̚ t͈ a̠	복따
본능	p o̞ n n ɯ ŋ	본능
본문	p o̞ n m u n	본문
본사	p o̞ n sʰ a̠	본사
본성	p o̞ n sʰ ʌ̹ ŋ	본성
본질	p o̞ ɲ d͡ʑ i ɭ	본질
본토	p o̞ n tʰ o̞	본토
볼리비아	p o̞ ʎ ʎ i b i a̠	볼리비아
볼링	p o̞ ʎ ʎ i ŋ	볼링
볼일	p o̞ː ʎ ʎ i ɭ	볼릴
볼트	p o̞ ɭ tʰ ɯ	볼트
볼펜	p o̞ ɭ pʰ e̞ n	볼펜
봄바람	p o̞ m p͈ a̠ ɾ a̠ m	봄빠람
봄철	p o̞ m t͡ɕʰ ʌ̹ ɭ	봄철
봉건	p o̞ ŋ ɡ ʌ̹ n	봉건
봉급	p o̞ː ŋ ɡ ɯ p̚	봉급
봉기	p o̞ ŋ ɡ i	봉기
봉사	p o̞ː ŋ sʰ a̠	봉사
봉우리	p o̞ ŋ u ɾ i	보우리
봉지	p o̞ ŋ d͡ʑ i	봉지
봉착	p o̞ ŋ t͡ɕʰ a̠ k̚	봉착
봉착하다	p o̞ ŋ t͡ɕʰ a̠ kʰ a̠ d a̠	봉차카다
봉투	p o̞ ŋ tʰ u	봉투
봐주다	p w a̠ː d͡ʑ u d a̠	봐주다
부검	p uː ɡ ʌ̹ m	부검
부근	p uː ɡ ɯ n	부근
부끄러움	p u k͈ ɯ ɾ ʌ̹ u m	부끄러움
부끄러워하다	p u k͈ ɯ ɾ ʌ̹ w ʌ̹ ɦ a̠ d a̠	부끄러워하다
부끄리다	p u k͈ ɯ ɾ i d a̠	부끄리다
부농	p uː n o̞ ŋ	부농
부다페스트	p u d a̠ pʰ e̞ sʰ ɯ tʰ ɯ	부다페스트
부담하다	p uː d a̠ m ɦ a̠ d a̠	부담하다
부동산	p u d o̞ ŋ sʰ a̠ n	부동산
부두	p u d u	부두
부드럽다	p u d ɯ ɾ ʌ̹ p̚ t͈ a̠	부드럽따
부들	p u d ɯ ɭ	부들
부딪다	p u d i t̚ t͈ a̠	부딛따
부러뜨리다	p u ɾ ʌ̹ t͈ ɯ ɾ i d a̠	부러뜨리다
부러움	p u ɾ ʌ̹ u m	부러움
부럼없다	p u ɾ ʌ̹ m ʌ̹ p̚ t͈ a̠	부러멉따
부럽다	p u ɾ ʌ̹ p̚ t͈ a̠	부럽따
부록	p uː ɾ o̞ k̚	부록
부룬디	p u ɾ u n d i	부룬디
부류	p u ɾ j u	부류
부르다	p u ɾ ɯ d a̠	부르다
부르죠아	p u ɾ ɯ d͡ʑ o a̠	부르죠아
부르짖다	p u ɾ ɯ d͡ʑ i t̚ t͈ a̠	부르짇따
부르트다	p u ɾ ɯ tʰ ɯ d a̠	부르트다
부름	p u ɾ ɯ m	부름
부리	p u ɾ i	부리
부리나케	p u ɾ i n a̠ kʰ e̞	부리나케
부리다	p u ɾ i d a̠	부리다
부모	p u m o̞	부모
부모님	p u m o̞ n i m	부모님
부부	p u b u	부부
부분	p u b u n	부분
부분적	p u b u ɲ d͡ʑ ʌ̹ k̚	부분적
부사	p uː sʰ a̠	부사
부산	p u sʰ a̠ n	부산
부상자	p uː sʰ a̠ ŋ d͡ʑ a̠	부상자
부서	p u sʰ ʌ̹	부서
부서석	p u sʰ ʌ̹ sʰ ʌ̹ k̚	부서석
부서지다	p u sʰ ʌ̹ d͡ʑ i d a̠	부서지다
부수	p u sʰ u	부수
부스러기	p u sʰ ɯ ɾ ʌ̹ ɡ i	부스러기
부스럭부스럭	p u sʰ ɯ ɾ ʌ̹ k̚ p͈ u sʰ ɯ ɾ ʌ̹ k̚	부스럭뿌스럭
부슬부슬	p u sʰ ɯ ɭ b u sʰ ɯ ɭ	부슬부슬
부신	p uː ɕʰ i n	부신
부썩	p u s͈ ʌ̹ k̚	부썩
부썩부썩	p u s͈ ʌ̹ k̚ p͈ u s͈ ʌ̹ k̚	부썩뿌썩
부아	p u a̠	부아
부아소리	p u a̠ sʰ o̞ ɾ i	부아소리
부엉이	p u ʌ̹ ŋ i	부어이
부에노스아이레스	p u e̞ n o̞ sʰ ɯ a̠ i ɾ e̞ sʰ ɯ	부에노스아이레스
부여	p u j ʌ̹	부여
부여하다	p uː j ʌ̹ ɦ a̠ d a̠	부여하다
부위	p u ɥ i	부위
부유	p uː j u	부유
부유하다	p uː j u ɦ a̠ d a̠	부유하다
부이온	p u i o̞ n	부이온
부인하다	p uː i n ɦ a̠ d a̠	부인하다
부임	p uː i m	부임
부임하다	p u i m ɦ a̠ d a̠	부임하다
부작용	p uː d͡ʑ a̠ ɡ j o ŋ	부자굥
부장	p u d͡ʑ a̠ ŋ	부장
부적	p uː d͡ʑ ʌ̹ k̚	부적
부전자전	p u d͡ʑ ʌ̹ ɲ d͡ʑ a̠ d͡ʑ ʌ̹ n	부전자전
부정관사	p u d͡ʑ ʌ̹ ŋ ɡ w a̠ n sʰ a̠	부정관사
부정적분	p u d͡ʑ ʌ̹ ŋ d͡ʑ ʌ̹ k̚ p͈ u n	부정적뿐
부제	p uː d͡ʑ e̞	부제
부조리	p u d͡ʑ o̞ ɾ i	부조리
부족	p u d͡ʑ o̞ k̚	부족
부족하다	p u d͡ʑ o̞ kʰ a̠ d a̠	부조카다
부처	p u t͡ɕʰ ʌ̹	부처
부처님	p u t͡ɕʰ ʌ̹ n i m	부처님
부추	p uː t͡ɕʰ u	부추
부쿠레슈티	p u kʰ u ɾ e̞ ɕʰ u tʰ i	부쿠레수티
부탁	p uː tʰ a̠ k̚	부탁
부탁하다	p uː tʰ a̠ kʰ a̠ d a̠	부타카다
부탄	p u tʰ a̠ n	부탄
부터	p u tʰ ʌ̹	부터
부통령	p uː tʰ o̞ ŋ ɲ j ʌ̹ ŋ	부통녕
부티크	p u tʰ i k x ɯ	부틱흐
부품	p u pʰ u m	부품
부피	p u pʰ i	부피
부호	p uː β o̞	부호
부화	p u β w a̠	부화
부활	p uː β w a̠ ɭ	부활
부회장	p uː β w e̞ d͡ʑ a̠ ŋ	부회장
북경	p u k̚ k͈ j ʌ̹ ŋ	북꼉
북극곰	p u k̚ k͈ ɯ k̚ k͈ o̞ m	북끅꼼
북돋다	p u k̚ t͈ o̞ t̚ t͈ a̠	북똗따
북돋우다	p u k̚ t͈ o̞ d u d a̠	북또두다
북두칠성	p u k̚ t͈ u t͡ɕʰ i ɭ sʰ ʌ̹ ŋ	북뚜칠성
북마케도니아	p u ŋ m a̠ kʰ e̞ d o̞ n i a̠	붕마케도니아
북마크	p u ŋ m a̠ k x ɯ	붕막흐
북미	p u ŋ m i	붕미
북반구	p u k̚ p͈ a̠ n ɡ u	북빤구
북방	p u k̚ p͈ a̠ ŋ	북빵
북방흰뺨오리	p u k̚ p͈ a̠ ŋ ʝ i n p͈ j a̠ m o̞ ɾ i	북빵힌뺘모리
북부	p u k̚ p͈ u	북뿌
북서	p u k s͈ ʌ̹	북써
북송	p u k s͈ o̞ ŋ	북쏭
북숲쥐	p u k s͈ u p̚ t͡ɕ͈ ɥ i	북쑵쮜
북아메리카	p u ɡ a̠ m e̞ ɾ i kʰ a̠	부가메리카
북위	p u ɡ ɥ i	부귀
북쪽	p u k̚ t͡ɕ͈ o̞ k̚	북쪽
북측	p u k̚ t͡ɕʰ ɯ k̚	북측
북한말	p u kʰ a̠ n m a̠ ɭ	부칸말
북한어	p u kʰ a̠ n ʌ̹	부카너
분광기	p u n ɡ w a̠ ŋ ɡ i	분광기
분권	p u n k͈ w ʌ̹ n	분꿘
분노	p uː n n o̞	분노
분단	p u n d a̠ n	분단
분량	p uː ʎ ʎ j a̠ ŋ	불량
분류	p u ʎ ʎ j u	불류
분리	p u ʎ ʎ i	불리
분리주의	p u ʎ ʎ i d͡ʑ u ɰ i	불리주의
분말	p u n m a̠ ɭ	분말
분명	p u n m j ʌ̹ ŋ	분명
분명하다	p u n m j ʌ̹ ŋ ɦ a̠ d a̠	분명하다
분모	p u n m o̞	분모
분묘	p u n m j o	분묘
분사	p u n sʰ a̠	분사
분석자	p u n sʰ ʌ̹ k̚ t͡ɕ͈ a̠	분석짜
분석하다	p u n sʰ ʌ̹ kʰ a̠ d a̠	분서카다
분수령	p u n sʰ u ɾ j ʌ̹ ŋ	분수령
분야	p u ɲ j a̠	부냐
분위기	p u n ɥ i ɡ i	부뉘기
분자	p u ɲ d͡ʑ a̠	분자
분점	p u ɲ d͡ʑ ʌ̹ m	분점
분주하다	p u ɲ d͡ʑ u ɦ a̠ d a̠	분주하다
분투	p uː n tʰ u	분투
분포하다	p u n pʰ o̞ ɦ a̠ d a̠	분포하다
분필	p u n pʰ i ɭ	분필
분홍빛	p uː n β o̞ ŋ p͈ i t̚	분홍삗
붇다	p uː t̚ t͈ a̠	붇따
불가결	p u ɭ ɡ a̠ ɡ j ʌ̹ ɭ	불가결
불가능하다	p u ɭ ɡ a̠ n ɯ ŋ ɦ a̠ d a̠	불가능하다
불가리아	p u ɭ ɡ a̠ ɾ i a̠	불가리아
불가사리	p u ɭ ɡ a̠ sʰ a̠ ɾ i	불가사리
불가피하다	p u ɭ ɡ a̠ pʰ i ɦ a̠ d a̠	불가피하다
불경	p u ɭ ɡ j ʌ̹ ŋ	불경
불고기	p u ɭ ɡ o̞ ɡ i	불고기
불곰국	p u ɭ ɡ o̞ m ɡ u k̚	불곰국
불과	p u ɭ ɡ w a̠	불과
불과하다	p u ɭ ɡ w a̠ ɦ a̠ d a̠	불과하다
불구속	p u ɭ ɡ u sʰ o̞ k̚	불구속
불구하다	p u ɭ ɡ u ɦ a̠ d a̠	불구하다
불꽃	p u ɭ k͈ o̞ t̚	불꼳
불꽃놀이	p u ɭ k͈ o̞ n n o̞ ɾ i	불꼰노리
불다	p uː ɭ d a̠	불다
불닭	p u ɭ d a̠ k̚	불닥
불도	p u ɭ t͈ o̞	불또
불도저	p u ɭ d o̞ d͡ʑ ʌ̹	불도저
불량	p u ʎ ʎ j a̠ ŋ	불량
불륜	p u ʎ ʎ j u n	불륜
불륜하다	p u ʎ ʎ j u n ɦ a̠ d a̠	불륜하다
불만	p u ɭ m a̠ n	불만
불만족	p u ɭ m a̠ ɲ d͡ʑ o̞ k̚	불만족
불면증	p u ɭ m j ʌ̹ ɲ t͡ɕ͈ ɯ ŋ	불면쯩
불멸	p u ɭ m j ʌ̹ ɭ	불멸
불바다	p u ɭ b a̠ d a̠	불바다
불법	p u ɭ b ʌ̹ p̚	불법
불변	p u ɭ b j ʌ̹ n	불변
불복	p u ɭ b o̞ k̚	불복
불빛	p u ɭ p͈ i t̚	불삗
불사조	p u ɭ s͈ a̠ d͡ʑ o̞	불싸조
불상	p u ɭ sʰ a̠ ŋ	불상
불쌍	p u ɭ s͈ a̠ ŋ	불쌍
불쌍하다	p u ɭ s͈ a̠ ŋ ɦ a̠ d a̠	불쌍하다
불안	p u ɾ a̠ n	부란
불안하다	p u ɾ a̠ n ɦ a̠ d a̠	부란하다
불야성	p u ɾ j a̠ sʰ ʌ̹ ŋ	부랴성
불어	p u ɾ ʌ̹	부러
불장난	p u ʎ d͡ʑ a̠ ŋ n a̠ n	불장난
불철주야	p u ʎ t͡ɕʰ ʌ̹ ʎ d͡ʑ u j a̠	불철주야
불치병	p u ʎ t͡ɕʰ i p͈ j ʌ̹ ŋ	불치뼝
불친절	p u ʎ t͡ɕʰ i ɲ d͡ʑ ʌ̹ ɭ	불친절
불친절하다	p u ʎ t͡ɕʰ i ɲ d͡ʑ ʌ̹ ɾ ɦ a̠ d a̠	불친절하다
불타	p u ɭ tʰ a̠	불타
불편	p u ɭ pʰ j ʌ̹ n	불편
불편하다	p u ɭ pʰ j ʌ̹ n ɦ a̠ d a̠	불편하다
불평	p u ɭ pʰ j ʌ̹ ŋ	불평
불포화	p u ɭ pʰ o̞ β w a̠	불포화
불필요하다	p u ɭ pʰ i ɾ j o ɦ a̠ d a̠	불피료하다
불현듯	p u ɾ ʝ j ʌ̹ n d ɯ t̚	불현듣
불화	p u ɾ β w a̠	불화
불황	p u ɾ β w a̠ ŋ	불황
붉어지다	p u ɭ ɡ ʌ̹ d͡ʑ i d a̠	불거지다
붓글씨	p u t̚ k͈ ɯ ɭ ɕ͈ i	붇끌씨
붕소	p u ŋ sʰ o̞	붕소
붕어	p uː ŋ ʌ̹	부어
붕어빵	p u ŋ ʌ̹ p͈ a̠ ŋ	부어빵
붙이다	p u t͡ɕʰ i d a̠	부치다
브금	p ɯ ɡ ɯ m	브금
브라더	p ɯ ɾ a̠ d ʌ̹	브라더
브라우저	p ɯ ɾ a̠ u d͡ʑ ʌ̹	브라우저
브라이언	p ɯ ɾ a̠ i ʌ̹ n	브라이언
브라질리아	p ɯ ɾ a̠ d͡ʑ i ʎ ʎ i a̠	브라질리아
브라티슬라바	p ɯ ɾ a̠ tʰ i sʰ ɯ ɭ ɭ a̠ b a̠	브라티슬라바
브러시	p ɯ ɾ ʌ̹ ɕʰ i	브러시
브로치	p ɯ ɾ o̞ t͡ɕʰ i	브로치
브로커	p ɯ ɾ o̞ kʰ ʌ̹	브로커
브로콜리	p ɯ ɾ o̞ kʰ o̞ ʎ ʎ i	브로콜리
브루나이	p ɯ ɾ u n a̠ i	브루나이
브뤼셀	p ɯ ɾ ɥ i sʰ e̞ ɭ	브뤼셀
브리핑	p ɯ ɾ i pʰ i ŋ	브리핑
블라디보스토크	p ɯ ɭ ɭ a̠ d i b o̞ sʰ ɯ tʰ o̞ k x ɯ	블라디보스톡흐
블라우스	p ɯ ɭ ɭ a̠ u sʰ ɯ	블라우스
블라지보스또크	p ɯ ɭ ɭ a̠ d͡ʑ i b o̞ sʰ ɯ t͈ o̞ k x ɯ	블라지보스똑흐
블럭	p ɯ ɭ ɭ ʌ̹ k̚	블럭
블로그	p ɯ ɭ ɭ o̞ ɡ ɯ	블로그
블루길	p ɯ ɭ ɭ u ɡ i ɭ	블루길
블링블링	p ɯ ʎ ʎ i ŋ b ɯ ʎ ʎ i ŋ	블링블링
비각	p i ɡ a̠ k̚	비각
비고	p iː ɡ o̞	비고
비골	p iː ɡ o̞ ɭ	비골
비교급	p iː ɡ j o k͈ ɯ p̚	비교끕
비교적	p iː ɡ j o d͡ʑ ʌ̹ k̚	비교적
비교하다	p iː ɡ j o ɦ a̠ d a̠	비교하다
비구니	p iː ɡ u n i	비구니
비구름	p i ɡ u ɾ ɯ m	비구름
비극	p iː ɡ ɯ k̚	비극
비기다	p i ɡ i d a̠	비기다
비난	p iː n a̠ n	비난
비난하다	p iː n a̠ n ɦ a̠ d a̠	비난하다
비눗방울	p i n u t̚ p͈ a̠ ŋ u ɭ	비눋빠울
비늘	p i n ɯ ɭ	비늘
비닐	p i n i ɭ	비닐
비다	p i d a̠	비다
비단길	p iː d a̠ n k͈ i ɭ	비단낄
비데오	p i d e̞ o̞	비데오
비둘기	p i d u ɭ ɡ i	비둘기
비듬	p i d ɯ m	비듬
비디오	p i d i o̞	비디오
비디오테이프	p i d i o̞ tʰ e̞ i pʰ ɯ	비디오테이프
비로소	p i ɾ o̞ sʰ o̞	비로소
비롯되다	p i ɾ o̞ t̚ t͈ w e̞ d a̠	비롣뙤다
비료	p iː ɾ j o	비료
비망록	p iː m a̠ ŋ n o̞ k̚	비망녹
비밀	p iː m i ɭ	비밀
비밀리	p iː m i ʎ ʎ i	비밀리
비밀번호	p iː m i ɭ b ʌ̹ n β o̞	비밀번호
비밀스럽다	p iː m i ɭ sʰ ɯ ɾ ʌ̹ p̚ t͈ a̠	비밀스럽따
비방	p i b a̠ ŋ	비방
비버	p i b ʌ̹	비버
비법	p iː p͈ ʌ̹ p̚	비뻡
비사우	p i sʰ a̠ u	비사우
비서	p iː sʰ ʌ̹	비서
비소	p i sʰ o̞	비소
비수	p iː sʰ u	비수
비슈케크	p i ɕʰ u kʰ e̞ k x ɯ	비수켁흐
비스켓	p i sʰ ɯ kʰ e̞ t̚	비스켇
비약하다	p i j a̠ kʰ a̠ d a̠	비야카다
비엔나	p i e̞ n n a̠	비엔나
비용	p iː j o ŋ	비용
비우다	p i u d a̠	비우다
비유	p iː j u	비유
비율	p iː j u ɭ	비율
비자	p i d͡ʑ a̠	비자
비잔티움	p i d͡ʑ a̠ n tʰ i u m	비잔티움
비중	p iː d͡ʑ u ŋ	비중
비추다	p i t͡ɕʰ u d a̠	비추다
비취	p iː t͡ɕʰ ɥ i	비취
비치발리볼	p i t͡ɕʰ i b a̠ ʎ ʎ i b o̞ ɭ	비치발리볼
비타민	p i tʰ a̠ m i n	비타민
비트	p i tʰ ɯ	비트
비트박스	p i tʰ ɯ b a̠ k s͈ ɯ	비트박쓰
비트코인	p i tʰ ɯ kʰ o̞ i n	비트코인
비파나무	p i pʰ a̠ n a̠ m u	비파나무
비판	p iː pʰ a̠ n	비판
비판적	p iː pʰ a̠ ɲ d͡ʑ ʌ̹ k̚	비판적
비판하다	p iː pʰ a̠ n ɦ a̠ d a̠	비판하다
비평가	p iː pʰ j ʌ̹ ŋ ɡ a̠	비평가
비하다	p iː ɦ a̠ d a̠	비하다
빅토리아	p i k̚ tʰ o̞ ɾ i a̠	빅토리아
빈곤	p i n ɡ o̞ n	빈곤
빈뇨	p i n ɲ j o	빈뇨
빈도	p i n d o̞	빈도
빈부	p i n b u	빈부
빈자	p i ɲ d͡ʑ a̠	빈자
빈칸	p iː n kʰ a̠ n	빈칸
빈트후크	p i n tʰ ɯ β u k x ɯ	빈트훅흐
빈틈	p iː n tʰ ɯ m	빈틈
빌뉴스	p i ʎ ʎ j u sʰ ɯ	빌류스
빌딩	p i ɭ d i ŋ	빌딩
빗금	p i t̚ k͈ ɯ m	빋끔
빗물	p i n m u ɭ	빈물
빗자루	p i t̚ t͡ɕ͈ a̠ ɾ u	빋짜루
빗장뼈	p i t̚ t͡ɕ͈ a̠ ŋ p͈ j ʌ̹	빋짱뼈
빙고	p i ŋ ɡ o̞	빙고
빙빙	p i ŋ b i ŋ	빙빙
빙산	p i ŋ sʰ a̠ n	빙산
빙상관	p i ŋ sʰ a̠ ŋ ɡ w a̠ n	빙상관
빙수	p i ŋ sʰ u	빙수
빙점	p i ŋ d͡ʑ ʌ̹ m	빙점
빙하	p i ŋ ɦ a̠	빙하
빚다	p i t̚ t͈ a̠	빋따
빛나다	p i n n a̠ d a̠	빈나다
빠다	p͈ a̠ d a̠	빠다
빠듯하다	p͈ a̠ d ɯ tʰ a̠ d a̠	빠드타다
빠리	p͈ a̠ ɾ i	빠리
빠져나오다	p͈ a̠ː d͡ʑ ʌ̹ n a̠ o̞ d a̠	빠저나오다
빤스	p͈ a̠ n sʰ ɯ	빤스
빤짝	p͈ a̠ ɲ t͡ɕ͈ a̠ k̚	빤짝
빨강	p͈ a̠ ɭ ɡ a̠ ŋ	빨강
빨갛다	p͈ a̠ ɭ ɡ a̠ tʰ a̠	빨가타
빨리	p͈ a̠ ʎ ʎ i	빨리
빨리빨리	p͈ a̠ ʎ ʎ i p͈ a̠ ʎ ʎ i	빨리빨리
빨아먹다	p͈ a̠ ɾ a̠ m ʌ̹ k̚ t͈ a̠	빠라먹따
빼다	p͈ ɛː d a̠	빼다
뺄셈	p͈ ɛː ɭ sʰ e̞ m	뺄셈
뻔쩍뻔쩍	p͈ ʌ̹ ɲ t͡ɕ͈ ʌ̹ k̚ p͈ ʌ̹ ɲ t͡ɕ͈ ʌ̹ k̚	뻔쩍뻔쩍
뻗다	p͈ ʌ̹ t̚ t͈ a̠	뻗따
뻘떡	p͈ ʌ̹ ɭ t͈ ʌ̹ k̚	뻘떡
뽀르뚜갈	p͈ o̞ ɾ ɯ t͈ u ɡ a̠ ɭ	뽀르뚜갈
뽀뽀	p͈ o̞ p͈ o̞	뽀뽀
뽀사삭	p͈ o̞ sʰ a̠ sʰ a̠ k̚	뽀사삭
뽈스카	p͈ o̞ ɭ sʰ ɯ kʰ a̠	뽈스카
뽐프	p͈ o̞ m pʰ ɯ	뽐프
뽑다	p͈ o̞ p̚ t͈ a̠	뽑따
뾰족하다	p͈ j o d͡ʑ o̞ kʰ a̠ d a̠	뾰조카다
뿌리다	p͈ u ɾ i d a̠	뿌리다
뿌서석	p͈ u sʰ ʌ̹ sʰ ʌ̹ k̚	뿌서석
뿌석	p͈ u sʰ ʌ̹ k̚	뿌석
뿌셔뿌셔	p͈ u ɕʰ ʌ̹ p͈ u ɕʰ ʌ̹	뿌서뿌서
뿌옇다	p͈ uː j ʌ̹ tʰ a̠	뿌여타
뿔논병아리	p͈ u ɭ ɭ o̞ n b j ʌ̹ ŋ a̠ ɾ i	뿔론벼아리
뿜다	p͈ uː m t͈ a̠	뿜따
삐딱하다	p͈ i t͈ a̠ kʰ a̠ d a̠	삐따카다
삐침	p͈ i t͡ɕʰ i m	삐침
삥궐	p͈ i ŋ ɡ w ʌ̹ ɭ	삥궐
삥삥	p͈ i ŋ p͈ i ŋ	삥삥
사거리	sʰ a̠ː ɡ ʌ̹ ɾ i	사거리
사건	sʰ a̠ː k͈ ʌ̹ n	사껀
사계	sʰ a̠ː ɡ j e̞	사계
사골	sʰ a̠ː ɡ o̞ ɭ	사골
사과하다	sʰ a̠ː ɡ w a̠ ɦ a̠ d a̠	사과하다
사구	sʰ a̠ ɡ u	사구
사기꾼	sʰ a̠ ɡ i k͈ u n	사기꾼
사기죄	sʰ a̠ ɡ i d͡ʑ w e̞	사기죄
사나	sʰ a̠ n a̠	사나
사나이	sʰ a̠ n a̠ i	사나이
사냥	sʰ a̠ ɲ j a̠ ŋ	사냥
사냥꾼	sʰ a̠ ɲ j a̠ ŋ k͈ u n	사냥꾼
사다리	sʰ a̠ d a̠ ɾ i	사다리
사단	sʰ a̠ d a̠ n	사단
사라예보	sʰ a̠ ɾ a̠ j e̞ b o̞	사라예보
사라지다	sʰ a̠ ɾ a̠ d͡ʑ i d a̠	사라지다
사랑	sʰ a̠ ɾ a̠ ŋ	사랑
사랑니	sʰ a̠ ɾ a̠ ŋ n i	사랑니
사랑스럽다	sʰ a̠ ɾ a̠ ŋ sʰ ɯ ɾ ʌ̹ p̚ t͈ a̠	사랑스럽따
사령부	sʰ a̠ ɾ j ʌ̹ ŋ b u	사령부
사로잡다	sʰ a̠ ɾ o̞ d͡ʑ a̠ p̚ t͈ a̠	사로잡따
사르르	sʰ a̠ ɾ ɯ ɾ ɯ	사르르
사리원	sʰ a̠ ɾ i w ʌ̹ n	사리원
사립	sʰ a̠ ɾ i p̚	사립
사립문	sʰ a̠ ɾ i m m u n	사림문
사마귀	sʰ a̠ː m a̠ ɡ ɥ i	사마귀
사마륨	sʰ a̠ m a̠ ɾ j u m	사마륨
사마리아	sʰ a̠ m a̠ ɾ i a̠	사마리아
사막	sʰ a̠ m a̠ k̚	사막
사막화	sʰ a̠ m a̠ kʰ w a̠	사마콰
사망	sʰ a̠ː m a̠ ŋ	사망
사면	sʰ a̠ː m j ʌ̹ n	사면
사모	sʰ a̠ m o̞	사모
사모아	sʰ a̠ m o̞ a̠	사모아
사무라이	sʰ a̠ m u ɾ a̠ i	사무라이
사무소	sʰ a̠ː m u sʰ o̞	사무소
사무치다	sʰ a̠ m u t͡ɕʰ i d a̠	사무치다
사물	sʰ a̠ː m u ɭ	사물
사방	sʰ a̠ː b a̠ ŋ	사방
사법	sʰ a̠ b ʌ̹ p̚	사법
사본	sʰ a̠ b o̞ n	사본
사뿐	sʰ a̠ p͈ u n	사뿐
사뿐사뿐	sʰ a̠ p͈ u n sʰ a̠ p͈ u n	사뿐사뿐
사상	sʰ a̠ː sʰ a̠ ŋ	사상
사설	sʰ a̠ sʰ ʌ̹ ɭ	사설
사스	sʰ a̠ sʰ ɯ	사스
사슴	sʰ a̠ sʰ ɯ m	사슴
사시	sʰ a̠ ɕʰ i	사시
사신	sʰ a̠ː ɕʰ i n	사신
사실	sʰ a̠ː ɕʰ i ɭ	사실
사악	sʰ a̠ a̠ k̚	사악
사악하다	sʰ a̠ a̠ kʰ a̠ d a̠	사아카다
사안	sʰ a̠ː a̠ n	사안
사양	sʰ a̠ j a̠ ŋ	사양
사업	sʰ a̠ː ʌ̹ p̚	사업
사업가	sʰ a̠ː ʌ̹ p̚ k͈ a̠	사업까
사업주	sʰ a̠ː ʌ̹ p̚ t͡ɕ͈ u	사업쭈
사업차	sʰ a̠ ʌ̹ p̚ t͡ɕʰ a̠	사업차
사용되다	sʰ a̠ː j o ŋ d w e̞ d a̠	사용되다
사용자	sʰ a̠ː j o ŋ d͡ʑ a̠	사용자
사용하다	sʰ a̠ː j o ŋ ɦ a̠ d a̠	사용하다
사우나	s͈ a̠ u n a̠	싸우나
사우디아라비아	sʰ a̠ u d i a̠ ɾ a̠ b i a̠	사우디아라비아
사울	sʰ a̠ u ɭ	사울
사원	sʰ a̠ w ʌ̹ n	사원
사월	sʰ a̠ː w ʌ̹ ɭ	사월
사이다	sʰ a̠ i d a̠	사이다
사이렌	s͈ a̠ i ɾ e̞ n	싸이렌
사이보그	s͈ a̠ i b o̞ ɡ ɯ	싸이보그
사이비	sʰ a̠ː i b i	사이비
사이즈	s͈ a̠ i d͡ʑ ɯ	싸이즈
사이클링	sʰ a̠ i k x ɯ ʎ ʎ i ŋ	사익흘링
사이트	s͈ a̠ i tʰ ɯ	싸이트
사자고추	sʰ a̠ d͡ʑ a̠ ɡ o̞ t͡ɕʰ u	사자고추
사제	sʰ a̠ d͡ʑ e̞	사제
사증	sʰ a̠ t͡ɕ͈ ɯ ŋ	사쯩
사직	sʰ a̠ d͡ʑ i k̚	사직
사진	sʰ a̠ d͡ʑ i n	사진
사진사	sʰ a̠ d͡ʑ i n sʰ a̠	사진사
사진술	sʰ a̠ d͡ʑ i n sʰ u ɭ	사진술
사창	sʰ a̠ t͡ɕʰ a̠ ŋ	사창
사천	sʰ a̠ː t͡ɕʰ ʌ̹ n	사천
사철	sʰ a̠ t͡ɕʰ ʌ̹ ɭ	사철
사철나무	sʰ a̠ː t͡ɕʰ ʌ̹ ɭ ɭ a̠ m u	사철라무
사촌	sʰ a̠ː t͡ɕʰ o̞ n	사촌
사춘기	sʰ a̠ t͡ɕʰ u n ɡ i	사춘기
사치품	sʰ a̠ t͡ɕʰ i pʰ u m	사치품
사쿠라	sʰ a̠ kʰ u ɾ a̠	사쿠라
사타구니	sʰ a̠ tʰ a̠ ɡ u n i	사타구니
사탄	sʰ a̠ tʰ a̠ n	사탄
사탕	sʰ a̠ tʰ a̠ ŋ	사탕
사탕수수	sʰ a̠ tʰ a̠ ŋ sʰ u sʰ u	사탕수수
사투리	sʰ a̠ː tʰ u ɾ i	사투리
사파리	sʰ a̠ pʰ a̠ ɾ i	사파리
사하다	sʰ a̠ ɦ a̠ d a̠	사하다
사하라	sʰ a̠ ɦ a̠ ɾ a̠	사하라
사학	sʰ a̠ː ɦ a̠ k̚	사학
사할린	sʰ a̠ ɦ a̠ ʎ ʎ i n	사할린
사항	sʰ a̠ː ɦ a̠ ŋ	사항
사향	sʰ a̠ː ʝ j a̠ ŋ	사향
사형	sʰ a̠ː ʝ j ʌ̹ ŋ	사형
사회적	sʰ a̠ β w e̞ d͡ʑ ʌ̹ k̚	사회적
사회주의	sʰ a̠ β w e̞ d͡ʑ u ɰ i	사회주의
사회학	sʰ a̠ β w e̞ ɦ a̠ k̚	사회학
사흘	sʰ a̠ ɣ ɯ ɭ	사ɣㅡㄹ
산골	sʰ a̠ n ɡ o̞ ɭ	산골
산동	sʰ a̠ n d o̞ ŋ	산동
산마리노	s͈ a̠ n m a̠ ɾ i n o̞	싼마리노
산문	sʰ a̠ː n m u n	산문
산보	sʰ a̠ː n p͈ o̞	산뽀
산봉우리	sʰ a̠ n p͈ o̞ ŋ u ɾ i	산뽀우리
산불	sʰ a̠ n b u ɭ	산불
산서	sʰ a̠ n sʰ ʌ̹	산서
산술	sʰ a̠ː n sʰ u ɭ	산술
산시	sʰ a̠ n ɕʰ i	산시
산양	sʰ a̠ ɲ j a̠ ŋ	사냥
산장	sʰ a̠ ɲ d͡ʑ a̠ ŋ	산장
산전	sʰ a̠ ɲ d͡ʑ ʌ̹ n	산전
산천	sʰ a̠ ɲ t͡ɕʰ ʌ̹ n	산천
산토끼	sʰ a̠ n tʰ o̞ k͈ i	산토끼
산티아고	sʰ a̠ n tʰ i a̠ ɡ o̞	산티아고
산호	sʰ a̠ n β o̞	산호
산호초	sʰ a̠ n β o̞ t͡ɕʰ o̞	산호초
살결물	sʰ a̠ ɭ k͈ j ʌ̹ ɭ m u ɭ	살껼물
살그머니	sʰ a̠ ɭ ɡ ɯ m ʌ̹ n i	살그머니
살금살금	sʰ a̠ ɭ ɡ ɯ m sʰ a̠ ɭ ɡ ɯ m	살금살금
살다	sʰ a̠ː ɭ d a̠	살다
살롱	sʰ a̠ ɭ ɭ o̞ ŋ	살롱
살리다	sʰ a̠ ʎ ʎ i d a̠	살리다
살며시	sʰ a̠ ɭ m j ʌ̹ ɕʰ i	살며시
살살	sʰ a̠ ɭ sʰ a̠ ɭ	살살
살아오다	sʰ a̠ ɾ a̠ o̞ d a̠	사라오다
살인자	sʰ a̠ ɾ i ɲ d͡ʑ a̠	사린자
살짝살짝	sʰ a̠ ʎ t͡ɕ͈ a̠ k s͈ a̠ ʎ t͡ɕ͈ a̠ k̚	살짝쌀짝
살펴보다	sʰ a̠ ɭ pʰ j ʌ̹ b o̞ d a̠	살펴보다
살피다	sʰ a̠ ɭ pʰ i d a̠	살피다
삶다	sʰ a̠ː m t͈ a̠	삼따
삼겹살	sʰ a̠ m ɡ j ʌ̹ p s͈ a̠ ɭ	삼겹쌀
삼계탕	sʰ a̠ m ɡ j e̞ tʰ a̠ ŋ	삼계탕
삼국	sʰ a̠ m ɡ u k̚	삼국
삼나무	sʰ a̠ m n a̠ m u	삼나무
삼다	sʰ a̠ː m t͈ a̠	삼따
삼루수	sʰ a̠ m n u sʰ u	삼누수
삼림	sʰ a̠ m n i m	삼님
삼바	sʰ a̠ m b a̠	삼바
삼성	sʰ a̠ m sʰ ʌ̹ ŋ	삼성
삼수	sʰ a̠ m sʰ u	삼수
삼십	sʰ a̠ m ɕʰ i p̚	삼십
삼십육계	sʰ a̠ m ɕʰ i b j u k̚ k͈ j e̞	삼시뷱꼐
삼월	sʰ a̠ m w ʌ̹ ɭ	사뭘
삼족	sʰ a̠ m d͡ʑ o̞ k̚	삼족
삼촌	sʰ a̠ m t͡ɕʰ o̞ n	삼촌
삼춘	sʰ a̠ m t͡ɕʰ u n	삼춘
삼한	sʰ a̠ m ɦ a̠ n	삼한
삽입	sʰ a̠ b i p̚	사빕
삽입곡	sʰ a̠ b i p̚ k͈ o̞ k̚	사빕꼭
상념	sʰ a̠ː ŋ ɲ j ʌ̹ m	상념
상놈	sʰ a̠ ŋ n o̞ m	상놈
상담	sʰ a̠ ŋ d a̠ m	상담
상담하다	sʰ a̠ ŋ d a̠ m ɦ a̠ d a̠	상담하다
상당	sʰ a̠ ŋ d a̠ ŋ	상당
상당하다	sʰ a̠ ŋ d a̠ ŋ ɦ a̠ d a̠	상당하다
상록수	sʰ a̠ ŋ n o̞ k s͈ u	상녹쑤
상사병	sʰ a̠ ŋ sʰ a̠ p͈ j ʌ̹ ŋ	상사뼝
상상	sʰ a̠ː ŋ sʰ a̠ ŋ	상상
상상력	sʰ a̠ː ŋ sʰ a̠ ŋ ɲ j ʌ̹ k̚	상상녁
상성	sʰ a̠ː ŋ sʰ ʌ̹ ŋ	상성
상세하다	sʰ a̠ ŋ sʰ e̞ ɦ a̠ d a̠	상세하다
상속	sʰ a̠ ŋ sʰ o̞ k̚	상속
상속인	sʰ a̠ ŋ sʰ o̞ ɡ i n	상소긴
상식	sʰ a̠ ŋ ɕʰ i k̚	상식
상아	sʰ a̠ ŋ a̠	사아
상어	sʰ a̠ ŋ ʌ̹	사어
상원	sʰ a̠ː ŋ w ʌ̹ n	사원
상응	sʰ a̠ ŋ ɯ ŋ	사응
상의	sʰ a̠ ŋ ɰ i	사의
상이하다	sʰ a̠ ŋ i ɦ a̠ d a̠	사이하다
상인	sʰ a̠ ŋ i n	사인
상자	sʰ a̠ ŋ d͡ʑ a̠	상자
상점	sʰ a̠ ŋ d͡ʑ ʌ̹ m	상점
상처	sʰ a̠ ŋ t͡ɕʰ ʌ̹	상처
상추	sʰ a̠ ŋ t͡ɕʰ u	상추
상표	sʰ a̠ ŋ pʰ j o	상표
상하이	sʰ a̠ ŋ ɦ a̠ i	상하이
상호	sʰ a̠ ŋ β o̞	상호
상환되다	sʰ a̠ ŋ β w a̠ n d w e̞ d a̠	상환되다
상황	sʰ a̠ ŋ β w a̠ ŋ	상황
색시	sʰ ɛː k ɕ͈ i	색씨
샛별	sʰ ɛː t̚ p͈ j ʌ̹ ɭ	샏뼐
샤발	ɕʰ a̠ b a̠ ɭ	사발
샤워	ɕʰ a̠ w ʌ̹	사워
샴페인	ɕʰ a̠ m pʰ e̞ i n	삼페인
샴푸	ɕʰ a̠ m pʰ u	삼푸
샹들리에	ɕʰ a̠ ŋ d ɯ ʎ ʎ i e̞	상들리에
서강	sʰ ʌ̹ ɡ a̠ ŋ	서강
서거	sʰ ɘː ɡ ʌ̹	서거
서고	sʰ ʌ̹ ɡ o̞	서고
서구	sʰ ʌ̹ ɡ u	서구
서귀포	sʰ ʌ̹ ɡ ɥ i pʰ o̞	서귀포
서남	sʰ ʌ̹ n a̠ m	서남
서넛	sʰ ʌ̹ n ʌ̹ t̚	서넏
서다	sʰ ʌ̹ d a̠	서다
서당	sʰ ʌ̹ d a̠ ŋ	서당
서두르다	sʰ ʌ̹ d u ɾ ɯ d a̠	서두르다
서랍	sʰ ʌ̹ ɾ a̠ p̚	서랍
서럽다	sʰ ɘː ɾ ʌ̹ p̚ t͈ a̠	서럽따
서로	sʰ ʌ̹ ɾ o̞	서로
서른	sʰ ʌ̹ ɾ ɯ n	서른
서리	sʰ ʌ̹ ɾ i	서리
서명	sʰ ɘː m j ʌ̹ ŋ	서명
서문	sʰ ɘː m u n	서문
서민	sʰ ɘː m i n	서민
서밋	sʰ ʌ̹ m i t̚	서믿
서방	sʰ ʌ̹ b a̠ ŋ	서방
서벌	sʰ ʌ̹ b ʌ̹ ɭ	서벌
서법	sʰ ʌ̹ p͈ ʌ̹ p̚	서뻡
서부	sʰ ʌ̹ b u	서부
서비스	s͈ ʌ̹ b i sʰ ɯ	써비스
서뿐서뿐	sʰ ʌ̹ p͈ u n sʰ ʌ̹ p͈ u n	서뿐서뿐
서서히	sʰ ɘː sʰ ʌ̹ ʝ i	서서히
서술	sʰ ɘː sʰ u ɭ	서술
서술하다	sʰ ɘː sʰ u ɾ ɦ a̠ d a̠	서술하다
서양	sʰ ʌ̹ j a̠ ŋ	서양
서양인	sʰ ʌ̹ j a̠ ŋ i n	서야인
서양자두	sʰ ʌ̹ j a̠ ŋ d͡ʑ a̠ d u	서양자두
서예	sʰ ʌ̹ j e̞	서예
서원	sʰ ɘː w ʌ̹ n	서원
서월	sʰ ʌ̹ w ʌ̹ ɭ	서월
서장	sʰ ʌ̹ d͡ʑ a̠ ŋ	서장
서점	sʰ ʌ̹ d͡ʑ ʌ̹ m	서점
서쪽	sʰ ʌ̹ t͡ɕ͈ o̞ k̚	서쪽
서체	sʰ ʌ̹ t͡ɕʰ e̞	서체
서커스	sʰ ʌ̹ kʰ ʌ̹ sʰ ɯ	서커스
서클	s͈ ʌ̹ k x ɯ ɭ	썩흘
서툴다	sʰ ɘː tʰ u ɭ d a̠	서툴다
서표	sʰ ʌ̹ pʰ j o	서표
서푼	sʰ ʌ̹ pʰ u n	서푼
석가모니	sʰ ʌ̹ k̚ k͈ a̠ m o̞ n i	석까모니
석관	sʰ ʌ̹ k̚ k͈ w a̠ n	석꽌
석류	sʰ ʌ̹ ŋ ɲ j u	성뉴
석류석	sʰ ʌ̹ ŋ ɲ j u sʰ ʌ̹ k̚	성뉴석
석방	sʰ ʌ̹ k̚ p͈ a̠ ŋ	석빵
석순	sʰ ʌ̹ k s͈ u n	석쑨
석유	sʰ ʌ̹ ɡ j u	서규
석의	sʰ ʌ̹ ɡ ɰ i	서긔
석탄	sʰ ʌ̹ k̚ tʰ a̠ n	석탄
석탄산	sʰ ʌ̹ k̚ tʰ a̠ n sʰ a̠ n	석탄산
섞다	sʰ ʌ̹ k̚ t͈ a̠	석따
선거	sʰ ɘː n ɡ ʌ̹	선거
선거인	sʰ ɘː n ɡ ʌ̹ i n	선거인
선거통	sʰ ɘː n ɡ ʌ̹ tʰ o̞ ŋ	선거통
선교	sʰ ʌ̹ n ɡ j o	선교
선교사	sʰ ʌ̹ n ɡ j o sʰ a̠	선교사
선글라스	s͈ ʌ̹ n ɡ ɯ ɭ ɭ a̠ sʰ ɯ	썬글라스
선동하다	sʰ ʌ̹ n d o̞ ŋ ɦ a̠ d a̠	선동하다
선렬	sʰ ʌ̹ ʎ ʎ j ʌ̹ ɭ	설렬
선로	sʰ ʌ̹ ɭ ɭ o̞	설로
선물	sʰ ɘː n m u ɭ	선물
선박	sʰ ʌ̹ n b a̠ k̚	선박
선상	sʰ ʌ̹ n sʰ a̠ ŋ	선상
선수	sʰ ɘː n sʰ u	선수
선술집	sʰ ʌ̹ n sʰ u ʎ t͡ɕ͈ i p̚	선술찝
선실	sʰ ʌ̹ n ɕʰ i ɭ	선실
선언	sʰ ʌ̹ n ʌ̹ n	서넌
선우	sʰ ʌ̹ n u	서누
선원	sʰ ʌ̹ n w ʌ̹ n	서눤
선율	sʰ ʌ̹ ɲ j u ɭ	서뉼
선인장	sʰ ʌ̹ n i ɲ d͡ʑ a̠ ŋ	서닌장
선장	sʰ ʌ̹ ɲ d͡ʑ a̠ ŋ	선장
선지	sʰ ʌ̹ ɲ d͡ʑ i	선지
선지자	sʰ ʌ̹ ɲ d͡ʑ i d͡ʑ a̠	선지자
선진국	sʰ ʌ̹ ɲ d͡ʑ i n ɡ u k̚	선진국
선착장	sʰ ʌ̹ ɲ t͡ɕʰ a̠ k̚ t͡ɕ͈ a̠ ŋ	선착짱
선창	sʰ ʌ̹ ɲ t͡ɕʰ a̠ ŋ	선창
선화	sʰ ʌ̹ n β w a̠	선화
설거지하다	sʰ ʌ̹ ɭ ɡ ʌ̹ d͡ʑ i ɦ a̠ d a̠	설거지하다
설교	sʰ ʌ̹ ɭ ɡ j o	설교
설교자	sʰ ʌ̹ ɭ ɡ j o d͡ʑ a̠	설교자
설날	sʰ ɘː ɭ ɭ a̠ ɭ	설랄
설더구하다	sʰ ʌ̹ ɭ d ʌ̹ ɡ u ɦ a̠ d a̠	설더구하다
설렁탕	sʰ ʌ̹ ɭ ɭ ʌ̹ ŋ tʰ a̠ ŋ	설렁탕
설레이다	sʰ ʌ̹ ɭ ɭ e̞ i d a̠	설레이다
설립하다	sʰ ʌ̹ ʎ ʎ i pʰ a̠ d a̠	설리파다
설마	sʰ ʌ̹ ɭ m a̠	설마
설명하다	sʰ ʌ̹ ɭ m j ʌ̹ ŋ ɦ a̠ d a̠	설명하다
설문	sʰ ʌ̹ ɭ m u n	설문
설문지	sʰ ʌ̹ ɭ m u ɲ d͡ʑ i	설문지
설비	sʰ ʌ̹ ɭ b i	설비
설사	sʰ ʌ̹ ɭ s͈ a̠	설싸
설산	sʰ ʌ̹ ɭ s͈ a̠ n	설싼
설설	sʰ ʌ̹ ɭ sʰ ʌ̹ ɭ	설설
설정	sʰ ʌ̹ ʎ t͡ɕ͈ ʌ̹ ŋ	설쩡
설치	sʰ ʌ̹ ʎ t͡ɕʰ i	설치
설치다	sʰ ʌ̹ ʎ t͡ɕʰ i d a̠	설치다
설치류	sʰ ʌ̹ ʎ t͡ɕʰ i ɾ j u	설치류
설탕	sʰ ʌ̹ ɭ tʰ a̠ ŋ	설탕
설포닐기	sʰ ʌ̹ ɭ pʰ o̞ n i ɭ ɡ i	설포닐기
설폰	sʰ ʌ̹ ɭ pʰ o̞ n	설폰
설화	sʰ ʌ̹ ɾ β w a̠	설화
섬네일	sʰ ʌ̹ m n e̞ i ɭ	섬네일
섭씨	sʰ ʌ̹ p ɕ͈ i	섭씨
성가	sʰ ɘː ŋ ɡ a̠	성가
성격	sʰ ɘː ŋ k͈ j ʌ̹ k̚	성껵
성경	sʰ ɘː ŋ ɡ j ʌ̹ ŋ	성경
성공	sʰ ʌ̹ ŋ ɡ o̞ ŋ	성공
성과	sʰ ʌ̹ ŋ k͈ w a̠	성꽈
성곽	sʰ ʌ̹ ŋ ɡ w a̠ k̚	성곽
성교	sʰ ɘː ŋ ɡ j o	성교
성교하다	sʰ ɘː ŋ ɡ j o ɦ a̠ d a̠	성교하다
성냥	sʰ ʌ̹ ŋ ɲ j a̠ ŋ	성냥
성당	sʰ ɘː ŋ d a̠ ŋ	성당
성립	sʰ ʌ̹ ŋ n i p̚	성닙
성명	sʰ ɘː ŋ m j ʌ̹ ŋ	성명
성문	sʰ ʌ̹ ŋ m u n	성문
성별	sʰ ɘː ŋ b j ʌ̹ ɭ	성별
성병	sʰ ɘː ŋ p͈ j ʌ̹ ŋ	성뼝
성부	sʰ ɘː ŋ b u	성부
성분	sʰ ʌ̹ ŋ b u n	성분
성사	sʰ ɘː ŋ sʰ a̠	성사
성상	sʰ ɘː ŋ sʰ a̠ ŋ	성상
성스럽다	sʰ ɘː ŋ sʰ ɯ ɾ ʌ̹ p̚ t͈ a̠	성스럽따
성실	sʰ ʌ̹ ŋ ɕʰ i ɭ	성실
성심	sʰ ʌ̹ ŋ ɕʰ i m	성심
성씨	sʰ ɘː ŋ ɕ͈ i	성씨
성어	sʰ ʌ̹ ŋ ʌ̹	서어
성욕	sʰ ɘː ŋ j o k̚	서욕
성우	sʰ ʌ̹ ŋ u	서우
성운	sʰ ʌ̹ ŋ u n	서운
성의	sʰ ʌ̹ ŋ ɰ i	서의
성장하다	sʰ ʌ̹ ŋ d͡ʑ a̠ ŋ ɦ a̠ d a̠	성장하다
성적표	sʰ ʌ̹ ŋ d͡ʑ ʌ̹ k̚ pʰ j o	성적표
성조	sʰ ʌ̹ ŋ d͡ʑ o̞	성조
성지	sʰ ɘː ŋ d͡ʑ i	성지
성질	sʰ ɘː ŋ d͡ʑ i ɭ	성질
성차별	sʰ ɘː ŋ t͡ɕʰ a̠ b j ʌ̹ ɭ	성차별
성찬	sʰ ɘː ŋ t͡ɕʰ a̠ n	성찬
성취	sʰ ʌ̹ ŋ t͡ɕʰ ɥ i	성취
성하	sʰ ɘː ŋ ɦ a̠	성하
성함	sʰ ɘː ŋ ɦ a̠ m	성함
세계	sʰ e̞ː ɡ j e̞	세계
세계관	sʰ e̞ː ɡ j e̞ ɡ w a̠ n	세계관
세계적	sʰ e̞ː ɡ j e̞ d͡ʑ ʌ̹ k̚	세계적
세계평화	sʰ e̞ ɡ j e̞ pʰ j ʌ̹ ŋ β w a̠	세계평화
세균	sʰ e̞ː ɡ j u n	세균
세금	sʰ e̞ː ɡ ɯ m	세금
세기	sʰ e̞ː ɡ i	세기
세네갈	s͈ e̞ n e̞ ɡ a̠ ɭ	쎄네갈
세뇌	sʰ e̞ː n w e̞	세뇌
세력	sʰ e̞ː ɾ j ʌ̹ k̚	세력
세례	sʰ e̞ː ɾ j e̞	세례
세로	sʰ e̞ː ɾ o̞	세로
세르비아	s͈ e̞ ɾ ɯ b i a̠	쎄르비아
세모꼴	sʰ e̞ː m o̞ k͈ o̞ ɭ	세모꼴
세미나	sʰ e̞ m i n a̠	세미나
세미콜론	sʰ e̞ m i kʰ o̞ ɭ ɭ o̞ n	세미콜론
세상	sʰ e̞ː sʰ a̠ ŋ	세상
세상에	sʰ e̞ː sʰ a̠ ŋ e̞	세사에
세수하다	sʰ e̞ː sʰ u ɦ a̠ d a̠	세수하다
세요	sʰ e̞ j o	세요
세우다	sʰ e̞ u d a̠	세우다
세워지다	sʰ e̞ w ʌ̹ d͡ʑ i d a̠	세워지다
세일	s͈ e̞ i ɭ	쎄일
세입자	sʰ e̞ː i p̚ t͡ɕ͈ a̠	세입짜
세제	sʰ e̞ː d͡ʑ e̞	세제
세종	sʰ e̞ː d͡ʑ o̞ ŋ	세종
세차	sʰ e̞ː t͡ɕʰ a̠	세차
세척	sʰ e̞ː t͡ɕʰ ʌ̹ k̚	세척
세탁	sʰ e̞ː tʰ a̠ k̚	세탁
세탁기	sʰ e̞ː tʰ a̠ k̚ k͈ i	세탁끼
세탁하다	sʰ e̞ː tʰ a̠ kʰ a̠ d a̠	세타카다
세트	sʰ e̞ tʰ ɯ	세트
세포	sʰ e̞ː pʰ o̞	세포
세포학	sʰ e̞ː pʰ o̞ ɦ a̠ k̚	세포학
섹션	sʰ e̞ k ɕ͈ ʌ̹ n	섹썬
섹스	s͈ e̞ k s͈ ɯ	쎅쓰
섹스하다	s͈ e̞ k s͈ ɯ ɦ a̠ d a̠	쎅쓰하다
센터	s͈ e̞ n tʰ ʌ̹	쎈터
센트	s͈ e̞ n tʰ ɯ	쎈트
센티미터	s͈ e̞ n tʰ i m i tʰ ʌ̹	쎈티미터
셀레늄	sʰ e̞ ɭ ɭ e̞ ɲ j u m	셀레늄
셀로판	sʰ e̞ ɭ ɭ o̞ pʰ a̠ n	셀로판
셀카	s͈ e̞ ɭ kʰ a̠	쎌카
셔벗	ɕʰ ʌ̹ b ʌ̹ t̚	서벋
셔츠	ɕʰ ʌ̹ t͡ɕʰ ɯ	서츠
셔터	ɕʰ ʌ̹ tʰ ʌ̹	서터
소고기	sʰ o̞ ɡ o̞ ɡ i	소고기
소금	sʰ o̞ ɡ ɯ m	소금
소나기	sʰ o̞ n a̠ ɡ i	소나기
소나무	sʰ o̞ n a̠ m u	소나무
소나타	sʰ o̞ n a̠ tʰ a̠	소나타
소낙비	sʰ o̞ n a̠ k̚ p͈ i	소낙삐
소녀	sʰ o̞ː ɲ j ʌ̹	소녀
소년	sʰ o̞ː ɲ j ʌ̹ n	소년
소년궁전	sʰ o̞ː ɲ j ʌ̹ n ɡ u ŋ d͡ʑ ʌ̹ n	소년궁전
소독제	sʰ o̞ d o̞ k̚ t͡ɕ͈ e̞	소독쩨
소득	sʰ o̞ː d ɯ k̚	소득
소련	sʰ o̞ ɾ j ʌ̹ n	소련
소령	sʰ o̞ː ɾ j ʌ̹ ŋ	소령
소리	sʰ o̞ ɾ i	소리
소말리아	s͈ o̞ m a̠ ʎ ʎ i a̠	쏘말리아
소멸	sʰ o̞ m j ʌ̹ ɭ	소멸
소모전	sʰ o̞ m o̞ d͡ʑ ʌ̹ n	소모전
소문	sʰ o̞ː m u n	소문
소방관	sʰ o̞ b a̠ ŋ ɡ w a̠ n	소방관
소방서	sʰ o̞ b a̠ ŋ sʰ ʌ̹	소방서
소방수	sʰ o̞ b a̠ ŋ sʰ u	소방수
소방차	sʰ o̞ b a̠ ŋ t͡ɕʰ a̠	소방차
소변	sʰ o̞ː b j ʌ̹ n	소변
소비에트	sʰ o̞ b i e̞ tʰ ɯ	소비에트
소비자	sʰ o̞ b i d͡ʑ a̠	소비자
소비하다	sʰ o̞ b i ɦ a̠ d a̠	소비하다
소속	sʰ o̞ː sʰ o̞ k̚	소속
소송	sʰ o̞ sʰ o̞ ŋ	소송
소수민족	sʰ o̞ː sʰ u m i ɲ d͡ʑ o̞ k̚	소수민족
소스	sʰ o̞ sʰ ɯ	소스
소시지	s͈ o̞ ɕʰ i d͡ʑ i	쏘시지
소식	sʰ o̞ ɕʰ i k̚	소식
소용	sʰ o̞ː j o ŋ	소용
소용돌이	sʰ o̞ j o ŋ d o̞ ɾ i	소용도리
소위	sʰ o̞ː ɥ i	소위
소유	sʰ o̞ː j u	소유
소유자	sʰ o̞ː j u d͡ʑ a̠	소유자
소유하다	sʰ o̞ː j u ɦ a̠ d a̠	소유하다
소음	sʰ o̞ ɯ m	소음
소음순	sʰ o̞ː ɯ m sʰ u n	소음순
소제	sʰ o̞ː d͡ʑ e̞	소제
소주	s͈ o̞ d͡ʑ u	쏘주
소중화	sʰ o̞ː d͡ʑ u ŋ β w a̠	소중화
소지품	sʰ o̞ː d͡ʑ i pʰ u m	소지품
소파	s͈ o̞ pʰ a̠	쏘파
소포	sʰ o̞ː pʰ o̞	소포
소품	sʰ o̞ː pʰ u m	소품
소풍	sʰ o̞ pʰ u ŋ	소풍
소프트볼	sʰ o̞ pʰ ɯ tʰ ɯ b o̞ ɭ	소프트볼
소피아	sʰ o̞ pʰ i a̠	소피아
소형	sʰ o̞ː ʝ j ʌ̹ ŋ	소형
소화	sʰ o̞ β w a̠	소화
소화기	sʰ o̞ β w a̠ ɡ i	소화기
소환	sʰ o̞ β w a̠ n	소환
속견	sʰ o̞ k̚ k͈ j ʌ̹ n	속껸
속눈썹	sʰ o̞ː ŋ n u n s͈ ʌ̹ p̚	송눈썹
속담	sʰ o̞ k̚ t͈ a̠ m	속땀
속도	sʰ o̞ k̚ t͈ o̞	속또
속삭임	sʰ o̞ k s͈ a̠ ɡ i m	속싸김
속세	sʰ o̞ k s͈ e̞	속쎄
속속	sʰ o̞ k s͈ o̞ k̚	속쏙
속속들이	sʰ o̞ k s͈ o̞ k̚ t͈ ɯ ɾ i	속쏙뜨리
속쓰림	sʰ o̞ː k s͈ ɯ ɾ i m	속쓰림
속어	sʰ o̞ ɡ ʌ̹	소거
속옷	sʰ o̞ː ɡ o̞ t̚	소곧
속이다	sʰ o̞ ɡ i d a̠	소기다
속자	sʰ o̞ k̚ t͡ɕ͈ a̠	속짜
손가락	sʰ o̞ n k͈ a̠ ɾ a̠ k̚	손까락
손가락질	sʰ o̞ n ɡ a̠ ɾ a̠ k̚ t͡ɕ͈ i ɭ	손가락찔
손가방	sʰ o̞ n ɡ a̠ b a̠ ŋ	손가방
손녀	sʰ o̞ n ɲ j ʌ̹	손녀
손님	sʰ o̞ n n i m	손님
손바닥	sʰ o̞ n p͈ a̠ d a̠ k̚	손빠닥
손뼉	sʰ o̞ n p͈ j ʌ̹ k̚	손뼉
손상	sʰ o̞ː n sʰ a̠ ŋ	손상
손상하다	sʰ o̞ː n sʰ a̠ ŋ ɦ a̠ d a̠	손상하다
손수건	sʰ o̞ n s͈ u ɡ ʌ̹ n	손쑤건
손아귀	sʰ o̞ː n a̠ ɡ ɥ i	소나귀
손자	sʰ o̞ ɲ d͡ʑ a̠	손자
손전등	sʰ o̞ ɲ t͡ɕ͈ ʌ̹ n d ɯ ŋ	손쩐등
손전화	sʰ o̞ ɲ d͡ʑ ʌ̹ n β w a̠	손전화
손주	sʰ o̞ ɲ d͡ʑ u	손주
손질	sʰ o̞ ɲ d͡ʑ i ɭ	손질
손톱	sʰ o̞ n tʰ o̞ p̚	손톱
솔까말	sʰ o̞ ɭ k͈ a̠ m a̠ ɭ	솔까말
솔로몬	sʰ o̞ ɭ ɭ o̞ m o̞ n	솔로몬
솔선수범	sʰ o̞ ɭ s͈ ʌ̹ n sʰ u b ʌ̹ m	솔썬수범
솔직하다	sʰ o̞ ʎ t͡ɕ͈ i kʰ a̠ d a̠	솔찌카다
솔크	s͈ o̞ ɭ k x ɯ	쏠ㄱ흐
솜사탕	sʰ o̞ m sʰ a̠ tʰ a̠ ŋ	솜사탕
솜씨	sʰ o̞ m ɕ͈ i	솜씨
솜털	sʰ o̞ m tʰ ʌ̹ ɭ	솜털
송과선	sʰ o̞ ŋ ɡ w a̠ sʰ ʌ̹ n	송과선
송구	sʰ o̞ː ŋ ɡ u	송구
송년회	sʰ o̞ː ŋ ɲ j ʌ̹ n β w e̞	송년회
송도	sʰ o̞ ŋ d o̞	송도
송림	sʰ o̞ ŋ n i m	송님
송사리	sʰ o̞ː ŋ sʰ a̠ ɾ i	송사리
송어	sʰ o̞ ŋ ʌ̹	소어
송이	sʰ o̞ ŋ i	소이
송이송이	sʰ o̞ ŋ i sʰ o̞ ŋ i	소이소이
송편	sʰ o̞ ŋ pʰ j ʌ̹ n	송편
쇠가마우지	sʰ w e̞ ɡ a̠ m a̠ u d͡ʑ i	쇠가마우지
쇠고기	sʰ w e̞ ɡ o̞ ɡ i	쇠고기
쇠기러기	sʰ w e̞ ɡ i ɾ ʌ̹ ɡ i	쇠기러기
쇠붙이	sʰ w e̞ b u t͡ɕʰ i	쇠부치
쇠풀	sʰ w e̞ pʰ u ɭ	쇠풀
쇳돌	sʰ w e̞ t̚ t͈ o̞ ɭ	쇧똘
쇼룸	ɕʰ o ɾ u m	쇼룸
쇼츠	ɕʰ o t͡ɕʰ ɯ	쇼츠
쇼케이스	ɕʰ o kʰ e̞ i sʰ ɯ	쇼케이스
쇼크	ɕʰ o k x ɯ	쇽흐
쇼트닝	ɕʰ o tʰ ɯ n i ŋ	쇼트닝
수간	sʰ u ɡ a̠ n	수간
수갑	sʰ u ɡ a̠ p̚	수갑
수고	sʰ uː ɡ o̞	수고
수괴	sʰ u ɡ w e̞	수괴
수납장	sʰ u n a̠ p̚ t͡ɕ͈ a̠ ŋ	수납짱
수녀	sʰ u ɲ j ʌ̹	수녀
수능	sʰ u n ɯ ŋ	수능
수다	sʰ uː d a̠	수다
수달	sʰ u d a̠ ɭ	수달
수도	sʰ u d o̞	수도
수도권	sʰ u d o̞ k͈ w ʌ̹ n	수도꿘
수도꼭지	sʰ u d o̞ k͈ o̞ k̚ t͡ɕ͈ i	수도꼭찌
수도사	sʰ u d o̞ sʰ a̠	수도사
수도원	sʰ u d o̞ w ʌ̹ n	수도원
수라	sʰ u ɾ a̠	수라
수량	sʰ uː ɾ j a̠ ŋ	수량
수레	sʰ u ɾ e̞	수레
수력	sʰ u ɾ j ʌ̹ k̚	수력
수련	sʰ u ɾ j ʌ̹ n	수련
수렴	sʰ u ɾ j ʌ̹ m	수렴
수로	sʰ u ɾ o̞	수로
수록	sʰ u ɾ o̞ k̚	수록
수류탄	sʰ u ɾ j u tʰ a̠ n	수류탄
수리남	sʰ u ɾ i n a̠ m	수리남
수말	sʰ u m a̠ ɭ	수말
수면제	sʰ u m j ʌ̹ ɲ d͡ʑ e̞	수면제
수명	sʰ u m j ʌ̹ ŋ	수명
수문학	sʰ u m u n ɦ a̠ k̚	수문학
수바	sʰ u b a̠	수바
수박	sʰ uː b a̠ k̚	수박
수법	sʰ u p͈ ʌ̹ p̚	수뻡
수병	sʰ u b j ʌ̹ ŋ	수병
수사학	sʰ u sʰ a̠ ɦ a̠ k̚	수사학
수산	sʰ u sʰ a̠ n	수산
수상	sʰ u sʰ a̠ ŋ	수상
수상하다	sʰ u sʰ a̠ ŋ ɦ a̠ d a̠	수상하다
수서	sʰ u sʰ ʌ̹	수서
수석	sʰ u sʰ ʌ̹ k̚	수석
수선	sʰ u sʰ ʌ̹ n	수선
수성	sʰ u sʰ ʌ̹ ŋ	수성
수소	sʰ u sʰ o̞	수소
수소폭탄	sʰ u sʰ o̞ pʰ o̞ k̚ tʰ a̠ n	수소폭탄
수송	sʰ u sʰ o̞ ŋ	수송
수수	sʰ u sʰ u	수수
수수께끼	sʰ u sʰ u k͈ e̞ k͈ i	수수께끼
수수미꾸리	sʰ u sʰ u m i k͈ u ɾ i	수수미꾸리
수술	sʰ u sʰ u ɭ	수술
수습	sʰ u sʰ ɯ p̚	수습
수시로	sʰ u ɕʰ i ɾ o̞	수시로
수식어	sʰ u ɕʰ i ɡ ʌ̹	수시거
수심	sʰ u ɕʰ i m	수심
수십	sʰ uː ɕʰ i p̚	수십
수염	sʰ u j ʌ̹ m	수염
수염수리	sʰ u j ʌ̹ m sʰ u ɾ i	수염수리
수영	sʰ u j ʌ̹ ŋ	수영
수영복	sʰ u j ʌ̹ ŋ b o̞ k̚	수영복
수영장	sʰ u j ʌ̹ ŋ d͡ʑ a̠ ŋ	수영장
수요	sʰ u j o	수요
수요일	sʰ u j o i ɭ	수요일
수원	sʰ u w ʌ̹ n	수원
수은	sʰ u ɯ n	수은
수음하다	sʰ u ɯ m ɦ a̠ d a̠	수음하다
수의사	sʰ u ɰ i sʰ a̠	수의사
수입	sʰ u i p̚	수입
수저	sʰ u d͡ʑ ʌ̹	수저
수적	sʰ uː t͡ɕ͈ ʌ̹ k̚	수쩍
수전	sʰ u d͡ʑ ʌ̹ n	수전
수정란	sʰ u d͡ʑ ʌ̹ ŋ n a̠ n	수정난
수정체	sʰ u d͡ʑ ʌ̹ ŋ t͡ɕʰ e̞	수정체
수조	sʰ u d͡ʑ o̞	수조
수족관	sʰ u d͡ʑ o̞ k̚ k͈ w a̠ n	수족꽌
수준	sʰ u d͡ʑ u n	수준
수줍다	sʰ u d͡ʑ u p̚ t͈ a̠	수줍따
수질	sʰ u d͡ʑ i ɭ	수질
수집하다	sʰ u d͡ʑ i pʰ a̠ d a̠	수지파다
수축	sʰ u t͡ɕʰ u k̚	수축
수출	sʰ u t͡ɕʰ u ɭ	수출
수출품	sʰ u t͡ɕʰ u ɭ pʰ u m	수출품
수치	sʰ u t͡ɕʰ i	수치
수칙	sʰ u t͡ɕʰ i k̚	수칙
수컷	sʰ u kʰ ʌ̹ t̚	수컫
수평	sʰ u pʰ j ʌ̹ ŋ	수평
수평선	sʰ u pʰ j ʌ̹ ŋ sʰ ʌ̹ n	수평선
수포자	sʰ uː pʰ o̞ d͡ʑ a̠	수포자
수표	sʰ u pʰ j o	수표
수프	sʰ u pʰ ɯ	수프
수필	sʰ u pʰ i ɭ	수필
수학자	sʰ uː ɦ a̠ k̚ t͡ɕ͈ a̠	수학짜
수호	sʰ u β o̞	수호
수호신	sʰ u β o̞ ɕʰ i n	수호신
수화	sʰ u β w a̠	수화
수화기	sʰ u β w a̠ ɡ i	수화기
숙답	sʰ u k̚ t͈ a̠ p̚	숙땁
숙명	sʰ u ŋ m j ʌ̹ ŋ	숭명
숙어	sʰ u ɡ ʌ̹	수거
숙제	sʰ u k̚ t͡ɕ͈ e̞	숙쩨
숙주나물	sʰ u k̚ t͡ɕ͈ u n a̠ m u ɭ	숙쭈나물
순간	sʰ u n ɡ a̠ n	순간
순결	sʰ u n ɡ j ʌ̹ ɭ	순결
순교	sʰ u n ɡ j o	순교
순교자	sʰ u n ɡ j o d͡ʑ a̠	순교자
순두부	sʰ u n d u b u	순두부
순례	sʰ u ʎ ʎ j e̞	술례
순박	sʰ u n b a̠ k̚	순박
순박하다	sʰ u n b a̠ kʰ a̠ d a̠	순바카다
순서	sʰ uː n sʰ ʌ̹	순서
순수	sʰ u n sʰ u	순수
순수하다	sʰ u n sʰ u ɦ a̠ d a̠	순수하다
순양함	sʰ u ɲ j a̠ ŋ ɦ a̠ m	수냥함
순천	sʰ uː ɲ t͡ɕʰ ʌ̹ n	순천
순회심판소	sʰ u n β w e̞ ɕʰ i m pʰ a̠ n sʰ o̞	순회심판소
순흥	sʰ u n ɣ ɯ ŋ	순ɣㅡㅇ
숟가락	sʰ u t̚ k͈ a̠ ɾ a̠ k̚	숟까락
술독	sʰ u ɭ d o̞ k̚	술독
술병	sʰ u ɭ p͈ j ʌ̹ ŋ	술뼝
술어	sʰ u ɾ ʌ̹	수러
술집	sʰ u ʎ t͡ɕ͈ i p̚	술찝
숨기다	sʰ u m ɡ i d a̠	숨기다
숨쉬다	sʰ u m ʃʰ ɥ i d a̠	숨쉬다
숨통	sʰ u m tʰ o̞ ŋ	숨통
숫자	sʰ uː t̚ t͡ɕ͈ a̠	숟짜
숭늉	sʰ u ŋ ɲ j u ŋ	숭늉
숭어	sʰ uː ŋ ʌ̹	수어
쉬다	ʃʰ ɥ iː d a̠	쉬다
쉽게	ʃʰ ɥ i p̚ k͈ e̞	쉽께
쉽다	ʃʰ ɥ iː p̚ t͈ a̠	쉽따
슈크림	ɕʰ u k x ɯ ɾ i m	숙흐림
슈퍼마켓	ɕʰ u pʰ ʌ̹ m a̠ kʰ e̞ t̚	수퍼마켇
스노보드	sʰ ɯ n o̞ b o̞ d ɯ	스노보드
스님	sʰ ɯ n i m	스님
스도쿠	sʰ ɯ d o̞ kʰ u	스도쿠
스라소니	sʰ ɯ ɾ a̠ sʰ o̞ n i	스라소니
스럽다	sʰ ɯ ɾ ʌ̹ p̚ t͈ a̠	스럽따
스르르	sʰ ɯ ɾ ɯ ɾ ɯ	스르르
스리랑카	sʰ ɯ ɾ i ɾ a̠ ŋ kʰ a̠	스리랑카
스마트폰	sʰ ɯ m a̠ tʰ ɯ pʰ o̞ n	스마트폰
스며들다	sʰ ɯ m j ʌ̹ d ɯ ɭ d a̠	스며들다
스모	s͈ ɯ m o̞	쓰모
스모그	sʰ ɯ m o̞ ɡ ɯ	스모그
스몰렌스크	sʰ ɯ m o̞ ɭ ɭ e̞ n sʰ ɯ k x ɯ	스몰렌슥흐
스무니다	sʰ ɯ m u n i d a̠	스무니다
스스로	sʰ ɯ sʰ ɯ ɾ o̞	스스로
스스이	sʰ ɯ sʰ ɯ i	스스이
스승	sʰ ɯ sʰ ɯ ŋ	스승
스시	sʰ ɯ ɕʰ i	스시
스시국	sʰ ɯ ɕʰ i ɡ u k̚	스시국
스웨덴	sʰ ɯ w e̞ d e̞ n	스웨덴
스웨리예	sʰ ɯ w e̞ ɾ i j e̞	스웨리예
스웨터	sʰ ɯ w e̞ tʰ ʌ̹	스웨터
스위스	sʰ ɯ ɥ i sʰ ɯ	스위스
스위치	sʰ ɯ ɥ i t͡ɕʰ i	스위치
스카이	sʰ ɯ kʰ a̠ i	스카이
스카프	sʰ ɯ kʰ a̠ pʰ ɯ	스카프
스커트	sʰ ɯ kʰ ʌ̹ tʰ ɯ	스커트
스컹크	sʰ ɯ kʰ ʌ̹ ŋ k x ɯ	스컹ㄱ흐
스케이트	sʰ ɯ kʰ e̞ i tʰ ɯ	스케이트
스케이트보드	sʰ ɯ kʰ e̞ i tʰ ɯ b o̞ d ɯ	스케이트보드
스케줄	sʰ ɯ kʰ e̞ d͡ʑ u ɭ	스케줄
스쿠터	sʰ ɯ kʰ u tʰ ʌ̹	스쿠터
스쿼시	sʰ ɯ kʰ w ʌ̹ ɕʰ i	스쿼시
스크린	sʰ ɯ k x ɯ ɾ i n	슥흐린
스타	sʰ ɯ tʰ a̠	스타
스타디움	sʰ ɯ tʰ a̠ d i u m	스타디움
스타벅스	sʰ ɯ tʰ a̠ b ʌ̹ k s͈ ɯ	스타벅쓰
스타일	sʰ ɯ tʰ a̠ i ɭ	스타일
스테아린	sʰ ɯ tʰ e̞ a̠ ɾ i n	스테아린
스테이크	sʰ ɯ tʰ e̞ i k x ɯ	스테익흐
스테이플러	sʰ ɯ tʰ e̞ i pʰ ɯ ɭ ɭ ʌ̹	스테이플러
스텝	sʰ ɯ tʰ e̞ p̚	스텝
스토브	sʰ ɯ tʰ o̞ b ɯ	스토브
스톤헨지	sʰ ɯ tʰ o̞ n ɦ e̞ ɲ d͡ʑ i	스톤헨지
스튜디오	s͈ ɯ tʰ j u d i o̞	쓰튜디오
스튜어디스	sʰ ɯ tʰ j u ʌ̹ d i sʰ ɯ	스튜어디스
스트레스	sʰ ɯ tʰ ɯ ɾ e̞ s͈ ɯ	스트레쓰
스트레이트	sʰ ɯ tʰ ɯ ɾ e̞ i tʰ ɯ	스트레이트
스트로	sʰ ɯ tʰ ɯ ɾ o̞	스트로
스트론튬	sʰ ɯ tʰ ɯ ɾ o̞ n tʰ j u m	스트론튬
스트리크닌	sʰ ɯ tʰ ɯ ɾ i k x ɯ n i n	스트릭흐닌
스티커	sʰ ɯ tʰ i kʰ ʌ̹	스티커
스파게티	sʰ ɯ pʰ a̠ ɡ e̞ tʰ i	스파게티
스파이	sʰ ɯ pʰ a̠ i	스파이
스파이웨어	sʰ ɯ pʰ a̠ i w e̞ ʌ̹	스파이웨어
스펀지	sʰ ɯ pʰ ʌ̹ ɲ d͡ʑ i	스펀지
스페인	sʰ ɯ pʰ e̞ i n	스페인
스페인어	sʰ ɯ pʰ e̞ i n ʌ̹	스페이너
스펙트럼	sʰ ɯ pʰ e̞ k̚ tʰ ɯ ɾ ʌ̹ m	스펙트럼
스포일러	s͈ ɯ pʰ o̞ i ɭ ɭ ʌ̹	쓰포일러
스포츠	sʰ ɯ pʰ o̞ t͡ɕʰ ɯ	스포츠
스푸트니크	sʰ ɯ pʰ u tʰ ɯ n i k x ɯ	스푸트닉흐
스푼	sʰ ɯ pʰ u n	스푼
스프링클러	sʰ ɯ pʰ ɯ ɾ i ŋ k x ɯ ɭ ɭ ʌ̹	스프링ㄱ흘러
스피커	s͈ ɯ pʰ i kʰ ʌ̹	쓰피커
슬금슬금	sʰ ɯ ɭ ɡ ɯ m sʰ ɯ ɭ ɡ ɯ m	슬금슬금
슬기	sʰ ɯ ɭ ɡ i	슬기
슬라브	sʰ ɯ ɭ ɭ a̠ b ɯ	슬라브
슬로건	s͈ ɯ ɭ ɭ o̞ ɡ ʌ̹ n	쓸로건
슬로베니아	sʰ ɯ ɭ ɭ o̞ b e̞ n i a̠	슬로베니아
슬로베니아어	sʰ ɯ ɭ ɭ o̞ b e̞ n i a̠ ʌ̹	슬로베니아어
슬로벤스꼬	sʰ ɯ ɭ ɭ o̞ b e̞ n sʰ ɯ k͈ o̞	슬로벤스꼬
슬리퍼	sʰ ɯ ʎ ʎ i pʰ ʌ̹	슬리퍼
슬며시	sʰ ɯ ɭ m j ʌ̹ ɕʰ i	슬며시
슬쩍슬쩍	sʰ ɯ ʎ t͡ɕ͈ ʌ̹ k s͈ ɯ ʎ t͡ɕ͈ ʌ̹ k̚	슬쩍쓸쩍
슬프다	sʰ ɯ ɭ pʰ ɯ d a̠	슬프다
슬픔	sʰ ɯ ɭ pʰ ɯ m	슬픔
습격	sʰ ɯ p̚ k͈ j ʌ̹ k̚	습껵
습기	sʰ ɯ p̚ k͈ i	습끼
습니까	s͈ ɯ m n i k͈ a̠	씀니까
습니다	s͈ ɯ m n i d a̠	씀니다
습도	sʰ ɯ p̚ t͈ o̞	습또
습득	sʰ ɯ p̚ t͈ ɯ k̚	습뜩
승강기	sʰ ɯ ŋ ɡ a̠ ŋ ɡ i	승강기
승계	sʰ ɯ ŋ ɡ j e̞	승계
승냥이	sʰ ɯ ŋ ɲ j a̠ ŋ i	승냐이
승려	sʰ ɯ ŋ ɲ j ʌ̹	승녀
승리	sʰ ɯ ŋ n i	승니
승무원	sʰ ɯ ŋ m u w ʌ̹ n	승무원
승부	sʰ ɯ ŋ b u	승부
승진	sʰ ɯ ŋ d͡ʑ i n	승진
승하하다	sʰ ɯ ŋ ɦ a̠ ɦ a̠ d a̠	승하하다
승화	sʰ ɯ ŋ β w a̠	승화
시가	ɕʰ i ɡ a̠	시가
시가전차	ɕʰ i ɡ a̠ d͡ʑ ʌ̹ ɲ t͡ɕʰ a̠	시가전차
시간표	ɕʰ i ɡ a̠ n pʰ j o	시간표
시계	ɕʰ iː ɡ j e̞	시계
시골	ɕʰ i ɡ o̞ ɭ	시골
시궁쥐	ɕʰ i ɡ u ŋ d͡ʑ ɥ i	시궁쥐
시금치	ɕʰ i ɡ ɯ m t͡ɕʰ i	시금치
시꺼멓다	ɕʰ i k͈ ʌ̹ m ʌ̹ tʰ a̠	시꺼머타
시끄럽다	ɕʰ i k͈ ɯ ɾ ʌ̹ p̚ t͈ a̠	시끄럽따
시나브로	ɕʰ i n a̠ b ɯ ɾ o̞	시나브로
시누이	ɕʰ i n u i	시누이
시다	ɕʰ i d a̠	시다
시도	ɕʰ iː d o̞	시도
시도하다	ɕʰ iː d o̞ ɦ a̠ d a̠	시도하다
시드니	ɕʰ i d ɯ n i	시드니
시디	ɕʰ i d i	시디
시럽	ɕʰ i ɾ ʌ̹ p̚	시럽
시력	ɕʰ iː ɾ j ʌ̹ k̚	시력
시루	ɕʰ i ɾ u	시루
시름	ɕʰ i ɾ ɯ m	시름
시리다	ɕʰ i ɾ i d a̠	시리다
시물	ɕʰ i m u ɭ	시물
시민	ɕʰ iː m i n	시민
시방	ɕʰ i b a̠ ŋ	시방
시베리아	ɕʰ i b e̞ ɾ i a̠	시베리아
시보	ɕʰ i b o̞	시보
시부모	ɕʰ i b u m o̞	시부모
시비	ɕʰ i b i	시비
시상	ɕʰ iː sʰ a̠ ŋ	시상
시상하부	ɕʰ iː sʰ a̠ ŋ h a̠ b u	시상하부
시선	ɕʰ iː sʰ ʌ̹ n	시선
시스터	ɕʰ i sʰ ɯ tʰ ʌ̹	시스터
시스템	ɕ͈ i sʰ ɯ tʰ e̞ m	씨스템
시심마	ɕʰ iː ɕʰ i m m a̠	시심마
시아버지	ɕʰ i a̠ b ʌ̹ d͡ʑ i	시아버지
시어머니	ɕʰ i ʌ̹ m ʌ̹ n i	시어머니
시에라리온	ɕ͈ i e̞ ɾ a̠ ɾ i o̞ n	씨에라리온
시원하다	ɕʰ i w ʌ̹ n ɦ a̠ d a̠	시원하다
시위	ɕʰ iː ɥ i	시위
시읏	ɕʰ i ɯ t̚	시읃
시작되다	ɕʰ iː d͡ʑ a̠ k̚ t͈ w e̞ d a̠	시작뙤다
시작하다	ɕʰ iː d͡ʑ a̠ kʰ a̠ d a̠	시자카다
시장하시다	ɕʰ i d͡ʑ a̠ ŋ ɦ a̠ ɕʰ i d a̠	시장하시다
시절	ɕʰ i d͡ʑ ʌ̹ ɭ	시절
시제	ɕʰ i d͡ʑ e̞	시제
시주	ɕʰ iː d͡ʑ u	시주
시중	ɕʰ iː d͡ʑ u ŋ	시중
시즌	ɕʰ i d͡ʑ ɯ n	시즌
시짱	ɕʰ i t͡ɕ͈ a̠ ŋ	시짱
시찰	ɕʰ i t͡ɕʰ a̠ ɭ	시찰
시청	ɕʰ iː t͡ɕʰ ʌ̹ ŋ	시청
시청자	ɕʰ iː t͡ɕʰ ʌ̹ ŋ d͡ʑ a̠	시청자
시체	ɕʰ iː t͡ɕʰ e̞	시체
시치미	ɕʰ i t͡ɕʰ i m i	시치미
시카고	ɕʰ i kʰ a̠ ɡ o̞	시카고
시토회	ɕʰ i tʰ o̞ β w e̞	시토회
시편	ɕʰ i pʰ j ʌ̹ n	시편
시합	ɕʰ i ɦ a̠ p̚	시합
시험	ɕʰ i ɦ ʌ̹ m	시험
시험하다	ɕʰ i ɦ ʌ̹ m ɦ a̠ d a̠	시험하다
식구	ɕʰ i k̚ k͈ u	식꾸
식기세척기	ɕʰ i k̚ k͈ i sʰ e̞ t͡ɕʰ ʌ̹ k̚ k͈ i	식끼세척끼
식량	ɕʰ i ŋ ɲ j a̠ ŋ	싱냥
식료품	ɕʰ i ŋ ɲ j o pʰ u m	싱뇨품
식료품점	ɕʰ i ŋ ɲ j o pʰ u m d͡ʑ ʌ̹ m	싱뇨품점
식물	ɕʰ i ŋ m u ɭ	싱물
식물학	ɕʰ i ŋ m u ɾ ɦ a̠ k̚	싱물학
식민지	ɕʰ i ŋ m i ɲ d͡ʑ i	싱민지
식빵	ɕʰ i k̚ p͈ a̠ ŋ	식빵
식사	ɕʰ i k s͈ a̠	식싸
식욕	ɕʰ i ɡ j o k̚	시굑
식용유	ɕʰ i ɡ j o ŋ ɲ j u	시굥뉴
식자	ɕʰ i k̚ t͡ɕ͈ a̠	식짜
식전	ɕʰ i k̚ t͡ɕ͈ ʌ̹ n	식쩐
식중독	ɕʰ i k̚ t͡ɕ͈ u ŋ d o̞ k̚	식쭝독
식초	ɕʰ i k̚ t͡ɕʰ o̞	식초
식탁	ɕʰ i k̚ tʰ a̠ k̚	식탁
식품	ɕʰ i k̚ pʰ u m	식품
식품보존료	ɕʰ i k̚ pʰ u m b o̞ d͡ʑ o̞ ʎ ʎ j o	식품보졸료
신경전달물질	ɕʰ i n ɡ j ʌ̹ ŋ d͡ʑ ʌ̹ n d a̠ ɭ m u ʎ t͡ɕ͈ i ɭ	신경전달물찔
신곡	ɕʰ i n ɡ o̞ k̚	신곡
신교도	ɕʰ i n ɡ j o d o̞	신교도
신규	ɕʰ i n ɡ j u	신규
신기	ɕʰ i n ɡ i	신기
신기루	ɕʰ iː n ɡ i ɾ u	신기루
신기하다	ɕʰ iː n ɡ i ɦ a̠ d a̠	신기하다
신념	ɕʰ iː n ɲ j ʌ̹ m	신념
신다	ɕʰ iː n t͈ a̠	신따
신도	ɕʰ i n d o̞	신도
신라	ɕʰ i ɭ ɭ a̠	실라
신랑	ɕʰ i ɭ ɭ a̠ ŋ	실랑
신뢰	ɕʰ iː ɭ ɭ w e̞	실뢰
신문	ɕʰ i n m u n	신문
신미	ɕʰ i n m i	신미
신발	ɕʰ i n b a̠ ɭ	신발
신부	ɕʰ i n b u	신부
신부님	ɕʰ i n b u n i m	신부님
신분	ɕʰ i n b u n	신분
신비	ɕʰ i n b i	신비
신사	ɕʰ iː n sʰ a̠	신사
신선	ɕʰ i n sʰ ʌ̹ n	신선
신선하다	ɕʰ i n sʰ ʌ̹ n ɦ a̠ d a̠	신선하다
신성	ɕʰ i n sʰ ʌ̹ ŋ	신성
신세계	ɕʰ i n sʰ e̞ ɡ j e̞	신세계
신속	ɕʰ iː n sʰ o̞ k̚	신속
신수	ɕʰ i n sʰ u	신수
신시사이저	ɕʰ i n ɕʰ i sʰ a̠ i d͡ʑ ʌ̹	신시사이저
신시아	ɕʰ i n ɕʰ i a̠	신시아
신앙	ɕʰ iː n a̠ ŋ	시낭
신용	ɕʰ iː ɲ j o ŋ	시뇽
신의주	ɕʰ i n ɰ i d͡ʑ u	시늬주
신임	ɕʰ iː n i m	시님
신임하다	ɕʰ iː n i m ɦ a̠ d a̠	시님하다
신자	ɕʰ iː ɲ d͡ʑ a̠	신자
신장위	ɕʰ i ɲ d͡ʑ a̠ ŋ ɥ i	신자위
신조어	ɕʰ i ɲ d͡ʑ o̞ ʌ̹	신조어
신종	ɕʰ iː ɲ d͡ʑ o̞ ŋ	신종
신주	ɕʰ i ɲ d͡ʑ u	신주
신중하다	ɕʰ iː ɲ d͡ʑ u ŋ ɦ a̠ d a̠	신중하다
신청	ɕʰ i ɲ t͡ɕʰ ʌ̹ ŋ	신청
신청자	ɕʰ i ɲ t͡ɕʰ ʌ̹ ŋ d͡ʑ a̠	신청자
신체	ɕʰ i ɲ t͡ɕʰ e̞	신체
신칸센	ɕʰ i n kʰ a̠ n sʰ e̞ n	신칸센
신탁통치	ɕʰ i n tʰ a̠ k̚ tʰ o̞ ŋ t͡ɕʰ i	신탁통치
신학	ɕʰ i n ɦ a̠ k̚	신학
신형	ɕʰ iː n ʝ j ʌ̹ ŋ	신형
신형코로나비루스감염증	ɕʰ i n ʝ j ʌ̹ ŋ kʰ o̞ ɾ o̞ n a̠ b i ɾ u sʰ ɯ ɡ a̠ m j ʌ̹ m d͡ʑ ɯ ŋ	신형코로나비루스가몀증
신호	ɕʰ iː n β o̞	신호
신호등	ɕʰ iː n β o̞ d ɯ ŋ	신호등
신호총	ɕʰ i n β o̞ t͡ɕʰ o̞ ŋ	신호총
신화	ɕʰ i n β w a̠	신화
실력	ɕʰ i ʎ ʎ j ʌ̹ k̚	실력
실례	ɕʰ i ʎ ʎ j e̞	실례
실로	ɕʰ i ɭ ɭ o̞	실로
실로폰	ɕʰ i ɭ ɭ o̞ pʰ o̞ n	실로폰
실록	ɕʰ i ɭ ɭ o̞ k̚	실록
실마리	ɕʰ iː ɭ m a̠ ɾ i	실마리
실망	ɕʰ i ɭ m a̠ ŋ	실망
실망하다	ɕʰ i ɭ m a̠ ŋ ɦ a̠ d a̠	실망하다
실명	ɕʰ i ɭ m j ʌ̹ ŋ	실명
실수	ɕʰ i ɭ s͈ u	실쑤
실습	ɕʰ i ɭ s͈ ɯ p̚	실씁
실시	ɕʰ i ɭ ɕ͈ i	실씨
실업	ɕʰ i ɾ ʌ̹ p̚	시럽
실업가	ɕʰ i ɾ ʌ̹ p̚ k͈ a̠	시럽까
실장	ɕʰ i ʎ t͡ɕ͈ a̠ ŋ	실짱
실정	ɕʰ i ʎ t͡ɕ͈ ʌ̹ ŋ	실쩡
실제	ɕʰ i ʎ t͡ɕ͈ e̞	실쩨
실제로	ɕʰ i ʎ t͡ɕ͈ e̞ ɾ o̞	실쩨로
실존주의	ɕʰ i ʎ t͡ɕ͈ o̞ ɲ d͡ʑ u ɰ i	실쫀주의
실천	ɕʰ i ʎ t͡ɕʰ ʌ̹ n	실천
실체	ɕʰ i ʎ t͡ɕʰ e̞	실체
실컷	ɕʰ i ɭ kʰ ʌ̹ t̚	실컫
실험	ɕʰ i ɾ ɦ ʌ̹ m	실험
실현	ɕʰ i ɾ ʝ j ʌ̹ n	실현
싫다	ɕʰ i ɭ tʰ a̠	실타
싫어하다	ɕʰ i ɾ ʌ̹ ɦ a̠ d a̠	시러하다
심각하다	ɕʰ iː m ɡ a̠ kʰ a̠ d a̠	심가카다
심다	ɕʰ iː m t͈ a̠	심따
심란하다	ɕʰ i m n a̠ n ɦ a̠ d a̠	심난하다
심리학	ɕʰ i m n i ɦ a̠ k̚	심니학
심마니	ɕʰ i m m a̠ n i	심마니
심마니말	ɕʰ i m m a̠ n i m a̠ ɭ	심마니말
심부름	ɕʰ iː m b u ɾ ɯ m	심부름
심사	ɕʰ i m sʰ a̠	심사
심사숙고	ɕʰ iː m sʰ a̠ sʰ u k̚ k͈ o̞	심사숙꼬
심성	ɕʰ i m sʰ ʌ̹ ŋ	심성
심심하다	ɕʰ i m ɕʰ i m ɦ a̠ d a̠	심심하다
심정	ɕʰ i m d͡ʑ ʌ̹ ŋ	심정
심지	ɕʰ i m d͡ʑ i	심지
심포지엄	ɕʰ i m pʰ o̞ d͡ʑ i ʌ̹ m	심포지엄
십삼	ɕʰ i p s͈ a̠ m	십쌈
십오	ɕʰ i b o̞	시보
십이	ɕʰ i b i	시비
십일월	ɕʰ i b i ɾ w ʌ̹ ɭ	시비뤌
십자	ɕʰ i p̚ t͡ɕ͈ a̠	십짜
십자가	ɕʰ i p̚ t͡ɕ͈ a̠ ɡ a̠	십짜가
싱가포르	ɕʰ i ŋ ɡ a̠ pʰ o̞ ɾ ɯ	싱가포르
싱글싱글	ɕʰ i ŋ ɡ ɯ ɭ ɕʰ i ŋ ɡ ɯ ɭ	싱글싱글
싶다	ɕʰ i p̚ t͈ a̠	십따
싸다	s͈ a̠ d a̠	싸다
싸리	s͈ a̠ ɾ i	싸리
싸우다	s͈ a̠ u d a̠	싸우다
쌀국수	s͈ a̠ ɭ ɡ u k s͈ u	쌀국쑤
쌀미꾸리	s͈ a̠ ɭ m i k͈ u ɾ i	쌀미꾸리
쌀밥	s͈ a̠ ɭ b a̠ p̚	쌀밥
쌀쌀	s͈ a̠ ɭ s͈ a̠ ɭ	쌀쌀
쌀쌀하다	s͈ a̠ ɭ s͈ a̠ ɾ ɦ a̠ d a̠	쌀쌀하다
쌀쌀히	s͈ a̠ ɭ s͈ a̠ ɾ ʝ i	쌀쌀히
쌍꺼풀	s͈ a̠ ŋ k͈ ʌ̹ pʰ u ɭ	쌍꺼풀
쌍둥이	s͈ a̠ ŋ d u ŋ i	쌍두이
쌍디귿	s͈ a̠ ŋ d i ɡ ɯ t̚	쌍디귿
쌍안경	s͈ a̠ ŋ a̠ n ɡ j ʌ̹ ŋ	싸안경
쌓다	s͈ a̠ tʰ a̠	싸타
써리다	s͈ ɘː ɾ i d a̠	써리다
써우지	s͈ ʌ̹ u d͡ʑ i	써우지
쎈터	s͈ e̞ n tʰ ʌ̹	쎈터
쏘가리	s͈ o̞ ɡ a̠ ɾ i	쏘가리
쏘다	s͈ o̞ː d a̠	쏘다
쏜살같이	s͈ o̞ n sʰ a̠ ɭ ɡ a̠ t͡ɕʰ i	쏜살가치
쏟아지다	s͈ o̞ d a̠ d͡ʑ i d a̠	쏘다지다
쐐기	s͈ w ɛː ɡ i	쐐기
쐬다	s͈ w e̞ː d a̠	쐬다
쑤시다	s͈ u ɕʰ i d a̠	쑤시다
쑥갓	s͈ u k̚ k͈ a̠ t̚	쑥깓
쓰다	s͈ ɯ d a̠	쓰다
쓰다듬다	s͈ ɯ d a̠ d ɯ m t͈ a̠	쓰다듬따
쓰딸로바야	s͈ ɯ t͈ a̠ ɭ ɭ o̞ b a̠ j a̠	쓰딸로바야
쓰러지다	s͈ ɯ ɾ ʌ̹ d͡ʑ i d a̠	쓰러지다
쓰레기	s͈ ɯ ɾ e̞ ɡ i	쓰레기
쓰리	s͈ ɯ ɾ i	쓰리
쓰이다	s͈ ɯ i d a̠	쓰이다
쓰푸	s͈ ɯ pʰ u	쓰푸
쓸데	s͈ ɯ ɭ t͈ e̞	쓸떼
쓸모	s͈ ɯ ɭ m o̞	쓸모
씌우다	ɕ͈ i u d a̠	씨우다
씨름	ɕ͈ i ɾ ɯ m	씨름
씨앗	ɕ͈ i a̠ t̚	씨앋
씹거웃	ɕ͈ i p̚ k͈ ʌ̹ u t̚	씹꺼욷
씹다	ɕ͈ i p̚ t͈ a̠	씹따
씹덕	ɕ͈ i p̚ t͈ ʌ̹ k̚	씹떡
씻다	ɕ͈ i t̚ t͈ a̠	씯따
아가미	a̠ ɡ a̠ m i	아가미
아가씨	a̠ ɡ a̠ ɕ͈ i	아가씨
아군	a̠ː ɡ u n	아군
아궁이	a̠ ɡ u ŋ i	아구이
아기	a̠ ɡ i	아기
아나운서	a̠ n a̠ u n sʰ ʌ̹	아나운서
아냐	a̠ ɲ j a̠	아냐
아니	a̠ n i	아니
아니다	a̠ n i d a̠	아니다
아니메	a̠ n i m e̞	아니메
아니면	a̠ n i m j ʌ̹ n	아니면
아니야	a̠ n i j a̠	아니야
아담	a̠ d a̠ m	아담
아동	a̠ d o̞ ŋ	아동
아들딸	a̠ d ɯ ɭ t͈ a̠ ɭ	아들딸
아디스아바바	a̠ d i sʰ ɯ a̠ b a̠ b a̠	아디스아바바
아라	a̠ ɾ a̠	아라
아라비아	a̠ ɾ a̠ b i a̠	아라비아
아라한	a̠ ɾ a̠ ɦ a̠ n	아라한
아랍	a̠ ɾ a̠ p̚	아랍
아랍어	a̠ ɾ a̠ b ʌ̹	아라버
아랍에미리트	a̠ ɾ a̠ b e̞ m i ɾ i tʰ ɯ	아라베미리트
아련	a̠ ɾ j ʌ̹ n	아련
아련히	a̠ ɾ j ʌ̹ n ʝ i	아련히
아론	a̠ ɾ o̞ n	아론
아롱아롱	a̠ ɾ o̞ ŋ a̠ ɾ o̞ ŋ	아로아롱
아르메니아	a̠ ɾ ɯ m e̞ n i a̠	아르메니아
아르메니아어	a̠ ɾ ɯ m e̞ n i a̠ ʌ̹	아르메니아어
아르바이트	a̠ ɾ ɯ b a̠ i tʰ ɯ	아르바이트
아름답다	a̠ ɾ ɯ m d a̠ p̚ t͈ a̠	아름답따
아리	a̠ ɾ i	아리
아리랑	a̠ ɾ i ɾ a̠ ŋ	아리랑
아리수	a̠ ɾ i sʰ u	아리수
아마	a̠ m a̠	아마
아마도	a̠ m a̠ d o̞	아마도
아마존	a̠ m a̠ d͡ʑ o̞ n	아마존
아마추어	a̠ m a̠ t͡ɕʰ u ʌ̹	아마추어
아메리카	a̠ m e̞ ɾ i kʰ a̠	아메리카
아메바	a̠ m e̞ b a̠	아메바
아멘	a̠ m e̞ n	아멘
아몬드	a̠ m o̞ n d ɯ	아몬드
아무	a̠ː m u	아무
아무런	a̠ː m u ɾ ʌ̹ n	아무런
아무리	a̠ː m u ɾ i	아무리
아미노산	a̠ m i n o̞ sʰ a̠ n	아미노산
아미타불	a̠ m i tʰ a̠ b u ɭ	아미타불
아민	a̠ m i n	아민
아바나	a̠ b a̠ n a̠	아바나
아버님	a̠ b ʌ̹ n i m	아버님
아보카도	a̠ b o̞ kʰ a̠ d o̞	아보카도
아부다비	a̠ b u d a̠ b i	아부다비
아부자	a̠ b u d͡ʑ a̠	아부자
아브라함	a̠ b ɯ ɾ a̠ ɦ a̠ m	아브라함
아비	a̠ b i	아비
아빠트	a̠ p͈ a̠ tʰ ɯ	아빠트
아뿔싸	a̠ p͈ u ɭ s͈ a̠	아뿔싸
아서	a̠ sʰ ʌ̹	아서
아수라	a̠ː sʰ u ɾ a̠	아수라
아순시온	a̠ sʰ u n ɕʰ i o̞ n	아순시온
아쉬움	a̠ ʃʰ ɥ i u m	아쉬움
아쉽다	a̠ ʃʰ ɥ i p̚ t͈ a̠	아쉽따
아스타나	a̠ sʰ ɯ tʰ a̠ n a̠	아스타나
아스타틴	a̠ sʰ ɯ tʰ a̠ tʰ i n	아스타틴
아스텍	a̠ sʰ ɯ tʰ e̞ k̚	아스텍
아스파라거스	a̠ sʰ ɯ pʰ a̠ ɾ a̠ ɡ ʌ̹ sʰ ɯ	아스파라거스
아시아	a̠ ɕʰ i a̠	아시아
아시타비	a̠ː ɕʰ i tʰ a̠ b i	아시타비
아악	a̠ː a̠ k̚	아악
아야	a̠ j a̠	아야
아야겠	a̠ j a̠ ɡ e̞ t̚	아야겓
아연	a̠ j ʌ̹ n	아연
아예	a̠ j e̞	아예
아오자이	a̠ o̞ d͡ʑ a̠ i	아오자이
아요	a̠ j o	아요
아우구스투스	a̠ u ɡ u sʰ ɯ tʰ u sʰ ɯ	아우구스투스
아웃	a̠ u t̚	아욷
아유	a̠ j u	아유
아이	a̠ i	아이
아이가	a̠ i ɡ a̠	아이가
아이고	a̠ i ɡ o̞	아이고
아이다	a̠ i d a̠	아이다
아이돌	a̠ i d o̞ ɭ	아이돌
아이들	a̠ i d ɯ ɭ	아이들
아이디	a̠ i d i	아이디
아이쇼핑	a̠ i ɕ͈ o pʰ i ŋ	아이쑈핑
아이슬란드	a̠ i sʰ ɯ ɭ ɭ a̠ n d ɯ	아이슬란드
아이콘	a̠ i kʰ o̞ n	아이콘
아이템	a̠ i tʰ e̞ m	아이템
아이티	a̠ i tʰ i	아이티
아이폰	a̠ i pʰ o̞ n	아이폰
아자	a̠ d͡ʑ a̠	아자
아저씨	a̠ d͡ʑ ʌ̹ ɕ͈ i	아저씨
아점	a̠ d͡ʑ ʌ̹ m	아점
아제르바이잔	a̠ d͡ʑ e̞ ɾ ɯ b a̠ i d͡ʑ a̠ n	아제르바이잔
아제티딘	a̠ d͡ʑ e̞ tʰ i d i n	아제티딘
아주	a̠ d͡ʑ u	아주
아주머니	a̠ d͡ʑ u m ʌ̹ n i	아주머니
아줄렌	a̠ d͡ʑ u ɭ ɭ e̞ n	아줄렌
아즈바이	a̠ d͡ʑ ɯ b a̠ i	아즈바이
아지트	a̠ d͡ʑ i tʰ ɯ	아지트
아직	a̠ d͡ʑ i k̚	아직
아체쥐	a̠ t͡ɕʰ e̞ d͡ʑ ɥ i	아체쥐
아카데미	a̠ kʰ a̠ d e̞ m i	아카데미
아코디언	a̠ kʰ o̞ d i ʌ̹ n	아코디언
아크라	a̠ k x ɯ ɾ a̠	악흐라
아크리딘	a̠ k x ɯ ɾ i d i n	악흐리딘
아테네	a̠ tʰ e̞ n e̞	아테네
아틀리에	a̠ tʰ ɯ ʎ ʎ i e̞	아틀리에
아티초크	a̠ tʰ i t͡ɕʰ o̞ k x ɯ	아티촉흐
아파르트헤이트	a̠ pʰ a̠ ɾ ɯ tʰ ɯ ɦ e̞ i tʰ ɯ	아파르트헤이트
아파트	a̠ pʰ a̠ tʰ ɯ	아파트
아편	a̠ pʰ j ʌ̹ n	아편
아프가니스탄	a̠ pʰ ɯ ɡ a̠ n i sʰ ɯ tʰ a̠ n	아프가니스탄
아프다	a̠ pʰ ɯ d a̠	아프다
아프로디테	a̠ pʰ ɯ ɾ o̞ d i tʰ e̞	아프로디테
아프리카	a̠ pʰ ɯ ɾ i kʰ a̠	아프리카
아휴	a̠ ʝ j u	아휴
아흐레	a̠ ɣ ɯ ɾ e̞	아ɣㅡ레
악곡	a̠ k̚ k͈ o̞ k̚	악꼭
악단	a̠ k̚ t͈ a̠ n	악딴
악당	a̠ k̚ t͈ a̠ ŋ	악땅
악동	a̠ k̚ t͈ o̞ ŋ	악똥
악력	a̠ ŋ ɲ j ʌ̹ k̚	앙녁
악마	a̠ ŋ m a̠	앙마
악몽	a̠ ŋ m o̞ ŋ	앙몽
악성	a̠ k s͈ ʌ̹ ŋ	악썽
악수	a̠ k s͈ u	악쑤
악습	a̠ k s͈ ɯ p̚	악씁
악어	a̠ ɡ ʌ̹	아거
악영향	a̠ ɡ j ʌ̹ ŋ ʝ j a̠ ŋ	아경향
악인	a̠ ɡ i n	아긴
악취	a̠ k̚ t͡ɕʰ ɥ i	악취
악평	a̠ k̚ pʰ j ʌ̹ ŋ	악평
악한	a̠ kʰ a̠ n	아칸
안경	a̠ː n ɡ j ʌ̹ ŋ	안경
안과	a̠ː n k͈ w a̠	안꽈
안녕	a̠ n ɲ j ʌ̹ ŋ	안녕
안녕히	a̠ n ɲ j ʌ̹ ŋ ʝ i	안녕히
안다	a̠ː n t͈ a̠	안따
안도라	a̠ n d o̞ ɾ a̠	안도라
안되다	a̠ n d w e̞ d a̠	안되다
안드레아	a̠ n d ɯ ɾ e̞ a̠	안드레아
안드로이드	a̠ n d ɯ ɾ o̞ i d ɯ	안드로이드
안락사	a̠ ɭ ɭ a̠ k s͈ a̠	알락싸
안락의자	a̠ ɭ ɭ a̠ ɡ ɰ i d͡ʑ a̠	알라긔자
안마	a̠ː n m a̠	안마
안면승마	a̠ n m j ʌ̹ n sʰ ɯ ŋ m a̠	안면승마
안방	a̠ n b a̠ ŋ	안방
안부	a̠ n b u	안부
안심	a̠ n ɕʰ i m	안심
안심하다	a̠ n ɕʰ i m ɦ a̠ d a̠	안심하다
안전	a̠ ɲ d͡ʑ ʌ̹ n	안전
안전제일	a̠ ɲ d͡ʑ ʌ̹ ɲ d͡ʑ e̞ i ɭ	안전제일
안절부절	a̠ ɲ d͡ʑ ʌ̹ ɭ b u d͡ʑ ʌ̹ ɭ	안절부절
안절부절못하다	a̠ ɲ d͡ʑ ʌ̹ ɭ b u d͡ʑ ʌ̹ ɭ m o̞ tʰ a̠ d a̠	안절부절모타다
안주	a̠ ɲ d͡ʑ u	안주
안쪽	a̠ ɲ t͡ɕ͈ o̞ k̚	안쪽
안타	a̠ n tʰ a̠	안타
안타나나리보	a̠ n tʰ a̠ n a̠ n a̠ ɾ i b o̞	안타나나리보
안티	a̠ n tʰ i	안티
안후이	a̠ n β u i	안후이
안휘	a̠ n ɦ ɥ i	안휘
알거지	a̠ ɭ ɡ ʌ̹ d͡ʑ i	알거지
알고리즘	a̠ ɭ ɡ o̞ ɾ i d͡ʑ ɯ m	알고리즘
알곡	a̠ ɭ ɡ o̞ k̚	알곡
알까기	a̠ ɭ k͈ a̠ ɡ i	알까기
알다	a̠ː ɭ d a̠	알다
알데히드	a̠ ɭ d e̞ ʝ i d ɯ	알데히드
알라	a̠ ɭ ɭ a̠	알라
알레르기	a̠ ɭ ɭ e̞ ɾ ɯ ɡ i	알레르기
알렉산드리아	a̠ ɭ ɭ e̞ k s͈ a̠ n d ɯ ɾ i a̠	알렉싼드리아
알려지다	a̠ ʎ ʎ j ʌ̹ d͡ʑ i d a̠	알려지다
알력	a̠ ʎ ʎ j ʌ̹ k̚	알력
알루미늄	a̠ ɭ ɭ u m i ɲ j u m	알루미늄
알리고	a̠ ʎ ʎ i ɡ o̞	알리고
알리다	a̠ ʎ ʎ i d a̠	알리다
알맞다	a̠ ɭ m a̠ t̚ t͈ a̠	알맏따
알바니아	a̠ ɭ b a̠ n i a̠	알바니아
알바니아어	a̠ ɭ b a̠ n i a̠ ʌ̹	알바니아어
알아보다	a̠ ɾ a̠ b o̞ d a̠	아라보다
알약	a̠ ʎ ʎ j a̠ k̚	알략
알제	a̠ ʎ d͡ʑ e̞	알제
알제리	a̠ ʎ d͡ʑ e̞ ɾ i	알제리
알칸	a̠ ɭ kʰ a̠ n	알칸
알칼로이드	a̠ ɭ kʰ a̠ ɭ ɭ o̞ i d ɯ	알칼로이드
알칼리	a̠ ɭ kʰ a̠ ʎ ʎ i	알칼리
알켄	a̠ ɭ kʰ e̞ n	알켄
알콜	a̠ ɭ kʰ o̞ ɭ	알콜
알타이	a̠ ɭ tʰ a̠ i	알타이
알파	a̠ ɭ pʰ a̠	알파
알판	a̠ ɭ pʰ a̠ n	알판
알현	a̠ ɾ ʝ j ʌ̹ n	알현
앓다	a̠ ɭ tʰ a̠	알타
앓이	a̠ ɾ i	아리
암만	a̠ m m a̠ n	암만
암말	a̠ m m a̠ ɭ	암말
암벽	a̠ m b j ʌ̹ k̚	암벽
암살	a̠ m sʰ a̠ ɭ	암살
암스테르담	a̠ m sʰ ɯ tʰ e̞ ɾ ɯ d a̠ m	암스테르담
암시	a̠ː m ɕʰ i	암시
암실	a̠ː m ɕʰ i ɭ	암실
암자	a̠ m d͡ʑ a̠	암자
암초	a̠ː m t͡ɕʰ o̞	암초
암컷	a̠ m kʰ ʌ̹ t̚	암컫
암탉	a̠ m tʰ a̠ k̚	암탁
암향	a̠ː m ʝ j a̠ ŋ	암향
암호	a̠ː m β o̞	암호
암흑	a̠ː m ɣ ɯ k̚	암ɣㅡㄱ
압도	a̠ p̚ t͈ o̞	압또
압또부스	a̠ p̚ t͈ o̞ b u sʰ ɯ	압또부스
압력	a̠ m ɲ j ʌ̹ k̚	암녁
압박	a̠ p̚ p͈ a̠ k̚	압빡
앙골라	a̠ ŋ ɡ o̞ ɭ ɭ a̠	앙골라
앙상블	a̠ ŋ sʰ a̠ ŋ b ɯ ɭ	앙상블
앙숙	a̠ ŋ sʰ u k̚	앙숙
앙심	a̠ ŋ ɕʰ i m	앙심
앙이다	a̠ ŋ i d a̠	아이다
앙카라	a̠ ŋ kʰ a̠ ɾ a̠	앙카라
앙케트	a̠ ŋ kʰ e̞ tʰ ɯ	앙케트
앞다리	a̠ p̚ t͈ a̠ ɾ i	압따리
앞뒤	a̠ p̚ t͈ ɥ i	압뛰
앞면	a̠ m m j ʌ̹ n	암면
앞서	a̠ p s͈ ʌ̹	압써
앞서다	a̠ p s͈ ʌ̹ d a̠	압써다
앞에서	a̠ pʰ e̞ sʰ ʌ̹	아페서
앞으로	a̠ pʰ ɯ ɾ o̞	아프로
애교	ɛː ɡ j o	애교
애국심	ɛː ɡ u k ɕ͈ i m	애국씸
애국자	ɛː ɡ u k̚ t͡ɕ͈ a̠	애국짜
애국주의	ɛː ɡ u k̚ t͡ɕ͈ u ɰ i	애국쭈의
애쓰다	ɛː s͈ ɯ d a̠	애쓰다
애완동물	ɛː w a̠ n d o̞ ŋ m u ɭ	애완동물
애인	ɛː i n	애인
애정	ɛː d͡ʑ ʌ̹ ŋ	애정
애칭	ɛː t͡ɕʰ i ŋ	애칭
야경	j a̠ː ɡ j ʌ̹ ŋ	야경
야구장	j a̠ː ɡ u d͡ʑ a̠ ŋ	야구장
야당	j a̠ː d a̠ ŋ	야당
야마토	j a̠ m a̠ tʰ o̞	야마토
야무수크로	j a̠ m u sʰ u k x ɯ ɾ o̞	야무숙흐로
야민정음	j a̠ m i ɲ d͡ʑ ʌ̹ ŋ ɯ m	야민저음
야식	j a̠ː ɕʰ i k̚	야식
야자나무	j a̠ː d͡ʑ a̠ n a̠ m u	야자나무
야자수	j a̠ː d͡ʑ a̠ sʰ u	야자수
야쿠자	j a̠ kʰ u d͡ʑ a̠	야쿠자
야하다	j a̠ː ɦ a̠ d a̠	야하다
야한	j a̠ː ɦ a̠ n	야한
야훼	j a̠ β w e̞	야훼
약국	j a̠ k̚ k͈ u k̚	약꾹
약도	j a̠ k̚ t͈ o̞	약또
약력	j a̠ ŋ ɲ j ʌ̹ k̚	양녁
약사	j a̠ k s͈ a̠	약싸
약속	j a̠ k s͈ o̞ k̚	약쏙
약식	j a̠ k ɕ͈ i k̚	약씩
약실	j a̠ k ɕ͈ i ɭ	약씰
약자	j a̠ k̚ t͡ɕ͈ a̠	약짜
약점	j a̠ k̚ t͡ɕ͈ ʌ̹ m	약쩜
약주	j a̠ k̚ t͡ɕ͈ u	약쭈
약칭	j a̠ k̚ t͡ɕʰ i ŋ	약칭
약탈	j a̠ k̚ tʰ a̠ ɭ	약탈
약품	j a̠ k̚ pʰ u m	약품
약하다	j a̠ kʰ a̠ d a̠	야카다
약학	j a̠ kʰ a̠ k̚	야칵
약혼	j a̠ kʰ o̞ n	야콘
양곤	j a̠ ŋ ɡ o̞ n	양곤
양국	j a̠ ŋ ɡ u k̚	양국
양귀비	j a̠ ŋ ɡ ɥ i b i	양귀비
양귀자	j a̠ ŋ ɡ ɥ i d͡ʑ a̠	양귀자
양념	j a̠ ŋ ɲ j ʌ̹ m	양념
양다리	j a̠ ŋ d a̠ ɾ i	양다리
양동이	j a̠ ŋ d o̞ ŋ i	양도이
양력	j a̠ ŋ ɲ j ʌ̹ k̚	양녁
양말	j a̠ ŋ m a̠ ɭ	양말
양면	j a̠ ŋ m j ʌ̹ n	양면
양반	j a̠ ŋ b a̠ n	양반
양복	j a̠ ŋ b o̞ k̚	양복
양봉	j a̠ː ŋ b o̞ ŋ	양봉
양상	j a̠ ŋ sʰ a̠ ŋ	양상
양성자	j a̠ ŋ sʰ ʌ̹ ŋ d͡ʑ a̠	양성자
양수사	j a̠ ŋ sʰ u sʰ a̠	양수사
양식	j a̠ ŋ ɕʰ i k̚	양식
양심	j a̠ ŋ ɕʰ i m	양심
양유	j a̠ ŋ j u	야유
양조장	j a̠ː ŋ d͡ʑ o̞ d͡ʑ a̠ ŋ	양조장
양주	j a̠ ŋ d͡ʑ u	양주
양즈	j a̠ ŋ d͡ʑ ɯ	양즈
양쪽	j a̠ː ŋ t͡ɕ͈ o̞ k̚	양쪽
양초	j a̠ ŋ t͡ɕʰ o̞	양초
양파	j a̠ ŋ pʰ a̠	양파
양피지	j a̠ ŋ pʰ i d͡ʑ i	양피지
얕다	j a̠ t̚ t͈ a̠	얃따
얘기	j ɛː ɡ i	jㅐ기
어간	ɘː ɡ a̠ n	어간
어감	ɘː ɡ a̠ m	어감
어구	ɘː ɡ u	어구
어그러지다	ʌ̹ ɡ ɯ ɾ ʌ̹ d͡ʑ i d a̠	어그러지다
어근	ɘː ɡ ɯ n	어근
어금니	ʌ̹ ɡ ɯ m n i	어금니
어긋나다	ʌ̹ ɡ ɯ n n a̠ d a̠	어근나다
어느	ʌ̹ n ɯ	어느
어둡다	ʌ̹ d u p̚ t͈ a̠	어둡따
어드벤처	ʌ̹ d ɯ b e̞ ɲ t͡ɕʰ ʌ̹	어드벤처
어디	ʌ̹ d i	어디
어딘가	ʌ̹ d i n ɡ a̠	어딘가
어떡하다	ʌ̹ t͈ ʌ̹ kʰ a̠ d a̠	어떠카다
어떻게	ʌ̹ t͈ ʌ̹ kʰ e̞	어떠케
어떻다	ʌ̹ t͈ ʌ̹ tʰ a̠	어떠타
어란	ʌ̹ ɾ a̠ n	어란
어려움	ʌ̹ ɾ j ʌ̹ u m	어려움
어렴풋이	ʌ̹ ɾ j ʌ̹ m pʰ u ɕʰ i	어렴푸시
어렵다	ʌ̹ ɾ j ʌ̹ p̚ t͈ a̠	어렵따
어뢰	ʌ̹ ɾ w e̞	어뢰
어름치	ʌ̹ ɾ ɯ m t͡ɕʰ i	어름치
어리다	ʌ̹ ɾ i d a̠	어리다
어리석다	ʌ̹ ɾ i sʰ ʌ̹ k̚ t͈ a̠	어리석따
어린아이	ʌ̹ ɾ i n a̠ i	어리나이
어린이	ʌ̹ ɾ i n i	어리니
어린이집	ʌ̹ ɾ i n i d͡ʑ i p̚	어리니집
어머	ʌ̹ m ʌ̹	어머
어머나	ɘː m ʌ̹ n a̠	어머나
어머니	ʌ̹ m ʌ̹ n i	어머니
어머님	ʌ̹ m ʌ̹ n i m	어머님
어묵	ʌ̹ m u k̚	어묵
어버이	ʌ̹ b ʌ̹ i	어버이
어부	ʌ̹ b u	어부
어서	ʌ̹ sʰ ʌ̹	어서
어여머리	ʌ̹ j ʌ̹ m ʌ̹ ɾ i	어여머리
어요	ʌ̹ j o	어요
어울리다	ʌ̹ u ʎ ʎ i d a̠	어울리다
어원	ɘː w ʌ̹ n	어원
어이	ʌ̹ i	어이
어장관리	ʌ̹ d͡ʑ a̠ ŋ ɡ w a̠ ʎ ʎ i	어장괄리
어제	ʌ̹ d͡ʑ e̞	어제
어젯밤	ʌ̹ d͡ʑ e̞ t̚ p͈ a̠ m	어젣빰
어족	ɘː d͡ʑ o̞ k̚	어족
어줍잖다	ʌ̹ d͡ʑ u p̚ t͡ɕ͈ a̠ n tʰ a̠	어줍짠타
어즈버	ʌ̹ d͡ʑ ɯ b ʌ̹	어즈버
어지럽다	ʌ̹ d͡ʑ i ɾ ʌ̹ p̚ t͈ a̠	어지럽따
어쩌다	ʌ̹ t͡ɕ͈ ʌ̹ d a̠	어쩌다
어쩌면	ʌ̹ t͡ɕ͈ ʌ̹ m j ʌ̹ n	어쩌면
어쭙잖다	ʌ̹ t͡ɕ͈ u p̚ t͡ɕ͈ a̠ n tʰ a̠	어쭙짠타
어차피	ʌ̹ t͡ɕʰ a̠ pʰ i	어차피
어치	ʌ̹ t͡ɕʰ i	어치
어형	ʌ̹ ʝ j ʌ̹ ŋ	어형
어휘소	ʌ̹ ɦ ɥ i sʰ o̞	어휘소
어휘장	ɘː ɦ ɥ i d͡ʑ a̠ ŋ	어휘장
억류	ʌ̹ ŋ ɲ j u	엉뉴
억수	ʌ̹ k s͈ u	억쑤
억압	ʌ̹ ɡ a̠ p̚	어갑
억울하다	ʌ̹ ɡ u ɾ ɦ a̠ d a̠	어굴하다
억지	ʌ̹ k̚ t͡ɕ͈ i	억찌
언간	ʌ̹ n ɡ a̠ n	언간
언니	ʌ̹ n n i	언니
언덕	ʌ̹ n d ʌ̹ k̚	언덕
언론학	ʌ̹ ɭ ɭ o̞ n ɦ a̠ k̚	얼론학
언론학자	ʌ̹ ɭ ɭ o̞ n ɦ a̠ k̚ t͡ɕ͈ a̠	얼론학짜
언문	ɘː n m u n	언문
언어	ʌ̹ n ʌ̹	어너
언어학	ʌ̹ n ʌ̹ ɦ a̠ k̚	어너학
언제	ɘː ɲ d͡ʑ e̞	언제
언제나	ɘː ɲ d͡ʑ e̞ n a̠	언제나
언젠가	ɘː ɲ d͡ʑ e̞ n ɡ a̠	언젠가
얼룩말	ʌ̹ ɭ ɭ u ŋ m a̠ ɭ	얼룽말
얼른	ʌ̹ ɭ ɭ ɯ n	얼른
얼리다	ʌ̹ ʎ ʎ i d a̠	얼리다
얼마나	ʌ̹ ɭ m a̠ n a̠	얼마나
얼쑤	ʌ̹ ɭ s͈ u	얼쑤
얼어붙다	ʌ̹ ɾ ʌ̹ b u t̚ t͈ a̠	어러붇따
얼음과자	ʌ̹ ɾ ɯ m ɡ w a̠ d͡ʑ a̠	어름과자
얼짱	ʌ̹ ʎ t͡ɕ͈ a̠ ŋ	얼짱
얼핏	ʌ̹ ɭ pʰ i t̚	얼핃
엄격	ʌ̹ m k͈ j ʌ̹ k̚	엄껵
엄격하다	ʌ̹ m k͈ j ʌ̹ kʰ a̠ d a̠	엄껴카다
엄니	ɘː m n i	엄니
엄마	ʌ̹ m m a̠	엄마
엄습	ɘː m sʰ ɯ p̚	엄습
엄습하다	ɘː m sʰ ɯ pʰ a̠ d a̠	엄스파다
엄지	ʌ̹ m d͡ʑ i	엄지
엄지손가락	ʌ̹ m d͡ʑ i sʰ o̞ n ɡ a̠ ɾ a̠ k̚	엄지손가락
엄청	ʌ̹ m t͡ɕʰ ʌ̹ ŋ	엄청
엄청나다	ʌ̹ m t͡ɕʰ ʌ̹ ŋ n a̠ d a̠	엄청나다
업그레이드	ʌ̹ p̚ k͈ ɯ ɾ e̞ i d ɯ	업끄레이드
업다	ʌ̹ p̚ t͈ a̠	업따
업동이	ʌ̹ p̚ t͈ o̞ ŋ i	업또이
업소	ʌ̹ p s͈ o̞	업쏘
업종	ʌ̹ p̚ t͡ɕ͈ o̞ ŋ	업쫑
없어지다	ɘː p s͈ ʌ̹ d͡ʑ i d a̠	업써지다
없었다	ʌ̹ p s͈ ʌ̹ t̚ t͈ a̠	업썯따
없이	ɘː p ɕ͈ i	업씨
엇비슷하다	ʌ̹ t̚ p͈ i sʰ ɯ tʰ a̠ d a̠	얻삐스타다
엉겁결에	ʌ̹ ŋ ɡ ʌ̹ p̚ k͈ j ʌ̹ ɾ e̞	엉겁껴레
엉뚱하다	ʌ̹ ŋ t͈ u ŋ ɦ a̠ d a̠	엉뚱하다
엉망진창	ʌ̹ ŋ m a̠ ŋ d͡ʑ i ɲ t͡ɕʰ a̠ ŋ	엉망진창
엉엉	ʌ̹ ŋ ʌ̹ ŋ	어엉
엉큼하다	ʌ̹ ŋ k x ɯ m ɦ a̠ d a̠	엉ㄱ흠하다
엊그제	ʌ̹ t̚ k͈ ɯ d͡ʑ e̞	얻끄제
에게	e̞ ɡ e̞	에게
에너지	e̞ n ʌ̹ d͡ʑ i	에너지
에네르기	e̞ n e̞ ɾ ɯ ɡ i	에네르기
에는	e̞ n ɯ n	에는
에러	e̞ ɾ ʌ̹	에러
에리트레아	e̞ ɾ i tʰ ɯ ɾ e̞ a̠	에리트레아
에멜무지로	e̞ m e̞ ɭ m u d͡ʑ i ɾ o̞	에멜무지로
에뮤	e̞ m j u	에뮤
에미리트	e̞ m i ɾ i tʰ ɯ	에미리트
에스컬레이터	e̞ sʰ ɯ kʰ ʌ̹ ɭ ɭ e̞ i tʰ ʌ̹	에스컬레이터
에스터	e̞ sʰ ɯ tʰ ʌ̹	에스터
에스토니아	e̞ sʰ ɯ tʰ o̞ n i a̠	에스토니아
에스토니아어	e̞ sʰ ɯ tʰ o̞ n i a̠ ʌ̹	에스토니아어
에스파냐	e̞ sʰ ɯ pʰ a̠ ɲ j a̠	에스파냐
에어컨	e̞ ʌ̹ kʰ ʌ̹ n	에어컨
에어컨디셔너	e̞ ʌ̹ kʰ ʌ̹ n d i ɕʰ ʌ̹ n ʌ̹	에어컨디서너
에이즈	e̞ i d͡ʑ ɯ	에이즈
에잇	e̞ i t̚	에읻
에콰도르	e̞ kʰ w a̠ d o̞ ɾ ɯ	에콰도르
에탄	e̞ tʰ a̠ n	에탄
에터	e̞ tʰ ʌ̹	에터
에테르	e̞ tʰ e̞ ɾ ɯ	에테르
에티오피아	e̞ tʰ i o̞ pʰ i a̠	에티오피아
에티켓	e̞ tʰ i kʰ e̞ t̚	에티켇
에피소드	e̞ pʰ i sʰ o̞ d ɯ	에피소드
엔진	e̞ ɲ d͡ʑ i n	엔진
엘리베이터	e̞ ʎ ʎ i b e̞ i tʰ ʌ̹	엘리베이터
엘리트	e̞ ʎ ʎ i tʰ ɯ	엘리트
엘살바도르	e̞ ɭ sʰ a̠ ɭ b a̠ d o̞ ɾ ɯ	엘살바도르
엥가노쥐	e̞ ŋ ɡ a̠ n o̞ d͡ʑ ɥ i	엥가노쥐
여가	j ʌ̹ ɡ a̠	여가
여건	j ɘː k͈ ʌ̹ n	여껀
여겨지다	j ʌ̹ ɡ j ʌ̹ d͡ʑ i d a̠	여겨지다
여과	j ɘː ɡ w a̠	여과
여과기	j ɘː ɡ w a̠ ɡ i	여과기
여관	j ʌ̹ ɡ w a̠ n	여관
여권	j ʌ̹ k͈ w ʌ̹ n	여꿘
여기	j ʌ̹ ɡ i	여기
여기다	j ʌ̹ ɡ i d a̠	여기다
여기저기	j ʌ̹ ɡ i d͡ʑ ʌ̹ ɡ i	여기저기
여뀌	j ʌ̹ k͈ ɥ i	여뀌
여남은	j ʌ̹ n a̠ m ɯ n	여나믄
여당	j ɘː d a̠ ŋ	여당
여덟	j ʌ̹ d ʌ̹ ɭ	여덜
여돌	j ʌ̹ d o̞ ɭ	여돌
여드레	j ʌ̹ d ɯ ɾ e̞	여드레
여든	j ʌ̹ d ɯ n	여든
여러분	j ʌ̹ ɾ ʌ̹ b u n	여러분
여럿	j ʌ̹ ɾ ʌ̹ t̚	여럳
여론	j ɘː ɾ o̞ n	여론
여름	j ʌ̹ ɾ ɯ m	여름
여보	j ʌ̹ b o̞	여보
여보세요	j ʌ̹ b o̞ sʰ e̞ j o	여보세요
여섯	j ʌ̹ sʰ ʌ̹ t̚	여섣
여성	j ʌ̹ sʰ ʌ̹ ŋ	여성
여성주의	j ʌ̹ sʰ ʌ̹ ŋ d͡ʑ u ɰ i	여성주의
여신	j ʌ̹ ɕʰ i n	여신
여와	j ʌ̹ w a̠	여와
여왕	j ʌ̹ w a̠ ŋ	여왕
여우비	j ʌ̹ u b i	여우비
여인	j ʌ̹ i n	여인
여자	j ʌ̹ d͡ʑ a̠	여자
여자아이	j ʌ̹ d͡ʑ a̠ a̠ i	여자아이
여자친구	j ʌ̹ d͡ʑ a̠ t͡ɕʰ i n ɡ u	여자친구
여장	j ʌ̹ d͡ʑ a̠ ŋ	여장
여전하다	j ʌ̹ d͡ʑ ʌ̹ n ɦ a̠ d a̠	여전하다
여정	j ʌ̹ d͡ʑ ʌ̹ ŋ	여정
여제	j ʌ̹ d͡ʑ e̞	여제
여진	j ʌ̹ d͡ʑ i n	여진
여쭈다	j ɘː t͡ɕ͈ u d a̠	여쭈다
여체	j ʌ̹ t͡ɕʰ e̞	여체
여초	j ʌ̹ t͡ɕʰ o̞	여초
여하	j ʌ̹ ɦ a̠	여하
역겹다	j ʌ̹ k̚ k͈ j ʌ̹ p̚ t͈ a̠	역꼅따
역경	j ʌ̹ k̚ k͈ j ʌ̹ ŋ	역꼉
역사	j ʌ̹ k s͈ a̠	역싸
역사가	j ʌ̹ k s͈ a̠ ɡ a̠	역싸가
역시	j ʌ̹ k ɕ͈ i	역씨
역학	j ʌ̹ kʰ a̠ k̚	여칵
연가	j ɘː n ɡ a̠	연가
연간	j ʌ̹ n ɡ a̠ n	연간
연감	j ʌ̹ n ɡ a̠ m	연감
연결	j ʌ̹ n ɡ j ʌ̹ ɭ	연결
연결되다	j ʌ̹ n ɡ j ʌ̹ ɭ d w e̞ d a̠	연결되다
연결하다	j ʌ̹ n ɡ j ʌ̹ ɾ ɦ a̠ d a̠	연결하다
연고	j ɘː n ɡ o̞	연고
연구	j ɘː n ɡ u	연구
연구되다	j ʌ̹ n ɡ u d w e̞ d a̠	연구되다
연구소	j ʌ̹ n ɡ u sʰ o̞	연구소
연구실	j ʌ̹ n ɡ u ɕʰ i ɭ	연구실
연구자	j ɘː n ɡ u d͡ʑ a̠	연구자
연극	j ɘː n ɡ ɯ k̚	연극
연근	j ʌ̹ n ɡ ɯ n	연근
연금	j ʌ̹ n ɡ ɯ m	연금
연기자	j ɘː n ɡ i d͡ʑ a̠	연기자
연꽃	j ʌ̹ n k͈ o̞ t̚	연꼳
연락처	j ʌ̹ ɭ ɭ a̠ k̚ t͡ɕʰ ʌ̹	열락처
연령	j ʌ̹ ʎ ʎ j ʌ̹ ŋ	열령
연말	j ʌ̹ n m a̠ ɭ	연말
연못	j ʌ̹ n m o̞ t̚	연몯
연방	j ʌ̹ n b a̠ ŋ	연방
연설	j ɘː n sʰ ʌ̹ ɭ	연설
연설자	j ɘː n sʰ ʌ̹ ʎ t͡ɕ͈ a̠	연설짜
연세	j ʌ̹ n sʰ e̞	연세
연속	j ʌ̹ n sʰ o̞ k̚	연속
연속극	j ʌ̹ n sʰ o̞ k̚ k͈ ɯ k̚	연속끅
연습	j ɘː n sʰ ɯ p̚	연습
연습하다	j ɘː n sʰ ɯ pʰ a̠ d a̠	연스파다
연안	j ʌ̹ n a̠ n	여난
연어	j ʌ̹ n ʌ̹	여너
연옥	j ɘː n o̞ k̚	여녹
연월일	j ʌ̹ n w ʌ̹ ɾ i ɭ	여눠릴
연장	j ʌ̹ ɲ d͡ʑ a̠ ŋ	연장
연적	j ɘː ɲ d͡ʑ ʌ̹ k̚	연적
연주	j ɘː ɲ d͡ʑ u	연주
연주하다	j ɘː ɲ d͡ʑ u ɦ a̠ d a̠	연주하다
연초	j ʌ̹ ɲ t͡ɕʰ o̞	연초
연필	j ʌ̹ n pʰ i ɭ	연필
연필깎이	j ʌ̹ n pʰ i ɭ k͈ a̠ k͈ i	연필까끼
연하다	j ɘː n ɦ a̠ d a̠	연하다
연합	j ʌ̹ n ɦ a̠ p̚	연합
연혁	j ɘː n ʝ j ʌ̹ k̚	연혁
연휴	j ʌ̹ n ʝ j u	연휴
엳아홉	j ʌ̹ d a̠ β o̞ p̚	여다홉
열다	j ɘː ɭ d a̠	열다
열다섯	j ʌ̹ ɭ t͈ a̠ sʰ ʌ̹ t̚	열따섣
열도	j ʌ̹ ɭ t͈ o̞	열또
열동갈문절	j ʌ̹ ɭ t͈ o̞ ŋ ɡ a̠ ɭ m u ɲ d͡ʑ ʌ̹ ɭ	열똥갈문절
열둘	j ʌ̹ ɭ t͈ u ɭ	열뚤
열등	j ʌ̹ ɭ d ɯ ŋ	열등
열등감	j ʌ̹ ɭ t͈ ɯ ŋ ɡ a̠ m	열뜽감
열량	j ʌ̹ ʎ ʎ j a̠ ŋ	열량
열리다	j ʌ̹ ʎ ʎ i d a̠	열리다
열반	j ʌ̹ ɭ b a̠ n	열반
열방	j ʌ̹ ɭ b a̠ ŋ	열방
열셋	j ʌ̹ ɭ s͈ e̞ t̚	열쎋
열쇠	j ɘː ɭ s͈ w e̞	열쐬
열심히	j ʌ̹ ɭ ɕ͈ i m ʝ i	열씸히
열아홉	j ʌ̹ ɾ a̠ β o̞ p̚	여라홉
열여덟	j ʌ̹ ʎ ʎ j ʌ̹ d ʌ̹ ɭ	열려덜
열여섯	j ʌ̹ ʎ ʎ j ʌ̹ sʰ ʌ̹ t̚	열려섣
열역학	j ʌ̹ ʎ ʎ j ʌ̹ kʰ a̠ k̚	열려칵
열일곱	j ʌ̹ ʎ ʎ i ɭ ɡ o̞ p̚	열릴곱
열정	j ʌ̹ ʎ d͡ʑ ʌ̹ ŋ	열정
열차	j ʌ̹ ʎ t͡ɕʰ a̠	열차
열화학	j ʌ̹ ɾ β w a̠ ɦ a̠ k̚	열화학
열흘	j ʌ̹ ɾ ɣ ɯ ɭ	열ɣㅡㄹ
염기	j ʌ̹ m ɡ i	염기
염료	j ɘː m ɲ j o	염뇨
염복	j ɘː m b o̞ k̚	염복
염세주의	j ɘː m sʰ e̞ d͡ʑ u ɰ i	염세주의
염소	j ʌ̹ m sʰ o̞	염소
염장	j ʌ̹ m d͡ʑ a̠ ŋ	염장
염주	j ɘː m d͡ʑ u	염주
염증	j ʌ̹ m t͡ɕ͈ ɯ ŋ	염쯩
염통	j ʌ̹ m tʰ o̞ ŋ	염통
엿기름	j ʌ̹ t̚ k͈ i ɾ ɯ m	엳끼름
엿보다	j ɘː t̚ p͈ o̞ d a̠	엳뽀다
영광	j ʌ̹ ŋ ɡ w a̠ ŋ	영광
영광스럽다	j ʌ̹ ŋ ɡ w a̠ ŋ sʰ ɯ ɾ ʌ̹ p̚ t͈ a̠	영광스럽따
영구	j ɘː ŋ ɡ u	영구
영국	j ʌ̹ ŋ ɡ u k̚	영국
영국인	j ʌ̹ ŋ ɡ u ɡ i n	영구긴
영도자	j ʌ̹ ŋ d o̞ d͡ʑ a̠	영도자
영리하다	j ɘː ŋ n i ɦ a̠ d a̠	영니하다
영묘	j ʌ̹ ŋ m j o	영묘
영문	j ʌ̹ ŋ m u n	영문
영미권	j ʌ̹ ŋ m i k͈ w ʌ̹ n	영미꿘
영본	j ʌ̹ ŋ b o̞ n	영본
영사	j ʌ̹ ŋ sʰ a̠	영사
영사관	j ʌ̹ ŋ sʰ a̠ ɡ w a̠ n	영사관
영성	j ʌ̹ ŋ sʰ ʌ̹ ŋ	영성
영성체	j ɘː ŋ sʰ ʌ̹ ŋ t͡ɕʰ e̞	영성체
영수증	j ʌ̹ ŋ sʰ u d͡ʑ ɯ ŋ	영수증
영양	j ʌ̹ ŋ j a̠ ŋ	여양
영양실조	j ʌ̹ ŋ j a̠ ŋ ɕʰ i ʎ d͡ʑ o̞	여양실조
영양제	j ʌ̹ ŋ j a̠ ŋ d͡ʑ e̞	여양제
영어	j ʌ̹ ŋ ʌ̹	여어
영업	j ʌ̹ ŋ ʌ̹ p̚	여업
영역	j ʌ̹ ŋ j ʌ̹ k̚	여역
영예	j ʌ̹ ŋ j e̞	여예
영웅	j ʌ̹ ŋ u ŋ	여웅
영원히	j ɘː ŋ w ʌ̹ n ʝ i	여원히
영적	j ʌ̹ ŋ t͡ɕ͈ ʌ̹ k̚	영쩍
영지	j ʌ̹ ŋ d͡ʑ i	영지
영춘권	j ɘː ŋ t͡ɕʰ u n ɡ w ʌ̹ n	영춘권
영토	j ʌ̹ ŋ tʰ o̞	영토
영하	j ʌ̹ ŋ ɦ a̠	영하
영향	j ɘː ŋ ʝ j a̠ ŋ	영향
영향력	j ɘː ŋ ʝ j a̠ ŋ ɲ j ʌ̹ k̚	영향녁
영혼	j ʌ̹ ŋ β o̞ n	영혼
영화관	j ʌ̹ ŋ β w a̠ ɡ w a̠ n	영화관
옅다	j ʌ̹ t̚ t͈ a̠	엳따
옆얼굴	j ʌ̹ b ʌ̹ ɭ ɡ u ɭ	여벌굴
옆집	j ʌ̹ p̚ t͡ɕ͈ i p̚	엽찝
예감	j e̞ː ɡ a̠ m	예감
예능	j e̞ː n ɯ ŋ	예능
예니레	j e̞ n i ɾ e̞	예니레
예닐곱	j e̞ n i ɭ ɡ o̞ p̚	예닐곱
예다	j e̞ː d a̠	예다
예레반	j e̞ ɾ e̞ b a̠ n	예레반
예멘	j e̞ m e̞ n	예멘
예명	j e̞ m j ʌ̹ ŋ	예명
예문	j e̞ː m u n	예문
예물	j e̞ m u ɭ	예물
예방	j e̞ː b a̠ ŋ	예방
예산	j e̞ː sʰ a̠ n	예산
예수	j e̞ sʰ u	예수
예수회	j e̞ sʰ u β w e̞	예수회
예순	j e̞ sʰ u n	예순
예술가	j e̞ː sʰ u ɭ ɡ a̠	예술가
예식	j e̞ ɕʰ i k̚	예식
예약하다	j e̞ː j a̠ kʰ a̠ d a̠	예야카다
예언	j e̞ː ʌ̹ n	예언
예언자	j e̞ː ʌ̹ ɲ d͡ʑ a̠	예언자
예외	j e̞ː w e̞	예외
예의	j e̞ ɰ i	예의
예일	j e̞ i ɭ	예일
예절	j e̞ d͡ʑ ʌ̹ ɭ	예절
예정	j e̞ː d͡ʑ ʌ̹ ŋ	예정
예카테린부르크	j e̞ kʰ a̠ tʰ e̞ ɾ i n b u ɾ ɯ k x ɯ	예카테린부륵흐
예후	j e̞ː β u	예후
옛날	j e̞ː n n a̠ ɭ	옌날
옛말	j e̞ː n m a̠ ɭ	옌말
옛적	j e̞ː t̚ t͡ɕ͈ ʌ̹ k̚	옏쩍
오글오글	o̞ ɡ ɯ ɾ o̞ ɡ ɯ ɭ	오그로글
오금	o̞ ɡ ɯ m	오금
오누이	o̞ n u i	오누이
오늘	o̞ n ɯ ɭ	오늘
오다	o̞ d a̠	오다
오답	o̞ː d a̠ p̚	오답
오데사	o̞ d e̞ sʰ a̠	오데사
오드콜로뉴	o̞ d ɯ kʰ o̞ ɭ ɭ o̞ ɲ j u	오드콜로뉴
오디	o̞ d i	오디
오라버님	o̞ ɾ a̠ b ʌ̹ n i m	오라버님
오락	o̞ː ɾ a̠ k̚	오락
오락실	o̞ː ɾ a̠ k ɕ͈ i ɭ	오락씰
오랑우탄	o̞ ɾ a̠ ŋ u tʰ a̠ n	오라우탄
오렌지	o̞ ɾ e̞ ɲ d͡ʑ i	오렌지
오로지	o̞ː ɾ o̞ d͡ʑ i	오로지
오롯하다	o̞ ɾ o̞ tʰ a̠ d a̠	오로타다
오류	o̞ː ɾ j u	오류
오르가슴	o̞ ɾ ɯ ɡ a̠ sʰ ɯ m	오르가슴
오르다	o̞ ɾ ɯ d a̠	오르다
오르되브르	o̞ ɾ ɯ d w e̞ b ɯ ɾ ɯ	오르되브르
오른	o̞ ɾ ɯ n	오른
오른손잡이	o̞ ɾ ɯ n sʰ o̞ ɲ d͡ʑ a̠ b i	오른손자비
오리나무	o̞ ɾ i n a̠ m u	오리나무
오리무중	o̞ː ɾ i m u d͡ʑ u ŋ	오리무중
오물	o̞ː m u ɭ	오물
오물오물	o̞ m u ɾ o̞ m u ɭ	오무로물
오므라이스	o̞ m ɯ ɾ a̠ i sʰ ɯ	오므라이스
오믈렛	o̞ m ɯ ɭ ɭ e̞ t̚	오믈렏
오버클럭	o̞ b ʌ̹ k x ɯ ɭ ɭ ʌ̹ k̚	오벅흘럭
오븐	o̞ b ɯ n	오븐
오빠	o̞ p͈ a̠	오빠
오사존	o̞ sʰ a̠ d͡ʑ o̞ n	오사존
오사카	o̞ sʰ a̠ kʰ a̠	오사카
오소리	o̞ sʰ o̞ ɾ i	오소리
오십	o̞ː ɕʰ i p̚	오십
오아시스	o̞ a̠ ɕʰ i sʰ ɯ	오아시스
오염	o̞ː j ʌ̹ m	오염
오염되다	o̞ː j ʌ̹ m d w e̞ d a̠	오염되다
오온	o̞ː o̞ n	오온
오옴	o̞ o̞ m	오옴
오월	o̞ː w ʌ̹ ɭ	오월
오이	o̞ i	오이
오적어	o̞ d͡ʑ ʌ̹ ɡ ʌ̹	오저거
오전	o̞ː d͡ʑ ʌ̹ n	오전
오존	o̞ d͡ʑ o̞ n	오존
오줌	o̞ d͡ʑ u m	오줌
오직	o̞ d͡ʑ i k̚	오직
오징어	o̞ d͡ʑ i ŋ ʌ̹	오지어
오촌	o̞ː t͡ɕʰ o̞ n	오촌
오케스트라	o̞ kʰ e̞ sʰ ɯ tʰ ɯ ɾ a̠	오케스트라
오타	o̞ː tʰ a̠	오타
오타와	o̞ tʰ a̠ w a̠	오타와
오타쿠	o̞ tʰ a̠ kʰ u	오타쿠
오토바이	o̞ tʰ o̞ b a̠ i	오토바이
오트밀	o̞ tʰ ɯ m i ɭ	오트밀
오페라	o̞ pʰ e̞ ɾ a̠	오페라
오페레타	o̞ pʰ e̞ ɾ e̞ tʰ a̠	오페레타
오후	o̞ː β u	오후
오히려	o̞ ʝ i ɾ j ʌ̹	오히려
옥상	o̞ k s͈ a̠ ŋ	옥쌍
옥석	o̞ k s͈ ʌ̹ k̚	옥썩
옥수수	o̞ k s͈ u sʰ u	옥쑤수
옥시토신	o̞ k ɕ͈ i tʰ o̞ ɕʰ i n	옥씨토신
옥중	o̞ k̚ t͡ɕ͈ u ŋ	옥쭝
옥탑	o̞ k̚ tʰ a̠ p̚	옥탑
옥테인	o̞ k̚ tʰ e̞ i n	옥테인
온갖	o̞ː n ɡ a̠ t̚	온갇
온돌	o̞ n d o̞ ɭ	온돌
온라인	o̞ n n a̠ i n	온나인
온몸	o̞ː n m o̞ m	온몸
온수	o̞ n sʰ u	온수
온실	o̞ n ɕʰ i ɭ	온실
온종일	o̞ː ɲ d͡ʑ o̞ ŋ i ɭ	온조일
온천	o̞ ɲ t͡ɕʰ ʌ̹ n	온천
온통	o̞ː n tʰ o̞ ŋ	온통
올겨울	o̞ ɭ k͈ j ʌ̹ u ɭ	올껴울
올라가다	o̞ ɭ ɭ a̠ ɡ a̠ d a̠	올라가다
올려놓다	o̞ ʎ ʎ j ʌ̹ n o̞ tʰ a̠	올려노타
올리고	o̞ ʎ ʎ i ɡ o̞	올리고
올리다	o̞ ʎ ʎ i d a̠	올리다
올리브	o̞ ʎ ʎ i b ɯ	올리브
올림말	o̞ ʎ ʎ i m m a̠ ɭ	올림말
올림픽	o̞ ʎ ʎ i m pʰ i k̚	올림픽
올바르다	o̞ ɭ b a̠ ɾ ɯ d a̠	올바르다
올여름	o̞ ʎ ʎ j ʌ̹ ɾ ɯ m	올려름
올통볼통	o̞ ɭ tʰ o̞ ŋ b o̞ ɭ tʰ o̞ ŋ	올통볼통
옳다	o̞ ɭ tʰ a̠	올타
옳아	o̞ ɾ a̠	오라
옴스크	o̞ m sʰ ɯ k x ɯ	옴슥흐
옷감	o̞ t̚ k͈ a̠ m	옫깜
옷걸이	o̞ t̚ k͈ ʌ̹ ɾ i	옫꺼리
옷고름	o̞ t̚ k͈ o̞ ɾ ɯ m	옫꼬름
옷장	o̞ t̚ t͡ɕ͈ a̠ ŋ	옫짱
와그르르	w a̠ ɡ ɯ ɾ ɯ ɾ ɯ	와그르르
와글와글	w a̠ ɡ ɯ ɾ w a̠ ɡ ɯ ɭ	와그롸글
와사비	w a̠ sʰ a̠ b i	와사비
와이셔츠	w a̠ i ɕʰ ʌ̹ t͡ɕʰ ɯ	와이서츠
와이파이	w a̠ i pʰ a̠ i	와이파이
와이프	w a̠ i pʰ ɯ	와이프
와인	w a̠ i n	와인
와타시	w a̠ tʰ a̠ ɕʰ i	와타시
완곡하다	w a̠ː n ɡ o̞ kʰ a̠ d a̠	완고카다
완두	w a̠ n d u	완두
완벽	w a̠ n b j ʌ̹ k̚	완벽
완비	w a̠ n b i	완비
완성	w a̠ n sʰ ʌ̹ ŋ	완성
완성하다	w a̠ n sʰ ʌ̹ ŋ ɦ a̠ d a̠	완성하다
완전	w a̠ ɲ d͡ʑ ʌ̹ n	완전
완전히	w a̠ ɲ d͡ʑ ʌ̹ n ʝ i	완전히
왈가왈부	w a̠ ɭ ɡ a̠ w a̠ ɭ b u	왈가왈부
왈츠	w a̠ ʎ t͡ɕʰ ɯ	왈츠
왕가	w a̠ ŋ ɡ a̠	왕가
왕관	w a̠ ŋ ɡ w a̠ n	왕관
왕국	w a̠ ŋ ɡ u k̚	왕국
왕복	w a̠ː ŋ b o̞ k̚	왕복
왕성	w a̠ː ŋ sʰ ʌ̹ ŋ	왕성
왕실	w a̠ ŋ ɕʰ i ɭ	왕실
왕자	w a̠ ŋ d͡ʑ a̠	왕자
왕조	w a̠ ŋ d͡ʑ o̞	왕조
왕후	w a̠ ŋ β u	왕후
왜서	w ɛː sʰ ʌ̹	왜서
외계어	w e̞ː ɡ j e̞ ʌ̹	외계어
외과	w e̞ː k͈ w a̠	외꽈
외교	w e̞ː ɡ j o	외교
외교관	w e̞ː ɡ j o ɡ w a̠ n	외교관
외국	w e̞ː ɡ u k̚	외국
외국어	w e̞ː ɡ u ɡ ʌ̹	외구거
외국인	w e̞ː ɡ u ɡ i n	외구긴
외딸	w e̞ t͈ a̠ ɭ	외딸
외롭다	w e̞ ɾ o̞ p̚ t͈ a̠	외롭따
외면	w e̞ː m j ʌ̹ n	외면
외모	w e̞ː m o̞	외모
외복사근	w e̞ b o̞ k s͈ a̠ ɡ ɯ n	외복싸근
외부	w e̞ː b u	외부
외삼촌	w e̞ː sʰ a̠ m t͡ɕʰ o̞ n	외삼촌
외설	w e̞ː sʰ ʌ̹ ɭ	외설
외손녀	w e̞ː sʰ o̞ n ɲ j ʌ̹	외손녀
외손자	w e̞ː sʰ o̞ ɲ d͡ʑ a̠	외손자
외식	w e̞ː ɕʰ i k̚	외식
외아들	w e̞ a̠ d ɯ ɭ	외아들
외야수	w e̞ː j a̠ sʰ u	외야수
외인	w e̞ː i n	외인
외지	w e̞ d͡ʑ i	외지
외치다	w e̞ t͡ɕʰ i d a̠	외치다
외투	w e̞ː tʰ u	외투
외할머니	w e̞ ɦ a̠ ɭ m ʌ̹ n i	외할머니
외할아버지	w e̞ ɦ a̠ ɾ a̠ b ʌ̹ d͡ʑ i	외하라버지
외환	w e̞ː β w a̠ n	외환
왼손잡이	w e̞ː n sʰ o̞ ɲ d͡ʑ a̠ b i	왼손자비
왼쪽	w e̞ː ɲ t͡ɕ͈ o̞ k̚	왼쪽
요격	j o ɡ j ʌ̹ k̚	요격
요괴	j o ɡ w e̞	요괴
요구	j o ɡ u	요구
요구되다	j o ɡ u d w e̞ d a̠	요구되다
요구하다	j o ɡ u ɦ a̠ d a̠	요구하다
요녕	j o ɲ j ʌ̹ ŋ	요녕
요도	j o d o̞	요도
요람	j o ɾ a̠ m	요람
요령	j o ɾ j ʌ̹ ŋ	요령
요르단	j o ɾ ɯ d a̠ n	요르단
요리	j o ɾ i	요리
요리하다	j o ɾ i ɦ a̠ d a̠	요리하다
요법	j o p͈ ʌ̹ p̚	요뻡
요사이	j o sʰ a̠ i	요사이
요소	j o sʰ o̞	요소
요술	j o sʰ u ɭ	요술
요약하다	j o j a̠ kʰ a̠ d a̠	요야카다
요오드	j o o̞ d ɯ	요오드
요일	j o i ɭ	요일
요절	j oː d͡ʑ ʌ̹ ɭ	요절
요즈음	j o d͡ʑ ɯ ɯ m	요즈음
요즘	j o d͡ʑ ɯ m	요즘
요지	j o d͡ʑ i	요지
요청	j o t͡ɕʰ ʌ̹ ŋ	요청
요크셔	j o k x ɯ ɕʰ ʌ̹	욕흐서
요하다	j o ɦ a̠ d a̠	요하다
요한	j o ɦ a̠ n	요한
욕실	j o k ɕ͈ i ɭ	욕씰
욕조	j o k̚ t͡ɕ͈ o̞	욕쪼
용감하다	j oː ŋ ɡ a̠ m ɦ a̠ d a̠	용감하다
용과	j o ŋ ɡ w a̠	용과
용도	j oː ŋ d o̞	용도
용돈	j oː ŋ t͈ o̞ n	용똔
용모	j o ŋ m o̞	용모
용병	j o ŋ b j ʌ̹ ŋ	용병
용비어천가	j o ŋ b i ʌ̹ t͡ɕʰ ʌ̹ n ɡ a̠	용비어천가
용서하다	j o ŋ sʰ ʌ̹ ɦ a̠ d a̠	용서하다
용언	j oː ŋ ʌ̹ n	요언
용역	j oː ŋ j ʌ̹ k̚	요역
용의자	j o ŋ ɰ i d͡ʑ a̠	요의자
용이	j o ŋ i	요이
용이하다	j o ŋ i ɦ a̠ d a̠	요이하다
용접	j o ŋ d͡ʑ ʌ̹ p̚	용접
용지	j oː ŋ d͡ʑ i	용지
용케	j oː ŋ kʰ e̞	용케
우간다	u ɡ a̠ n d a̠	우간다
우그르르	u ɡ ɯ ɾ ɯ ɾ ɯ	우그르르
우동	u d o̞ ŋ	우동
우두커니	u d u kʰ ʌ̹ n i	우두커니
우렁각시	u ɾ ʌ̹ ŋ ɡ a̠ k ɕ͈ i	우렁각씨
우렁이	u ɾ ʌ̹ ŋ i	우러이
우롱차	u ɾ o̞ ŋ t͡ɕʰ a̠	우롱차
우루과이	u ɾ u ɡ w a̠ i	우루과이
우리나라	u ɾ i n a̠ ɾ a̠	우리나라
우리들	u ɾ i d ɯ ɭ	우리들
우리말	u ɾ i m a̠ ɭ	우리말
우리집	u ɾ i d͡ʑ i p̚	우리집
우마	u m a̠	우마
우먼	u m ʌ̹ n	우먼
우물	u m u ɭ	우물
우물우물	u m u ɾ u m u ɭ	우무루물
우산	uː sʰ a̠ n	우산
우상	uː sʰ a̠ ŋ	우상
우선	u sʰ ʌ̹ n	우선
우세	u sʰ e̞	우세
우수리	u sʰ u ɾ i	우수리
우습다	uː sʰ ɯ p̚ t͈ a̠	우습따
우승	u sʰ ɯ ŋ	우승
우아	u a̠	우아
우아하다	u a̠ ɦ a̠ d a̠	우아하다
우엉	u ʌ̹ ŋ	우엉
우연	u j ʌ̹ n	우연
우연히	u j ʌ̹ n ʝ i	우연히
우울증	u u ʎ t͡ɕ͈ ɯ ŋ	우울쯩
우울하다	u u ɾ ɦ a̠ d a̠	우울하다
우웩	u w e̞ k̚	우웩
우유	u j u	우유
우익수	uː i k s͈ u	우익쑤
우주선	uː d͡ʑ u sʰ ʌ̹ n	우주선
우체국	u t͡ɕʰ e̞ ɡ u k̚	우체국
우체부	uː t͡ɕʰ e̞ b u	우체부
우크라이나어	u k x ɯ ɾ a̠ i n a̠ ʌ̹	욱흐라이나어
우편	u pʰ j ʌ̹ n	우편
우편번호	u pʰ j ʌ̹ n b ʌ̹ n β o̞	우편번호
우편함	u pʰ j ʌ̹ n ɦ a̠ m	우편함
우표	u pʰ j o	우표
우한	u ɦ a̠ n	우한
우화	uː β w a̠	우화
운동	uː n d o̞ ŋ	운동
운동공원	u n d o̞ ŋ ɡ o̞ ŋ w ʌ̹ n	운동고원
운동복	uː n d o̞ ŋ b o̞ k̚	운동복
운동장	uː n d o̞ ŋ d͡ʑ a̠ ŋ	운동장
운동하다	uː n d o̞ ŋ ɦ a̠ d a̠	운동하다
운동화	uː n d o̞ ŋ β w a̠	운동화
운명	uː n m j ʌ̹ ŋ	운명
운명론	uː n m j ʌ̹ ŋ n o̞ n	운명논
운수	u n sʰ u	운수
운전	u ɲ d͡ʑ ʌ̹ n	운전
운전기사	uː ɲ d͡ʑ ʌ̹ n ɡ i sʰ a̠	운전기사
운전사	uː ɲ d͡ʑ ʌ̹ n sʰ a̠	운전사
운전자	uː ɲ d͡ʑ ʌ̹ ɲ d͡ʑ a̠	운전자
운하	uː n ɦ a̠	운하
울다	uː ɭ d a̠	울다
울란바토르	u ɭ ɭ a̠ n b a̠ tʰ o̞ ɾ ɯ	울란바토르
울리다	u ʎ ʎ i d a̠	울리다
울리짜	u ʎ ʎ i t͡ɕ͈ a̠	울리짜
울버린	u ɭ b ʌ̹ ɾ i n	울버린
울산	u ɭ s͈ a̠ n	울싼
울음	u ɾ ɯ m	우름
울음소리	u ɾ ɯ m s͈ o̞ ɾ i	우름쏘리
움직이다	u m d͡ʑ i ɡ i d a̠	움지기다
움직임	u m d͡ʑ i ɡ i m	움지김
움짤	u m t͡ɕ͈ a̠ ɭ	움짤
웃기다	u t̚ k͈ i d a̠	욷끼다
웃다	uː t̚ t͈ a̠	욷따
웃음	u sʰ ɯ m	우슴
웅덩이	u ŋ d ʌ̹ ŋ i	웅더이
웅데	u ŋ d e̞	웅데
웅어	u ŋ ʌ̹	우어
워그르르	w ʌ̹ ɡ ɯ ɾ ɯ ɾ ɯ	워그르르
워낙	w ʌ̹ n a̠ k̚	워낙
워석버석	w ʌ̹ sʰ ʌ̹ k̚ p͈ ʌ̹ sʰ ʌ̹ k̚	워석뻐석
워싱턴	w ʌ̹ ɕʰ i ŋ tʰ ʌ̹ n	워싱턴
원고	w ʌ̹ n ɡ o̞	원고
원기둥	w ʌ̹ n ɡ i d u ŋ	원기둥
원료	w ʌ̹ ʎ ʎ j o	월료
원룸	w ʌ̹ n n u m	원눔
원리	w ʌ̹ ʎ ʎ i	월리
원망	w ʌ̹ n m a̠ ŋ	원망
원망하다	w ɘː n m a̠ ŋ ɦ a̠ d a̠	wㅓㄴ망하다
원반	w ʌ̹ n b a̠ n	원반
원본	w ʌ̹ n b o̞ n	원본
원산	w ʌ̹ n sʰ a̠ n	원산
원석	w ʌ̹ n sʰ ʌ̹ k̚	원석
원시	w ɘː n ɕʰ i	wㅓㄴ시
원앙	w ʌ̹ n a̠ ŋ	워낭
원인	w ʌ̹ n i n	워닌
원자	w ʌ̹ ɲ d͡ʑ a̠	원자
원자력발전소	w ʌ̹ ɲ d͡ʑ a̠ ɾ j ʌ̹ k̚ p͈ a̠ ʎ d͡ʑ ʌ̹ n sʰ o̞	원자력빨전소
원장	w ʌ̹ ɲ d͡ʑ a̠ ŋ	원장
원조	w ɘː ɲ d͡ʑ o̞	wㅓㄴ조
원조교제	w ʌ̹ ɲ d͡ʑ o̞ ɡ j o d͡ʑ e̞	원조교제
원족	w ʌ̹ ɲ d͡ʑ o̞ k̚	원족
원천	w ʌ̹ ɲ t͡ɕʰ ʌ̹ n	원천
원칙	w ʌ̹ ɲ t͡ɕʰ i k̚	원칙
원통	w ʌ̹ n tʰ o̞ ŋ	원통
원폭	w ʌ̹ n pʰ o̞ k̚	원폭
원피스	w ʌ̹ n pʰ i sʰ ɯ	원피스
월경	w ʌ̹ ɭ ɡ j ʌ̹ ŋ	월경
월남	w ʌ̹ ɭ ɭ a̠ m	월람
월세	w ʌ̹ ɭ s͈ e̞	월쎄
월식	w ʌ̹ ɭ ɕ͈ i k̚	월씩
월요일	w ʌ̹ ɾ j o i ɭ	워료일
웨브페지	w e̞ b ɯ pʰ e̞ d͡ʑ i	웨브페지
웨이터	w e̞ i tʰ ʌ̹	웨이터
웬일	w e̞ː n n i ɭ	웬닐
웹사이트	w e̞ p s͈ a̠ i tʰ ɯ	웹싸이트
위구르어	ɥ i ɡ u ɾ ɯ ʌ̹	위구르어
위굴말	ɥ i ɡ u ɭ m a̠ ɭ	위굴말
위글말	ɥ i ɡ ɯ ɭ m a̠ ɭ	위글말
위기	ɥ i ɡ i	위기
위력	ɥ i ɾ j ʌ̹ k̚	위력
위반	ɥ i b a̠ n	위반
위선자	ɥ i sʰ ʌ̹ ɲ d͡ʑ a̠	위선자
위안부	ɥ i a̠ n b u	위안부
위업	ɥ i ʌ̹ p̚	위업
위원장	ɥ i w ʌ̹ ɲ d͡ʑ a̠ ŋ	위원장
위원회	ɥ i w ʌ̹ n β w e̞	위원회
위조	ɥ iː d͡ʑ o̞	위조
위주	ɥ i d͡ʑ u	위주
위증	ɥ i d͡ʑ ɯ ŋ	위증
위치	ɥ i t͡ɕʰ i	위치
위탁	ɥ i tʰ a̠ k̚	위탁
위험	ɥ i ɦ ʌ̹ m	위험
위협	ɥ i ʝ j ʌ̹ p̚	위협
위화감	ɥ i β w a̠ ɡ a̠ m	위화감
위훈	ɥ i β u n	위훈
윅셔너리	ɥ i k ɕ͈ ʌ̹ n ʌ̹ ɾ i	윅써너리
윈난	ɥ i n n a̠ n	윈난
윈도	ɥ i n d o̞	윈도
윈도우	ɥ i n d o̞ u	윈도우
유가	j u ɡ a̠	유가
유가증권	j uː ɡ a̠ d͡ʑ ɯ ŋ k͈ w ʌ̹ n	유가증꿘
유감	j u ɡ a̠ m	유감
유격수	j u ɡ j ʌ̹ k s͈ u	유격쑤
유고슬라비아	j u ɡ o̞ sʰ ɯ ɭ ɭ a̠ b i a̠	유고슬라비아
유곽	j u ɡ w a̠ k̚	유곽
유괴	j u ɡ w e̞	유괴
유교	j u ɡ j o	유교
유권자	j uː ɡ w ʌ̹ ɲ d͡ʑ a̠	유권자
유기견	j u ɡ i ɡ j ʌ̹ n	유기견
유난히	j uː n a̠ n ʝ i	유난히
유년	j u ɲ j ʌ̹ n	유년
유능하다	j u n ɯ ŋ ɦ a̠ d a̠	유능하다
유니폼	j u n i pʰ o̞ m	유니폼
유도	j u d o̞	유도
유도탄	j u d o̞ tʰ a̠ n	유도탄
유독	j uː d o̞ k̚	유독
유라시아	j u ɾ a̠ ɕʰ i a̠	유라시아
유량	j u ɾ j a̠ ŋ	유량
유럽	j u ɾ ʌ̹ p̚	유럽
유령	j u ɾ j ʌ̹ ŋ	유령
유로비트	j u ɾ o̞ b i tʰ ɯ	유로비트
유르트	j u ɾ ɯ tʰ ɯ	유르트
유리기	j u ɾ i ɡ i	유리기
유릿조각	j u ɾ i t̚ t͡ɕ͈ o̞ ɡ a̠ k̚	유릳쪼각
유머	j u m ʌ̹	유머
유명	j uː m j ʌ̹ ŋ	유명
유명하다	j uː m j ʌ̹ ŋ ɦ a̠ d a̠	유명하다
유목민	j u m o̞ ŋ m i n	유몽민
유물	j u m u ɭ	유물
유민	j u m i n	유민
유사하다	j uː sʰ a̠ ɦ a̠ d a̠	유사하다
유서	j u sʰ ʌ̹	유서
유성	j u sʰ ʌ̹ ŋ	유성
유스호스텔	j u sʰ ɯ β o̞ sʰ ɯ tʰ e̞ ɭ	유스호스텔
유아	j u a̠	유아
유아원	j u a̠ w ʌ̹ n	유아원
유언	j u ʌ̹ n	유언
유언비어	j u ʌ̹ n b i ʌ̹	유언비어
유엔	j u e̞ n	유엔
유역	j u j ʌ̹ k̚	유역
유용하다	j uː j o ŋ ɦ a̠ d a̠	유용하다
유월	j u w ʌ̹ ɭ	유월
유의어	j uː ɰ i ʌ̹	유의어
유익하다	j u i kʰ a̠ d a̠	유이카다
유인원	j uː i n w ʌ̹ n	유이눤
유입	j u i p̚	유입
유적	j u d͡ʑ ʌ̹ k̚	유적
유전자	j u d͡ʑ ʌ̹ ɲ d͡ʑ a̠	유전자
유제품	j u d͡ʑ e̞ pʰ u m	유제품
유죄	j uː d͡ʑ w e̞	유죄
유지	j u d͡ʑ i	유지
유지하다	j u d͡ʑ i ɦ a̠ d a̠	유지하다
유진	j u d͡ʑ i n	유진
유출	j u t͡ɕʰ u ɭ	유출
유충	j u t͡ɕʰ u ŋ	유충
유탄	j u tʰ a̠ n	유탄
유통	j u tʰ o̞ ŋ	유통
유튜브	j u tʰ j u b ɯ	유튜브
유학	j u ɦ a̠ k̚	유학
유형	j uː ʝ j ʌ̹ ŋ	유형
유혹	j u β o̞ k̚	유혹
유희	j u ʝ i	유히
육군	j u k̚ k͈ u n	육꾼
육분의	j u k̚ p͈ u n ɰ i	육뿌늬
육서	j u k s͈ ʌ̹	육써
육수	j u k s͈ u	육쑤
육자진언	j u k̚ t͡ɕ͈ a̠ d͡ʑ i n ʌ̹ n	육짜지넌
육지	j u k̚ t͡ɕ͈ i	육찌
육체	j u k̚ t͡ɕʰ e̞	육체
육회	j u kʰ w e̞	유쾨
윤곽	j u n ɡ w a̠ k̚	윤곽
윤리	j u ʎ ʎ i	율리
윤리학	j u ʎ ʎ i ɦ a̠ k̚	율리학
융자	j u ŋ d͡ʑ a̠	융자
융합	j u ŋ ɦ a̠ p̚	융합
윷놀이	j uː n n o̞ ɾ i	윤노리
윷짝	j uː t̚ t͡ɕ͈ a̠ k̚	윧짝
으로	ɯ ɾ o̞	으로
으쌰	ɯ ɕ͈ a̠	으싸
은근	ɯ n ɡ ɯ n	은근
은근히	ɯ n ɡ ɯ n ʝ i	은근히
은어	ɯ n ʌ̹	으너
은유	ɯ ɲ j u	으뉴
은인	ɯ n i n	으닌
은퇴하다	ɯ n tʰ w e̞ ɦ a̠ d a̠	은퇴하다
은하단	ɯ n ɦ a̠ d a̠ n	은하단
은하수	ɯ n ɦ a̠ sʰ u	은하수
은혜	ɯ n ʝ j e̞	은혜
을게	ɯ ɭ k͈ e̞	을께
음경	ɯ m ɡ j ʌ̹ ŋ	음경
음독	ɯ m d o̞ k̚	음독
음량	ɯ m ɲ j a̠ ŋ	음냥
음력	ɯ m ɲ j ʌ̹ k̚	음녁
음료	ɯː m ɲ j o	음뇨
음모론	ɯ m m o̞ ɾ o̞ n	음모론
음문	ɯ m m u n	음문
음반	ɯ m b a̠ n	음반
음성	ɯ m sʰ ʌ̹ ŋ	음성
음소	ɯ m sʰ o̞	음소
음소문자	ɯ m sʰ o̞ m u ɲ d͡ʑ a̠	음소문자
음식	ɯː m ɕʰ i k̚	음식
음식값	ɯː m ɕʰ i k̚ k͈ a̠ p̚	음식깝
음식점	ɯː m ɕʰ i k̚ t͡ɕ͈ ʌ̹ m	음식쩜
음쓰	ɯː m s͈ ɯ	음쓰
음악	ɯ m a̠ k̚	으막
음악가	ɯ m a̠ k̚ k͈ a̠	으막까
음악학	ɯ m a̠ kʰ a̠ k̚	으마칵
음양	ɯ m j a̠ ŋ	으먕
음역자	ɯ m j ʌ̹ k̚ t͡ɕ͈ a̠	으멱짜
음운론	ɯ m u n n o̞ n	으문논
음절	ɯ m d͡ʑ ʌ̹ ɭ	음절
음표	ɯ m pʰ j o	음표
음향	ɯ m ʝ j a̠ ŋ	음향
음훈	ɯ m β u n	음훈
응답	ɯː ŋ d a̠ p̚	응답
응당	ɯː ŋ d a̠ ŋ	응당
응용	ɯː ŋ j o ŋ	으용
응원	ɯː ŋ w ʌ̹ n	으원
응집력	ɯː ŋ d͡ʑ i m ɲ j ʌ̹ k̚	응짐녁
응징하다	ɯ ŋ d͡ʑ i ŋ ɦ a̠ d a̠	응징하다
의거하다	ɰ i ɡ ʌ̹ ɦ a̠ d a̠	의거하다
의견	ɰ iː ɡ j ʌ̹ n	의견
의논	ɰ i n o̞ n	의논
의료	ɰ i ɾ j o	의료
의리	ɰ iː ɾ i	의리
의문	ɰ i m u n	의문
의문사	ɰ i m u n sʰ a̠	의문사
의미	ɰ iː m i	의미
의복	ɰ i b o̞ k̚	의복
의상	ɰ i sʰ a̠ ŋ	의상
의성어	ɰ i sʰ ʌ̹ ŋ ʌ̹	의서어
의식	ɰ iː ɕʰ i k̚	의식
의식하다	ɰ iː ɕʰ i kʰ a̠ d a̠	의시카다
의심	ɰ i ɕʰ i m	의심
의심쩍다	ɰ i ɕʰ i m t͡ɕ͈ ʌ̹ k̚ t͈ a̠	의심쩍따
의심하다	ɰ i ɕʰ i m ɦ a̠ d a̠	의심하다
의의	ɰ iː ɰ i	의의
의인화	ɰ i i n β w a̠	의인화
의자	ɰ i d͡ʑ a̠	의자
의장	ɰ i d͡ʑ a̠ ŋ	의장
의제	ɰ i d͡ʑ e̞	의제
의존증	ɰ i d͡ʑ o̞ ɲ t͡ɕ͈ ɯ ŋ	의존쯩
의존하다	ɰ i d͡ʑ o̞ n ɦ a̠ d a̠	의존하다
의향	ɰ iː ʝ j a̠ ŋ	의향
의협심	ɰ i ʝ j ʌ̹ p ɕ͈ i m	의협씸
의형제	ɰ iː ʝ j ʌ̹ ŋ d͡ʑ e̞	의형제
의혹	ɰ i β o̞ k̚	의혹
의회	ɰ i β w e̞	의회
이거	i ɡ ʌ̹	이거
이것	i ɡ ʌ̹ t̚	이걷
이게	i ɡ e̞	이게
이곳	i ɡ o̞ t̚	이곧
이과	iː k͈ w a̠	이꽈
이교도	iː ɡ j o d o̞	이교도
이글	i ɡ ɯ ɭ	이글
이글이글	i ɡ ɯ ɾ i ɡ ɯ ɭ	이그리글
이기다	i ɡ i d a̠	이기다
이기적	iː ɡ i d͡ʑ ʌ̹ k̚	이기적
이기주의	iː ɡ i d͡ʑ u ɰ i	이기주의
이끌다	i k͈ ɯ ɭ d a̠	이끌다
이끼	i k͈ i	이끼
이나	i n a̠	이나
이날	i n a̠ ɭ	이날
이념	iː ɲ j ʌ̹ m	이념
이다	i d a̠	이다
이데올로기	i d e̞ o̞ ɭ ɭ o̞ ɡ i	이데올로기
이도	i d o̞	이도
이동	i d o̞ ŋ	이동
이듬	i d ɯ m	이듬
이디시어	i d i ɕʰ i ʌ̹	이디시어
이따가	i t͈ a̠ ɡ a̠	이따가
이라크	i ɾ a̠ k x ɯ	이락흐
이란	i ɾ a̠ n	이란
이란어	i ɾ a̠ n ʌ̹	이라너
이랑	i ɾ a̠ ŋ	이랑
이러다	i ɾ ʌ̹ d a̠	이러다
이런	i ɾ ʌ̹ n	이런
이렇다	i ɾ ʌ̹ tʰ a̠	이러타
이력서	iː ɾ j ʌ̹ k s͈ ʌ̹	이력써
이론	iː ɾ o̞ n	이론
이롭다	iː ɾ o̞ p̚ t͈ a̠	이롭따
이루다	i ɾ u d a̠	이루다
이르다	i ɾ ɯ d a̠	이르다
이름	i ɾ ɯ m	이름
이리	i ɾ i	이리
이마	i m a̠	이마
이맘	i m a̠ m	이맘
이메일	i m e̞ i ɭ	이메일
이며	i m j ʌ̹	이며
이명	iː m j ʌ̹ ŋ	이명
이모	i m o̞	이모
이모부	i m o̞ b u	이모부
이목구비	iː m o̞ k̚ k͈ u b i	이목꾸비
이물	i m u ɭ	이물
이미	iː m i	이미
이미다졸	i m i d a̠ d͡ʑ o̞ ɭ	이미다졸
이미지	i m i d͡ʑ i	이미지
이민	i m i n	이민
이발	iː b a̠ ɭ	이발
이발사	iː b a̠ ɭ sʰ a̠	이발사
이발소	iː b a̠ ɭ s͈ o̞	이발쏘
이번	i b ʌ̹ n	이번
이벤트	i b e̞ n tʰ ɯ	이벤트
이별	iː b j ʌ̹ ɭ	이별
이분	i b u n	이분
이불	i b u ɭ	이불
이빨	i p͈ a̠ ɭ	이빨
이사야	i sʰ a̠ j a̠	이사야
이사회	iː sʰ a̠ β w e̞	이사회
이산화탄소	iː sʰ a̠ n β w a̠ tʰ a̠ n sʰ o̞	이산화탄소
이삼	iː sʰ a̠ m	이삼
이상	iː sʰ a̠ ŋ	이상
이상하다	iː sʰ a̠ ŋ ɦ a̠ d a̠	이상하다
이성	iː sʰ ʌ̹ ŋ	이성
이스라엘	i sʰ ɯ ɾ a̠ e̞ ɭ	이스라엘
이스마엘	i sʰ ɯ m a̠ e̞ ɭ	이스마엘
이스탄불	i sʰ ɯ tʰ a̠ n b u ɭ	이스탄불
이슬라마바드	i sʰ ɯ ɭ ɭ a̠ m a̠ b a̠ d ɯ	이슬라마바드
이슬람	i sʰ ɯ ɭ ɭ a̠ m	이슬람
이슬람교	i sʰ ɯ ɭ ɭ a̠ m ɡ j o	이슬람교
이슬람국가	i sʰ ɯ ɭ ɭ a̠ m ɡ u k̚ k͈ a̠	이슬람국까
이승	i sʰ ɯ ŋ	이승
이신론	i ɕʰ i n n o̞ n	이신논
이심전심	iː ɕʰ i m d͡ʑ ʌ̹ n ɕʰ i m	이심전심
이십	iː ɕʰ i p̚	이십
이야	i j a̠	이야
이야기	i j a̠ ɡ i	이야기
이야기하다	i j a̠ ɡ i ɦ a̠ d a̠	이야기하다
이어	i ʌ̹	이어
이어지다	i ʌ̹ d͡ʑ i d a̠	이어지다
이어폰	i ʌ̹ pʰ o̞ n	이어폰
이엉	i ʌ̹ ŋ	이엉
이외	iː w e̞	이외
이용	iː j o ŋ	이용
이용되다	iː j o ŋ d w e̞ d a̠	이용되다
이용자	iː j o ŋ d͡ʑ a̠	이용자
이용하다	iː j o ŋ ɦ a̠ d a̠	이용하다
이웃	i u t̚	이욷
이웃집	i u t̚ t͡ɕ͈ i p̚	이욷찝
이윽고	i ɯ k̚ k͈ o̞	이윽꼬
이익	iː i k̚	이익
이자	i d͡ʑ a̠	이자
이장	i d͡ʑ a̠ ŋ	이장
이전	iː d͡ʑ ʌ̹ n	이전
이점	iː d͡ʑ ʌ̹ m	이점
이제	i d͡ʑ e̞	이제
이주	i d͡ʑ u	이주
이진법	iː d͡ʑ i n p͈ ʌ̹ p̚	이진뻡
이질	iː d͡ʑ i ɭ	이질
이집트	i d͡ʑ i p̚ tʰ ɯ	이집트
이쪽	i t͡ɕ͈ o̞ k̚	이쪽
이체	iː t͡ɕʰ e̞	이체
이탈	iː tʰ a̠ ɭ	이탈
이튿날	i tʰ ɯ n n a̠ ɭ	이튼날
이틀	i tʰ ɯ ɭ	이틀
이하	iː ɦ a̠	이하
이혼	iː β o̞ n	이혼
이화우	i β w a̠ u	이화우
익룡	i ŋ ɲ j o ŋ	잉뇽
익명	i ŋ m j ʌ̹ ŋ	잉명
익사	i k s͈ a̠	익싸
익숙하다	i k s͈ u kʰ a̠ d a̠	익쑤카다
인간	i n ɡ a̠ n	인간
인격	i n k͈ j ʌ̹ k̚	인껵
인공지능	i n ɡ o̞ ŋ d͡ʑ i n ɯ ŋ	인공지능
인구조사	i n ɡ u d͡ʑ o̞ sʰ a̠	인구조사
인근	i n ɡ ɯ n	인근
인니	i n n i	인니
인도	i n d o̞	인도
인도네시아	i n d o̞ n e̞ ɕʰ i a̠	인도네시아
인도네시아어	i n d o̞ n e̞ ɕʰ i a̠ ʌ̹	인도네시아어
인도양	i n d o̞ j a̠ ŋ	인도양
인도차이나	i n d o̞ t͡ɕʰ a̠ i n a̠	인도차이나
인돌	i n d o̞ ɭ	인돌
인력거	i ʎ ʎ j ʌ̹ k̚ k͈ ʌ̹	일력꺼
인류	i ʎ ʎ j u	일류
인명	i n m j ʌ̹ ŋ	인명
인문학	i n m u n ɦ a̠ k̚	인문학
인사	i n sʰ a̠	인사
인삼	i n sʰ a̠ m	인삼
인성	i n sʰ ʌ̹ ŋ	인성
인수	i n sʰ u	인수
인식	i n ɕʰ i k̚	인식
인식론	i n ɕʰ i ŋ n o̞ n	인싱논
인식표	i n ɕʰ i k̚ pʰ j o	인식표
인어	i n ʌ̹	이너
인연	i ɲ j ʌ̹ n	이년
인용하다	i ɲ j o ŋ ɦ a̠ d a̠	이뇽하다
인자	i ɲ d͡ʑ a̠	인자
인절미	i ɲ d͡ʑ ʌ̹ ɭ m i	인절미
인제	i ɲ d͡ʑ e̞	인제
인종	i ɲ d͡ʑ o̞ ŋ	인종
인종차별	i ɲ d͡ʑ o̞ ŋ t͡ɕʰ a̠ b j ʌ̹ ɭ	인종차별
인중	i ɲ d͡ʑ u ŋ	인중
인증	i ɲ d͡ʑ ɯ ŋ	인증
인질	i ɲ d͡ʑ i ɭ	인질
인천	i ɲ t͡ɕʰ ʌ̹ n	인천
인출	i ɲ t͡ɕʰ u ɭ	인출
인치	i ɲ t͡ɕʰ i	인치
인터네트	i n tʰ ʌ̹ n e̞ tʰ ɯ	인터네트
인터뷰	i n tʰ ʌ̹ b j u	인터뷰
인터페이스	i n tʰ ʌ̹ pʰ e̞ i sʰ ɯ	인터페이스
인텔리겐치아	i n tʰ e̞ ʎ ʎ i ɡ e̞ ɲ t͡ɕʰ i a̠	인텔리겐치아
인티파다	i n tʰ i pʰ a̠ d a̠	인티파다
인플레이션	i n pʰ ɯ ɭ ɭ e̞ i ɕʰ ʌ̹ n	인플레이선
인플루엔자	i n pʰ ɯ ɭ ɭ u e̞ ɲ d͡ʑ a̠	인플루엔자
인하	i n ɦ a̠	인하
인하다	i n ɦ a̠ d a̠	인하다
인형	i n ʝ j ʌ̹ ŋ	인형
인화지	i n β w a̠ d͡ʑ i	인화지
인후	i n β u	인후
일각수	i ɭ ɡ a̠ k s͈ u	일각쑤
일견	i ɭ ɡ j ʌ̹ n	일견
일고여덟	i ɭ ɡ o̞ j ʌ̹ d ʌ̹ ɭ	일고여덜
일광	i ɭ ɡ w a̠ ŋ	일광
일국	i ɭ ɡ u k̚	일국
일군	i ɭ k͈ u n	일꾼
일그러지다	i ɭ ɡ ɯ ɾ ʌ̹ d͡ʑ i d a̠	일그러지다
일기	i ɭ ɡ i	일기
일꾼	i ɭ k͈ u n	일꾼
일년	i ʎ ʎ j ʌ̹ n	일련
일단	i ɭ t͈ a̠ n	일딴
일동	i ɭ t͈ o̞ ŋ	일똥
일러두기	i ɭ ɭ ʌ̹ d u ɡ i	일러두기
일문	i ɭ m u n	일문
일반	i ɭ b a̠ n	일반
일반인	i ɭ b a̠ n i n	일바닌
일반적	i ɭ b a̠ ɲ d͡ʑ ʌ̹ k̚	일반적
일보	i ɭ b o̞	일보
일본어	i ɭ b o̞ n ʌ̹	일보너
일본인	i ɭ b o̞ n i n	일보닌
일본주	i ɭ b o̞ ɲ d͡ʑ u	일본주
일본학	i ɭ b o̞ n ɦ a̠ k̚	일본학
일부	i ɭ b u	일부
일부러	iː ɭ b u ɾ ʌ̹	일부러
일사천리	i ɭ s͈ a̠ t͡ɕʰ ʌ̹ ʎ ʎ i	일싸철리
일시적	i ɭ ɕʰ i d͡ʑ ʌ̹ k̚	일시적
일쑤	i ɭ s͈ u	일쑤
일어나다	i ɾ ʌ̹ n a̠ d a̠	이러나다
일어서다	i ɾ ʌ̹ sʰ ʌ̹ d a̠	이러서다
일왕	i ɾ w a̠ ŋ	이뢍
일요일	i ɾ j o i ɭ	이료일
일원	i ɾ w ʌ̹ n	이뤈
일월	i ɾ w ʌ̹ ɭ	이뤌
일이	i ɾ i	이리
일인칭	i ɾ i ɲ t͡ɕʰ i ŋ	이린칭
일자	i ʎ t͡ɕ͈ a̠	일짜
일정	i ʎ t͡ɕ͈ ʌ̹ ŋ	일쩡
일정하다	i ʎ d͡ʑ ʌ̹ ŋ ɦ a̠ d a̠	일정하다
일종	i ʎ t͡ɕ͈ o̞ ŋ	일쫑
일주일	i ʎ t͡ɕ͈ u i ɭ	일쭈일
일찍이	i ʎ t͡ɕ͈ i ɡ i	일찌기
일천	i ʎ t͡ɕʰ ʌ̹ n	일천
일체	i ʎ t͡ɕʰ e̞	일체
일출	i ʎ t͡ɕʰ u ɭ	일출
일취월장	i ʎ t͡ɕʰ ɥ i w ʌ̹ ʎ d͡ʑ a̠ ŋ	일취월장
일치	i ʎ t͡ɕʰ i	일치
일치하다	i ʎ t͡ɕʰ i ɦ a̠ d a̠	일치하다
일하다	iː ɾ ɦ a̠ d a̠	일하다
일흔	i ɾ ɣ ɯ n	일ɣㅡㄴ
읽다	i k̚ t͈ a̠	익따
잃다	i ɭ tʰ a̠	일타
임기	i m ɡ i	임기
임마누엘	i m m a̠ n u e̞ ɭ	임마누엘
임명	i m m j ʌ̹ ŋ	임명
임무	iː m m u	임무
임부	iː m b u	임부
임시	i m ɕʰ i	임시
임신	iː m ɕʰ i n	임신
임신부	iː m ɕʰ i n b u	임신부
임실납자루	i m ɕʰ i ɭ ɭ a̠ p̚ t͡ɕ͈ a̠ ɾ u	임실랍짜루
임자	iː m d͡ʑ a̠	임자
임질	i m d͡ʑ i ɭ	임질
입구	i p̚ k͈ u	입꾸
입금	i p̚ k͈ ɯ m	입끔
입다	i p̚ t͈ a̠	입따
입덧	i p̚ t͈ ʌ̹ t̚	입떧
입력	i m ɲ j ʌ̹ k̚	임녁
입법	i p̚ p͈ ʌ̹ p̚	입뻡
입빠이	i p̚ p͈ a̠ i	입빠이
입성	i p s͈ ʌ̹ ŋ	입썽
입술	i p s͈ u ɭ	입쑬
입시	i p ɕ͈ i	입씨
입양	i b j a̠ ŋ	이뱡
입장	i p̚ t͡ɕ͈ a̠ ŋ	입짱
입장료	i p̚ t͡ɕ͈ a̠ ŋ ɲ j o	입짱뇨
잇다	iː t̚ t͈ a̠	읻따
있다	i t̚ t͈ a̠	읻따
있어	i s͈ ʌ̹	이써
잉부	iː ŋ b u	잉부
잉어	iː ŋ ʌ̹	이어
잉여	iː ŋ j ʌ̹	이여
잊어버리다	i d͡ʑ ʌ̹ b ʌ̹ ɾ i d a̠	이저버리다
잊히다	i t͡ɕʰ i d a̠	이치다
자가사리	t͡ɕ a̠ ɡ a̠ sʰ a̠ ɾ i	자가사리
자가용차	t͡ɕ a̠ ɡ a̠ j o ŋ t͡ɕʰ a̠	자가용차
자갈	t͡ɕ a̠ ɡ a̠ ɭ	자갈
자강도	t͡ɕ a̠ ɡ a̠ ŋ d o̞	자강도
자격	t͡ɕ a̠ ɡ j ʌ̹ k̚	자격
자그레브	t͡ɕ a̠ ɡ ɯ ɾ e̞ b ɯ	자그레브
자극	t͡ɕ a̠ː ɡ ɯ k̚	자극
자기절로	t͡ɕ a̠ ɡ i d͡ʑ ʌ̹ ɭ ɭ o̞	자기절로
자꾸	t͡ɕ a̠ k͈ u	자꾸
자꾸만	t͡ɕ a̠ k͈ u m a̠ n	자꾸만
자낳괴	t͡ɕ a̠ n a̠ ɡ w e̞	자나괴
자네	t͡ɕ a̠ n e̞	자네
자다	t͡ɕ a̠ d a̠	자다
자동	t͡ɕ a̠ d o̞ ŋ	자동
자동차	t͡ɕ a̠ d o̞ ŋ t͡ɕʰ a̠	자동차
자동화	t͡ɕ a̠ d o̞ ŋ β w a̠	자동화
자두나무	t͡ɕ a̠ d u n a̠ m u	자두나무
자라다	t͡ɕ a̠ ɾ a̠ d a̠	자라다
자랑	t͡ɕ a̠ ɾ a̠ ŋ	자랑
자랑스럽다	t͡ɕ a̠ ɾ a̠ ŋ sʰ ɯ ɾ ʌ̹ p̚ t͈ a̠	자랑스럽따
자료	t͡ɕ a̠ ɾ j o	자료
자리	t͡ɕ a̠ ɾ i	자리
자막	t͡ɕ a̠ m a̠ k̚	자막
자만	t͡ɕ a̠ m a̠ n	자만
자메이카	t͡ɕ a̠ m e̞ i kʰ a̠	자메이카
자명금	t͡ɕ a̠ m j ʌ̹ ŋ ɡ ɯ m	자명금
자명종	t͡ɕ a̠ m j ʌ̹ ŋ d͡ʑ o̞ ŋ	자명종
자몽	t͡ɕ a̠ m o̞ ŋ	자몽
자물쇠	t͡ɕ a̠ m u ɭ s͈ w e̞	자물쐬
자본	t͡ɕ a̠ b o̞ n	자본
자본주의	t͡ɕ a̠ b o̞ ɲ d͡ʑ u ɰ i	자본주의
자비	t͡ɕ a̠ b i	자비
자뻑	t͡ɕ a̠ p͈ ʌ̹ k̚	자뻑
자산	t͡ɕ a̠ sʰ a̠ n	자산
자살	t͡ɕ a̠ sʰ a̠ ɭ	자살
자석	t͡ɕ a̠ː sʰ ʌ̹ k̚	자석
자세	t͡ɕ a̠ sʰ e̞	자세
자세하다	t͡ɕ a̠ sʰ e̞ ɦ a̠ d a̠	자세하다
자세히	t͡ɕ a̠ sʰ e̞ ʝ i	자세히
자손	t͡ɕ a̠ sʰ o̞ n	자손
자시다	t͡ɕ a̠ː ɕʰ i d a̠	자시다
자식	t͡ɕ a̠ ɕʰ i k̚	자식
자신	t͡ɕ a̠ ɕʰ i n	자신
자아	t͡ɕ a̠ a̠	자아
자업자득	t͡ɕ a̠ ʌ̹ p̚ t͡ɕ͈ a̠ d ɯ k̚	자업짜득
자연	t͡ɕ a̠ j ʌ̹ n	자연
자연스럽다	t͡ɕ a̠ j ʌ̹ n sʰ ɯ ɾ ʌ̹ p̚ t͈ a̠	자연스럽따
자연환경	t͡ɕ a̠ j ʌ̹ n β w a̠ n ɡ j ʌ̹ ŋ	자연환경
자외	t͡ɕ a̠ w e̞	자외
자원	t͡ɕ a̠ w ʌ̹ n	자원
자유적	t͡ɕ a̠ j u d͡ʑ ʌ̹ k̚	자유적
자유주의	t͡ɕ a̠ j u d͡ʑ u ɰ i	자유주의
자유지상주의	t͡ɕ a̠ j u d͡ʑ i sʰ a̠ ŋ d͡ʑ u ɰ i	자유지상주의
자율	t͡ɕ a̠ j u ɭ	자율
자음	t͡ɕ a̠ ɯ m	자음
자작	t͡ɕ a̠ d͡ʑ a̠ k̚	자작
자장가	t͡ɕ a̠ d͡ʑ a̠ ŋ ɡ a̠	자장가
자장면	t͡ɕ a̠ d͡ʑ a̠ ŋ m j ʌ̹ n	자장면
자전거	t͡ɕ a̠ d͡ʑ ʌ̹ n ɡ ʌ̹	자전거
자제	t͡ɕ a̠ d͡ʑ e̞	자제
자존감	t͡ɕ a̠ d͡ʑ o̞ n ɡ a̠ m	자존감
자존심	t͡ɕ a̠ d͡ʑ o̞ n ɕʰ i m	자존심
자지	t͡ɕ a̠ː d͡ʑ i	자지
자진	t͡ɕ a̠ d͡ʑ i n	자진
자진하다	t͡ɕ a̠ d͡ʑ i n ɦ a̠ d a̠	자진하다
자체	t͡ɕ a̠ t͡ɕʰ e̞	자체
자취	t͡ɕ a̠ t͡ɕʰ ɥ i	자취
자칫하면	t͡ɕ a̠ t͡ɕʰ i tʰ a̠ m j ʌ̹ n	자치타면
자칼	t͡ɕ a̠ kʰ a̠ ɭ	자칼
자타공인	t͡ɕ a̠ tʰ a̠ ɡ o̞ ŋ i n	자타고인
자판	t͡ɕ a̠ pʰ a̠ n	자판
자판기	t͡ɕ a̠ pʰ a̠ n ɡ i	자판기
자폐증	t͡ɕ a̠ pʰ j e̞ t͡ɕ͈ ɯ ŋ	자폐쯩
작가	t͡ɕ a̠ k̚ k͈ a̠	작까
작곡	t͡ɕ a̠ k̚ k͈ o̞ k̚	작꼭
작곡가	t͡ɕ a̠ k̚ k͈ o̞ k̚ k͈ a̠	작꼭까
작곡자	t͡ɕ a̠ k̚ k͈ o̞ k̚ t͡ɕ͈ a̠	작꼭짜
작년	t͡ɕ a̠ ŋ ɲ j ʌ̹ n	장년
작다	t͡ɕ a̠ː k̚ t͈ a̠	작따
작렬	t͡ɕ a̠ ŋ ɲ j ʌ̹ ɭ	장녈
작별	t͡ɕ a̠ k̚ p͈ j ʌ̹ ɭ	작뼐
작심삼일	t͡ɕ a̠ k ɕ͈ i m sʰ a̠ m i ɭ	작씸사밀
작업복	t͡ɕ a̠ ɡ ʌ̹ p̚ p͈ o̞ k̚	자겁뽁
작업실	t͡ɕ a̠ ɡ ʌ̹ p ɕ͈ i ɭ	자겁씰
작용	t͡ɕ a̠ ɡ j o ŋ	자굥
작은	t͡ɕ a̠ ɡ ɯ n	자근
작은관코박쥐	t͡ɕ a̠ ɡ ɯ n ɡ w a̠ n kʰ o̞ b a̠ k̚ t͡ɕ͈ ɥ i	자근관코박쮜
작은땃쥐	t͡ɕ a̠ ɡ ɯ n t͈ a̠ t̚ t͡ɕ͈ ɥ i	자근딷쮜
작은아버지	t͡ɕ a̠ ɡ ɯ n a̠ b ʌ̹ d͡ʑ i	자그나버지
작전	t͡ɕ a̠ k̚ t͡ɕ͈ ʌ̹ n	작쩐
작품	t͡ɕ a̠ k̚ pʰ u m	작품
잔나비	t͡ɕ a̠ n n a̠ b i	잔나비
잔돈	t͡ɕ a̠ n d o̞ n	잔돈
잔디	t͡ɕ a̠ n d i	잔디
잔디밭	t͡ɕ a̠ n d i b a̠ t̚	잔디받
잔류	t͡ɕ a̠ ʎ ʎ j u	잘류
잔소리	t͡ɕ a̠ n sʰ o̞ ɾ i	잔소리
잔잔하다	t͡ɕ a̠ ɲ d͡ʑ a̠ n ɦ a̠ d a̠	잔잔하다
잔칫집	t͡ɕ a̠ ɲ t͡ɕʰ i t̚ t͡ɕ͈ i p̚	잔칟찝
잔혹	t͡ɕ a̠ n β o̞ k̚	잔혹
잘못	t͡ɕ a̠ ɭ m o̞ t̚	잘몯
잘못되다	t͡ɕ a̠ ɭ m o̞ t̚ t͈ w e̞ d a̠	잘몯뙤다
잘잘못	t͡ɕ a̠ ʎ d͡ʑ a̠ ɭ m o̞ t̚	잘잘몯
잠그다	t͡ɕ a̠ m ɡ ɯ d a̠	잠그다
잠깐	t͡ɕ a̠ m k͈ a̠ n	잠깐
잠두	t͡ɕ a̠ m d u	잠두
잠들다	t͡ɕ a̠ m d ɯ ɭ d a̠	잠들다
잠망경	t͡ɕ a̠ m m a̠ ŋ ɡ j ʌ̹ ŋ	잠망경
잠바	t͡ɕ a̠ m b a̠	잠바
잠비아	t͡ɕ a̠ m b i a̠	잠비아
잠수함	t͡ɕ a̠ m sʰ u ɦ a̠ m	잠수함
잠시	t͡ɕ a̠ː m ɕʰ i	잠시
잠열	t͡ɕ a̠ m j ʌ̹ ɭ	자멸
잠자다	t͡ɕ a̠ m d͡ʑ a̠ d a̠	잠자다
잠자코	t͡ɕ a̠ m d͡ʑ a̠ kʰ o̞	잠자코
잡년	t͡ɕ a̠ m ɲ j ʌ̹ n	잠년
잡다	t͡ɕ a̠ p̚ t͈ a̠	잡따
잡수시다	t͡ɕ a̠ p s͈ u ɕʰ i d a̠	잡쑤시다
잡종	t͡ɕ a̠ p̚ t͡ɕ͈ o̞ ŋ	잡쫑
잡지	t͡ɕ a̠ p̚ t͡ɕ͈ i	잡찌
잡초	t͡ɕ a̠ p̚ t͡ɕʰ o̞	잡초
장관	t͡ɕ a̠ː ŋ ɡ w a̠ n	장관
장교	t͡ɕ a̠ː ŋ ɡ j o	장교
장군	t͡ɕ a̠ ŋ ɡ u n	장군
장군석	t͡ɕ a̠ ŋ ɡ u n sʰ ʌ̹ k̚	장군석
장난	t͡ɕ a̠ ŋ n a̠ n	장난
장난감	t͡ɕ a̠ ŋ n a̠ n k͈ a̠ m	장난깜
장려금	t͡ɕ a̠ː ŋ ɲ j ʌ̹ ɡ ɯ m	장녀금
장로교	t͡ɕ a̠ː ŋ n o̞ ɡ j o	장노교
장로교회	t͡ɕ a̠ː ŋ n o̞ ɡ j o β w e̞	장노교회
장면	t͡ɕ a̠ ŋ m j ʌ̹ n	장면
장모	t͡ɕ a̠ː ŋ m o̞	장모
장모님	t͡ɕ a̠ː ŋ m o̞ n i m	장모님
장물	t͡ɕ a̠ ŋ m u ɭ	장물
장미	t͡ɕ a̠ ŋ m i	장미
장보다	t͡ɕ a̠ ŋ b o̞ d a̠	장보다
장비	t͡ɕ a̠ ŋ b i	장비
장사	t͡ɕ a̠ ŋ sʰ a̠	장사
장석	t͡ɕ a̠ ŋ sʰ ʌ̹ k̚	장석
장소	t͡ɕ a̠ ŋ sʰ o̞	장소
장승	t͡ɕ a̠ ŋ sʰ ɯ ŋ	장승
장식하다	t͡ɕ a̠ ŋ ɕʰ i kʰ a̠ d a̠	장시카다
장쑤	t͡ɕ a̠ ŋ s͈ u	장쑤
장어	t͡ɕ a̠ ŋ ʌ̹	자어
장작	t͡ɕ a̠ ŋ d͡ʑ a̠ k̚	장작
장정	t͡ɕ a̠ ŋ d͡ʑ ʌ̹ ŋ	장정
장치	t͡ɕ a̠ ŋ t͡ɕʰ i	장치
장학금	t͡ɕ a̠ː ŋ ɦ a̠ k̚ k͈ ɯ m	장학끔
잦다	t͡ɕ a̠ t̚ t͈ a̠	잗따
재작년	t͡ɕ ɛː d͡ʑ a̠ ŋ ɲ j ʌ̹ n	재장년
저거	t͡ɕ ʌ̹ ɡ ʌ̹	저거
저것	t͡ɕ ʌ̹ ɡ ʌ̹ t̚	저걷
저고리	t͡ɕ ʌ̹ ɡ o̞ ɾ i	저고리
저곳	t͡ɕ ʌ̹ ɡ o̞ t̚	저곧
저금통	t͡ɕ ɘː ɡ ɯ m tʰ o̞ ŋ	저금통
저급	t͡ɕ ɘː ɡ ɯ p̚	저급
저기	t͡ɕ ʌ̹ ɡ i	저기
저널리스트	t͡ɕ ʌ̹ n ʌ̹ ʎ ʎ i sʰ ɯ tʰ ɯ	저널리스트
저렇게	t͡ɕ ʌ̹ ɾ ʌ̹ kʰ e̞	저러케
저력	t͡ɕ ɘː ɾ j ʌ̹ k̚	저력
저분	t͡ɕ ʌ̹ b u n	저분
저수지	t͡ɕ ɘː sʰ u d͡ʑ i	저수지
저승사자	t͡ɕ ʌ̹ sʰ ɯ ŋ sʰ a̠ d͡ʑ a̠	저승사자
저작권	t͡ɕ ɘː d͡ʑ a̠ k̚ k͈ w ʌ̹ n	저작꿘
저장	t͡ɕ ʌ̹ d͡ʑ a̠ ŋ	저장
저절로	t͡ɕ ʌ̹ d͡ʑ ʌ̹ ɭ ɭ o̞	저절로
저주	t͡ɕ ɘː d͡ʑ u	저주
저지르다	t͡ɕ ʌ̹ d͡ʑ i ɾ ɯ d a̠	저지르다
저지하다	t͡ɕ ʌ̹ d͡ʑ i ɦ a̠ d a̠	저지하다
저쪽	t͡ɕ ʌ̹ t͡ɕ͈ o̞ k̚	저쪽
저축	t͡ɕ ɘː t͡ɕʰ u k̚	저축
저편	t͡ɕ ʌ̹ pʰ j ʌ̹ n	저편
저항	t͡ɕ ɘː ɦ a̠ ŋ	저항
저항기	t͡ɕ ʌ̹ ɦ a̠ ŋ ɡ i	저항기
저희	t͡ɕ ʌ̹ ʝ i	저히
적군	t͡ɕ ʌ̹ k̚ k͈ u n	적꾼
적극	t͡ɕ ʌ̹ k̚ k͈ ɯ k̚	적끅
적나라	t͡ɕ ʌ̹ ŋ n a̠ ɾ a̠	정나라
적당하다	t͡ɕ ʌ̹ k̚ t͈ a̠ ŋ ɦ a̠ d a̠	적땅하다
적도	t͡ɕ ʌ̹ k̚ t͈ o̞	적또
적반하장	t͡ɕ ʌ̹ k̚ p͈ a̠ n ɦ a̠ d͡ʑ a̠ ŋ	적빤하장
적분	t͡ɕ ʌ̹ k̚ p͈ u n	적뿐
적어도	t͡ɕ ɘː ɡ ʌ̹ d o̞	저거도
적외	t͡ɕ ʌ̹ ɡ w e̞	저괴
적외선	t͡ɕ ʌ̹ ɡ w e̞ sʰ ʌ̹ n	저괴선
적용	t͡ɕ ʌ̹ ɡ j o ŋ	저굥
적용되다	t͡ɕ ʌ̹ ɡ j o ŋ d w e̞ d a̠	저굥되다
적용하다	t͡ɕ ʌ̹ ɡ j o ŋ ɦ a̠ d a̠	저굥하다
적응도	t͡ɕ ʌ̹ ɡ ɯ ŋ d o̞	저긍도
적의	t͡ɕ ʌ̹ ɡ ɰ i	저긔
적자	t͡ɕ ʌ̹ k̚ t͡ɕ͈ a̠	적짜
적절하다	t͡ɕ ʌ̹ k̚ t͡ɕ͈ ʌ̹ ɾ ɦ a̠ d a̠	적쩔하다
적포도주	t͡ɕ ʌ̹ k̚ pʰ o̞ d o̞ d͡ʑ u	적포도주
전갈	t͡ɕ ʌ̹ n ɡ a̠ ɭ	전갈
전골	t͡ɕ ɘː n ɡ o̞ ɭ	전골
전공	t͡ɕ ʌ̹ n ɡ o̞ ŋ	전공
전구	t͡ɕ ɘː n ɡ u	전구
전국적	t͡ɕ ʌ̹ n ɡ u k̚ t͡ɕ͈ ʌ̹ k̚	전국쩍
전기	t͡ɕ ɘː n ɡ i	전기
전날	t͡ɕ ʌ̹ n n a̠ ɭ	전날
전도서	t͡ɕ ʌ̹ n d o̞ sʰ ʌ̹	전도서
전등	t͡ɕ ɘː n d ɯ ŋ	전등
전라남도	t͡ɕ ʌ̹ ɭ ɭ a̠ n a̠ m d o̞	절라남도
전라도	t͡ɕ ʌ̹ ɭ ɭ a̠ d o̞	절라도
전람회	t͡ɕ ɘː ɭ ɭ a̠ m β w e̞	절람회
전략가	t͡ɕ ɘː ʎ ʎ j a̠ k̚ k͈ a̠	절략까
전력	t͡ɕ ɘː ʎ ʎ j ʌ̹ k̚	절력
전례	t͡ɕ ʌ̹ ʎ ʎ j e̞	절례
전류	t͡ɕ ɘː ʎ ʎ j u	절류
전리품	t͡ɕ ɘː ʎ ʎ i pʰ u m	절리품
전무이사	t͡ɕ ʌ̹ n m u i sʰ a̠	전무이사
전문	t͡ɕ ʌ̹ n m u n	전문
전문가	t͡ɕ ʌ̹ n m u n ɡ a̠	전문가
전문일군	t͡ɕ ʌ̹ n m u n i ɭ ɡ u n	전무닐군
전문화	t͡ɕ ʌ̹ n m u n β w a̠	전문화
전반적	t͡ɕ ʌ̹ n b a̠ ɲ d͡ʑ ʌ̹ k̚	전반적
전보	t͡ɕ ɘː n b o̞	전보
전복	t͡ɕ ʌ̹ n b o̞ k̚	전복
전부	t͡ɕ ʌ̹ n b u	전부
전상장골극	t͡ɕ ʌ̹ n sʰ a̠ ŋ d͡ʑ a̠ ŋ ɡ o̞ ɭ ɡ ɯ k̚	전상장골극
전설	t͡ɕ ɘː n sʰ ʌ̹ ɭ	전설
전술	t͡ɕ ɘː n sʰ u ɭ	전술
전신	t͡ɕ ɘː n ɕʰ i n	전신
전신케블	t͡ɕ ɘː n ɕʰ i n kʰ e̞ b ɯ ɭ	전신케블
전업	t͡ɕ ʌ̹ n ʌ̹ p̚	저넙
전역	t͡ɕ ɘː ɲ j ʌ̹ k̚	저녁
전염병	t͡ɕ ʌ̹ ɲ j ʌ̹ m p͈ j ʌ̹ ŋ	저념뼝
전우	t͡ɕ ʌ̹ n u	저누
전율	t͡ɕ ɘː ɲ j u ɭ	저뉼
전율하다	t͡ɕ ɘː ɲ j u ɾ ɦ a̠ d a̠	저뉼하다
전이	t͡ɕ ɘː n i	저니
전자	t͡ɕ ɘː ɲ d͡ʑ a̠	전자
전자우편	t͡ɕ ʌ̹ ɲ d͡ʑ a̠ u pʰ j ʌ̹ n	전자우편
전장	t͡ɕ ɘː ɲ d͡ʑ a̠ ŋ	전장
전주	t͡ɕ ʌ̹ ɲ d͡ʑ u	전주
전지	t͡ɕ ɘː ɲ d͡ʑ i	전지
전진	t͡ɕ ʌ̹ ɲ d͡ʑ i n	전진
전진하다	t͡ɕ ʌ̹ ɲ d͡ʑ i n ɦ a̠ d a̠	전진하다
전차	t͡ɕ ɘː ɲ t͡ɕʰ a̠	전차
전체	t͡ɕ ʌ̹ ɲ t͡ɕʰ e̞	전체
전체주의	t͡ɕ ʌ̹ ɲ t͡ɕʰ e̞ d͡ʑ u ɰ i	전체주의
전통	t͡ɕ ʌ̹ n tʰ o̞ ŋ	전통
전투	t͡ɕ ʌ̹ n tʰ u	전투
전하	t͡ɕ ʌ̹ n ɦ a̠	전하
전하다	t͡ɕ ʌ̹ n ɦ a̠ d a̠	전하다
전학	t͡ɕ ɘː n ɦ a̠ k̚	전학
전한	t͡ɕ ʌ̹ n ɦ a̠ n	전한
전함	t͡ɕ ʌ̹ n ɦ a̠ m	전함
전혀	t͡ɕ ʌ̹ n ʝ j ʌ̹	전혀
전화기	t͡ɕ ɘː n β w a̠ ɡ i	전화기
전화번호	t͡ɕ ʌ̹ n β w a̠ b ʌ̹ n β o̞	전화번호
전환	t͡ɕ ɘː n β w a̠ n	전환
전후	t͡ɕ ʌ̹ n β u	전후
절감	t͡ɕ ʌ̹ ɭ ɡ a̠ m	절감
절다	t͡ɕ ɘː ɭ d a̠	절다
절로	t͡ɕ ʌ̹ ɭ ɭ o̞	절로
절망	t͡ɕ ʌ̹ ɭ m a̠ ŋ	절망
절반	t͡ɕ ʌ̹ ɭ b a̠ n	절반
절벽	t͡ɕ ʌ̹ ɭ b j ʌ̹ k̚	절벽
절약	t͡ɕ ʌ̹ ɾ j a̠ k̚	저략
절이다	t͡ɕ ʌ̹ ɾ i d a̠	저리다
절차	t͡ɕ ʌ̹ ʎ t͡ɕʰ a̠	절차
젊다	t͡ɕ ɘː m t͈ a̠	점따
젊은이	t͡ɕ ʌ̹ ɭ m ɯ n i	절므니
젊음	t͡ɕ ɘː ɭ m ɯ m	절믐
점검	t͡ɕ ʌ̹ m ɡ ʌ̹ m	점검
점막	t͡ɕ ɘː m m a̠ k̚	점막
점수	t͡ɕ ʌ̹ m s͈ u	점쑤
점심	t͡ɕ ɘː m ɕʰ i m	점심
점원	t͡ɕ ɘː m w ʌ̹ n	저뭔
점입가경	t͡ɕ ɘː m i p̚ k͈ a̠ ɡ j ʌ̹ ŋ	저밉까경
점점	t͡ɕ ɘː m d͡ʑ ʌ̹ m	점점
점주	t͡ɕ ʌ̹ m d͡ʑ u	점주
점줄망둑	t͡ɕ ʌ̹ m d͡ʑ u ɭ m a̠ ŋ d u k̚	점줄망둑
점차	t͡ɕ ɘː m t͡ɕʰ a̠	점차
접골	t͡ɕ ʌ̹ p̚ k͈ o̞ ɭ	접꼴
접근	t͡ɕ ʌ̹ p̚ k͈ ɯ n	접끈
접근하다	t͡ɕ ʌ̹ p̚ k͈ ɯ n ɦ a̠ d a̠	접끈하다
접미사	t͡ɕ ʌ̹ m m i sʰ a̠	점미사
접선	t͡ɕ ʌ̹ p s͈ ʌ̹ n	접썬
접속	t͡ɕ ʌ̹ p s͈ o̞ k̚	접쏙
접수처	t͡ɕ ʌ̹ p s͈ u t͡ɕʰ ʌ̹	접쑤처
접수하다	t͡ɕ ʌ̹ p s͈ u ɦ a̠ d a̠	접쑤하다
접시	t͡ɕ ʌ̹ p ɕ͈ i	접씨
접전	t͡ɕ ʌ̹ p̚ t͡ɕ͈ ʌ̹ n	접쩐
접촉	t͡ɕ ʌ̹ p̚ t͡ɕʰ o̞ k̚	접촉
젓가락질	t͡ɕ ʌ̹ t̚ k͈ a̠ ɾ a̠ k̚ t͡ɕ͈ i ɭ	젇까락찔
젓갈	t͡ɕ ʌ̹ t̚ k͈ a̠ ɭ	젇깔
정가	t͡ɕ ɘː ŋ k͈ a̠	정까
정거장	t͡ɕ ʌ̹ ŋ ɡ ʌ̹ d͡ʑ a̠ ŋ	정거장
정겹다	t͡ɕ ʌ̹ ŋ ɡ j ʌ̹ p̚ t͈ a̠	정겹따
정관사	t͡ɕ ɘː ŋ ɡ w a̠ n sʰ a̠	정관사
정교회	t͡ɕ ɘː ŋ ɡ j o β w e̞	정교회
정구	t͡ɕ ʌ̹ ŋ ɡ u	정구
정권	t͡ɕ ʌ̹ ŋ k͈ w ʌ̹ n	정꿘
정규	t͡ɕ ɘː ŋ ɡ j u	정규
정글	t͡ɕ ʌ̹ ŋ ɡ ɯ ɭ	정글
정기	t͡ɕ ɘː ŋ ɡ i	정기
정년	t͡ɕ ʌ̹ ŋ ɲ j ʌ̹ n	정년
정녕	t͡ɕ ʌ̹ ŋ ɲ j ʌ̹ ŋ	정녕
정답	t͡ɕ ɘː ŋ d a̠ p̚	정답
정답다	t͡ɕ ʌ̹ ŋ d a̠ p̚ t͈ a̠	정답따
정량	t͡ɕ ɘː ŋ ɲ j a̠ ŋ	정냥
정류장	t͡ɕ ʌ̹ ŋ ɲ j u d͡ʑ a̠ ŋ	정뉴장
정리	t͡ɕ ʌ̹ ŋ n i	정니
정말	t͡ɕ ɘː ŋ m a̠ ɭ	정말
정말로	t͡ɕ ɘː ŋ m a̠ ɭ ɭ o̞	정말로
정면	t͡ɕ ɘː ŋ m j ʌ̹ n	정면
정보	t͡ɕ ʌ̹ ŋ b o̞	정보
정부	t͡ɕ ʌ̹ ŋ b u	정부
정비	t͡ɕ ɘː ŋ b i	정비
정비공	t͡ɕ ɘː ŋ b i ɡ o̞ ŋ	정비공
정상치	t͡ɕ ɘː ŋ sʰ a̠ ŋ t͡ɕʰ i	정상치
정상회담	t͡ɕ ʌ̹ ŋ sʰ a̠ ŋ β w e̞ d a̠ m	정상회담
정서	t͡ɕ ʌ̹ ŋ sʰ ʌ̹	정서
정성	t͡ɕ ʌ̹ ŋ sʰ ʌ̹ ŋ	정성
정수	t͡ɕ ʌ̹ ŋ sʰ u	정수
정수리	t͡ɕ ʌ̹ ŋ sʰ u ɾ i	정수리
정식	t͡ɕ ɘː ŋ ɕʰ i k̚	정식
정신	t͡ɕ ʌ̹ ŋ ɕʰ i n	정신
정신병자	t͡ɕ ʌ̹ ŋ ɕʰ i n p͈ j ʌ̹ ŋ d͡ʑ a̠	정신뼝자
정신분열증	t͡ɕ ʌ̹ ŋ ɕʰ i n p u ɲ j ʌ̹ ʎ t͡ɕ͈ ɯ ŋ	정신부녈쯩
정신적	t͡ɕ ʌ̹ ŋ ɕʰ i ɲ d͡ʑ ʌ̹ k̚	정신적
정오	t͡ɕ ɘː ŋ o̞	저오
정욕	t͡ɕ ʌ̹ ŋ j o k̚	저욕
정원	t͡ɕ ʌ̹ ŋ w ʌ̹ n	저원
정월	t͡ɕ ʌ̹ ŋ w ʌ̹ ɭ	저월
정유	t͡ɕ ʌ̹ ŋ j u	저유
정육점	t͡ɕ ʌ̹ ŋ j u k̚ t͡ɕ͈ ʌ̹ m	저육쩜
정은	t͡ɕ ɘː ŋ ɯ n	저은
정음	t͡ɕ ʌ̹ ŋ ɯ m	저음
정장	t͡ɕ ɘː ŋ d͡ʑ a̠ ŋ	정장
정적분	t͡ɕ ʌ̹ ŋ d͡ʑ ʌ̹ k̚ p͈ u n	정적뿐
정전	t͡ɕ ʌ̹ ŋ d͡ʑ ʌ̹ n	정전
정제	t͡ɕ ʌ̹ ŋ d͡ʑ e̞	정제
정조	t͡ɕ ʌ̹ ŋ d͡ʑ o̞	정조
정주	t͡ɕ ɘː ŋ d͡ʑ u	정주
정지	t͡ɕ ʌ̹ ŋ d͡ʑ i	정지
정직	t͡ɕ ɘː ŋ d͡ʑ i k̚	정직
정직하다	t͡ɕ ɘː ŋ d͡ʑ i kʰ a̠ d a̠	정지카다
정치가	t͡ɕ ʌ̹ ŋ t͡ɕʰ i ɡ a̠	정치가
정치권	t͡ɕ ʌ̹ ŋ t͡ɕʰ i k͈ w ʌ̹ n	정치꿘
정치인	t͡ɕ ʌ̹ ŋ t͡ɕʰ i i n	정치인
정치판	t͡ɕ ʌ̹ ŋ t͡ɕʰ i pʰ a̠ n	정치판
정치학	t͡ɕ ʌ̹ ŋ t͡ɕʰ i ɦ a̠ k̚	정치학
정치학자	t͡ɕ ʌ̹ ŋ t͡ɕʰ i ɦ a̠ k̚ t͡ɕ͈ a̠	정치학짜
정크푸드	t͡ɕ ʌ̹ ŋ k x ɯ pʰ u d ɯ	정ㄱ흐푸드
정확하다	t͡ɕ ɘː ŋ β w a̠ kʰ a̠ d a̠	정화카다
정황	t͡ɕ ʌ̹ ŋ β w a̠ ŋ	정황
젖가공품	t͡ɕ ʌ̹ t̚ k͈ a̠ ɡ o̞ ŋ pʰ u m	젇까공품
젖꼭지	t͡ɕ ʌ̹ t̚ k͈ o̞ k̚ t͡ɕ͈ i	젇꼭찌
젖다	t͡ɕ ʌ̹ t̚ t͈ a̠	젇따
젖당못견딤증	t͡ɕ ʌ̹ t̚ t͈ a̠ ŋ m o̞ t̚ k͈ j ʌ̹ n d i m d͡ʑ ɯ ŋ	젇땅몯껸딤증
젖먹이	t͡ɕ ʌ̹ n m ʌ̹ ɡ i	전머기
젖통	t͡ɕ ʌ̹ t̚ tʰ o̞ ŋ	젇통
제거	t͡ɕ e̞ ɡ ʌ̹	제거
제거하다	t͡ɕ e̞ ɡ ʌ̹ ɦ a̠ d a̠	제거하다
제공	t͡ɕ e̞ ɡ o̞ ŋ	제공
제공하다	t͡ɕ e̞ ɡ o̞ ŋ ɦ a̠ d a̠	제공하다
제과점	t͡ɕ e̞ː ɡ w a̠ d͡ʑ ʌ̹ m	제과점
제국주의	t͡ɕ e̞ː ɡ u k̚ t͡ɕ͈ u ɰ i	제국쭈의
제기랄	t͡ɕ e̞ː ɡ i ɾ a̠ ɭ	제기랄
제기차기	t͡ɕ e̞ ɡ i t͡ɕʰ a̠ ɡ i	제기차기
제노바	t͡ɕ e̞ n o̞ b a̠	제노바
제단	t͡ɕ e̞ː d a̠ n	제단
제로	t͡ɕ e̞ ɾ o̞	제로
제명	t͡ɕ e̞ m j ʌ̹ ŋ	제명
제물	t͡ɕ e̞ m u ɭ	제물
제발	t͡ɕ e̞ː b a̠ ɭ	제발
제법	t͡ɕ e̞ b ʌ̹ p̚	제법
제복	t͡ɕ e̞ː b o̞ k̚	제복
제비	t͡ɕ e̞ː b i	제비
제사	t͡ɕ e̞ː sʰ a̠	제사
제설차	t͡ɕ e̞ sʰ ʌ̹ ʎ t͡ɕʰ a̠	제설차
제스처	t͡ɕ e̞ sʰ ɯ t͡ɕʰ ʌ̹	제스처
제시	t͡ɕ e̞ ɕʰ i	제시
제안	t͡ɕ e̞ a̠ n	제안
제안하다	t͡ɕ e̞ a̠ n ɦ a̠ d a̠	제안하다
제약	t͡ɕ e̞ː j a̠ k̚	제약
제왕	t͡ɕ e̞ː w a̠ ŋ	제왕
제우스	t͡ɕ e̞ u sʰ ɯ	제우스
제유	t͡ɕ e̞ j u	제유
제육	t͡ɕ e̞ j u k̚	제육
제의	t͡ɕ e̞ ɰ i	제의
제일	t͡ɕ e̞ː i ɭ	제일
제작	t͡ɕ e̞ː d͡ʑ a̠ k̚	제작
제작자	t͡ɕ e̞ː d͡ʑ a̠ k̚ t͡ɕ͈ a̠	제작짜
제작하다	t͡ɕ e̞ː d͡ʑ a̠ kʰ a̠ d a̠	제자카다
제조	t͡ɕ e̞ː d͡ʑ o̞	제조
제조업	t͡ɕ e̞ː d͡ʑ o̞ ʌ̹ p̚	제조업
제주	t͡ɕ e̞ː d͡ʑ u	제주
제주도	t͡ɕ e̞ː d͡ʑ u d o̞	제주도
제주말	t͡ɕ e̞ː d͡ʑ u m a̠ ɭ	제주말
제주시	t͡ɕ e̞ː d͡ʑ u ɕʰ i	제주시
제쳐놓다	t͡ɕ e̞ t͡ɕʰ ʌ̹ n o̞ tʰ a̠	제처노타
제출	t͡ɕ e̞ t͡ɕʰ u ɭ	제출
제출하다	t͡ɕ e̞ t͡ɕʰ u ɾ ɦ a̠ d a̠	제출하다
제탄	t͡ɕ e̞ː tʰ a̠ n	제탄
제트기	t͡ɕ e̞ tʰ ɯ ɡ i	제트기
제품	t͡ɕ e̞ː pʰ u m	제품
제한	t͡ɕ e̞ː ɦ a̠ n	제한
젠장	t͡ɕ e̞ː ɲ d͡ʑ a̠ ŋ	젠장
젤리	t͡ɕ e̞ ʎ ʎ i	젤리
조가비	t͡ɕ o̞ ɡ a̠ b i	조가비
조각	t͡ɕ o̞ ɡ a̠ k̚	조각
조각상	t͡ɕ o̞ ɡ a̠ k s͈ a̠ ŋ	조각쌍
조건	t͡ɕ o̞ k͈ ʌ̹ n	조껀
조계종	t͡ɕ o̞ ɡ j e̞ d͡ʑ o̞ ŋ	조계종
조국	t͡ɕ o̞ ɡ u k̚	조국
조금	t͡ɕ o̞ ɡ ɯ m	조금
조금씩	t͡ɕ o̞ ɡ ɯ m ɕ͈ i k̚	조금씩
조깅	t͡ɕ o̞ ɡ i ŋ	조깅
조끼	t͡ɕ o̞ k͈ i	조끼
조랑말	t͡ɕ o̞ ɾ a̠ ŋ m a̠ ɭ	조랑말
조롱	t͡ɕ o̞ ɾ o̞ ŋ	조롱
조롱이	t͡ɕ o̞ ɾ o̞ ŋ i	조로이
조류	t͡ɕ o̞ ɾ j u	조류
조림	t͡ɕ o̞ ɾ i m	조림
조미료	t͡ɕ o̞ m i ɾ j o	조미료
조반	t͡ɕ o̞ː b a̠ n	조반
조부모	t͡ɕ o̞ b u m o̞	조부모
조뼛	t͡ɕ o̞ p͈ j ʌ̹ t̚	조뼏
조사	t͡ɕ o̞ sʰ a̠	조사
조사하다	t͡ɕ o̞ sʰ a̠ ɦ a̠ d a̠	조사하다
조산부	t͡ɕ o̞ː sʰ a̠ n b u	조산부
조상	t͡ɕ o̞ sʰ a̠ ŋ	조상
조선말	t͡ɕ o̞ sʰ ʌ̹ n m a̠ ɭ	조선말
조선민주주의인민공화국	t͡ɕ o̞ sʰ ʌ̹ n m i ɲ d͡ʑ u d͡ʑ u ɰ i i n m i n k o̞ ŋ β w a̠ ɡ u k̚	조선민주주의인민공화국
조선어	t͡ɕ o̞ sʰ ʌ̹ n ʌ̹	조서너
조선인	t͡ɕ o̞ sʰ ʌ̹ n i n	조서닌
조성	t͡ɕ o̞ sʰ ʌ̹ ŋ	조성
조세	t͡ɕ o̞ sʰ e̞	조세
조수	t͡ɕ o̞ː sʰ u	조수
조식	t͡ɕ o̞ ɕʰ i k̚	조식
조심	t͡ɕ o̞ː ɕʰ i m	조심
조어	t͡ɕ o̞ ʌ̹	조어
조예	t͡ɕ o̞ j e̞	조예
조용	t͡ɕ o̞ j o ŋ	조용
조용하다	t͡ɕ o̞ j o ŋ ɦ a̠ d a̠	조용하다
조용히	t͡ɕ o̞ j o ŋ ʝ i	조용히
조우	t͡ɕ o̞ u	조우
조의	t͡ɕ o̞ ɰ i	조의
조이다	t͡ɕ o̞ i d a̠	조이다
조작	t͡ɕ o̞ː d͡ʑ a̠ k̚	조작
조절	t͡ɕ o̞ d͡ʑ ʌ̹ ɭ	조절
조종사	t͡ɕ o̞ d͡ʑ o̞ ŋ sʰ a̠	조종사
조지아	t͡ɕ o̞ d͡ʑ i a̠	조지아
조지아어	t͡ɕ o̞ d͡ʑ i a̠ ʌ̹	조지아어
조지타운	t͡ɕ o̞ d͡ʑ i tʰ a̠ u n	조지타운
조직	t͡ɕ o̞ d͡ʑ i k̚	조직
조짐	t͡ɕ o̞ d͡ʑ i m	조짐
조차	t͡ɕ o̞ t͡ɕʰ a̠	조차
조치	t͡ɕ o̞ t͡ɕʰ i	조치
조카	t͡ɕ o̞ kʰ a̠	조카
조피볼락	t͡ɕ o̞ pʰ i b o̞ ɭ ɭ a̠ k̚	조피볼락
조합	t͡ɕ o̞ ɦ a̠ p̚	조합
조현병	t͡ɕ o̞ ʝ j ʌ̹ n b j ʌ̹ ŋ	조현병
조회	t͡ɕ o̞ː β w e̞	조회
존경	t͡ɕ o̞ n ɡ j ʌ̹ ŋ	존경
존맛	t͡ɕ o̞ n m a̠ t̚	존맏
존엄사	t͡ɕ o̞ n ʌ̹ m sʰ a̠	조넘사
존중	t͡ɕ o̞ ɲ d͡ʑ u ŋ	존중
존중하다	t͡ɕ o̞ ɲ d͡ʑ u ŋ ɦ a̠ d a̠	존중하다
졸다	t͡ɕ o̞ː ɭ d a̠	졸다
졸업식	t͡ɕ o̞ ɾ ʌ̹ p ɕ͈ i k̚	조럽씩
졸음	t͡ɕ o̞ ɾ ɯ m	조름
졸혼	t͡ɕ o̞ ɾ β o̞ n	졸혼
좀비	t͡ɕ o̞ m b i	좀비
좀수수치	t͡ɕ o̞ m sʰ u sʰ u t͡ɕʰ i	좀수수치
좀처럼	t͡ɕ o̞ː m t͡ɕʰ ʌ̹ ɾ ʌ̹ m	좀처럼
좁다	t͡ɕ o̞ p̚ t͈ a̠	좁따
종교	t͡ɕ o̞ ŋ ɡ j o	종교
종로	t͡ɕ o̞ ŋ n o̞	종노
종료	t͡ɕ o̞ ŋ ɲ j o	종뇨
종류	t͡ɕ o̞ː ŋ ɲ j u	종뉴
종식	t͡ɕ o̞ ŋ ɕʰ i k̚	종식
종아리뼈	t͡ɕ o̞ː ŋ a̠ ɾ i p͈ j ʌ̹	조아리뼈
종양	t͡ɕ o̞ː ŋ j a̠ ŋ	조양
종업원	t͡ɕ o̞ ŋ ʌ̹ b w ʌ̹ n	조어붠
종유석	t͡ɕ o̞ ŋ j u sʰ ʌ̹ k̚	조유석
종이	t͡ɕ o̞ ŋ i	조이
종일	t͡ɕ o̞ ŋ i ɭ	조일
종자	t͡ɕ o̞ ŋ d͡ʑ a̠	종자
종족	t͡ɕ o̞ ŋ d͡ʑ o̞ k̚	종족
종종	t͡ɕ o̞ː ŋ d͡ʑ o̞ ŋ	종종
종파	t͡ɕ o̞ ŋ pʰ a̠	종파
종합	t͡ɕ o̞ ŋ ɦ a̠ p̚	종합
종횡	t͡ɕ o̞ ŋ β w e̞ ŋ	종횡
좇다	t͡ɕ o̞ t̚ t͈ a̠	졷따
좋다	t͡ɕ o̞ː tʰ a̠	조타
좋아지다	t͡ɕ o̞ː a̠ d͡ʑ i d a̠	조아지다
좋아하다	t͡ɕ o̞ː a̠ ɦ a̠ d a̠	조아하다
좌석	t͡ɕ w a̠ sʰ ʌ̹ k̚	좌석
좌우	t͡ɕ w a̠ː u	좌우
좌익수	t͡ɕ w a̠ː i k s͈ u	좌익쑤
좌표	t͡ɕ w a̠ː pʰ j o	좌표
죄다	t͡ɕ w e̞ː d a̠	죄다
죄송	t͡ɕ w e̞ː sʰ o̞ ŋ	죄송
죄송하다	t͡ɕ w e̞ː sʰ o̞ ŋ ɦ a̠ d a̠	죄송하다
죄수	t͡ɕ w e̞ sʰ u	죄수
죄악	t͡ɕ w e̞ː a̠ k̚	죄악
죄인	t͡ɕ w e̞ː i n	죄인
주거	t͡ɕ uː ɡ ʌ̹	주거
주고받다	t͡ɕ u ɡ o̞ b a̠ t̚ t͈ a̠	주고받따
주교	t͡ɕ u ɡ j o	주교
주교관	t͡ɕ u ɡ j o ɡ w a̠ n	주교관
주꾸미	t͡ɕ u k͈ u m i	주꾸미
주다	t͡ɕ u d a̠	주다
주도	t͡ɕ u d o̞	주도
주둔	t͡ɕ uː d u n	주둔
주로	t͡ɕ u ɾ o̞	주로
주류	t͡ɕ u ɾ j u	주류
주막	t͡ɕ u m a̠ k̚	주막
주말	t͡ɕ u m a̠ ɭ	주말
주머니	t͡ɕ u m ʌ̹ n i	주머니
주먹	t͡ɕ u m ʌ̹ k̚	주먹
주무르다	t͡ɕ u m u ɾ ɯ d a̠	주무르다
주무시다	t͡ɕ u m u ɕʰ i d a̠	주무시다
주문	t͡ɕ uː m u n	주문
주민	t͡ɕ uː m i n	주민
주방	t͡ɕ u b a̠ ŋ	주방
주방장	t͡ɕ u b a̠ ŋ d͡ʑ a̠ ŋ	주방장
주사	t͡ɕ uː sʰ a̠	주사
주사기	t͡ɕ uː sʰ a̠ ɡ i	주사기
주석	t͡ɕ u sʰ ʌ̹ k̚	주석
주소	t͡ɕ uː sʰ o̞	주소
주스	t͡ɕ u sʰ ɯ	주스
주식	t͡ɕ u ɕʰ i k̚	주식
주식회사	t͡ɕ u ɕʰ i kʰ w e̞ sʰ a̠	주시쾨사
주어	t͡ɕ u ʌ̹	주어
주연	t͡ɕ u j ʌ̹ n	주연
주요하다	t͡ɕ u j o ɦ a̠ d a̠	주요하다
주위	t͡ɕ u ɥ i	주위
주유소	t͡ɕ uː j u sʰ o̞	주유소
주인	t͡ɕ u i n	주인
주인공	t͡ɕ u i n ɡ o̞ ŋ	주인공
주장	t͡ɕ u d͡ʑ a̠ ŋ	주장
주장하다	t͡ɕ u d͡ʑ a̠ ŋ ɦ a̠ d a̠	주장하다
주저	t͡ɕ u d͡ʑ ʌ̹	주저
주전자	t͡ɕ u d͡ʑ ʌ̹ ɲ d͡ʑ a̠	주전자
주정	t͡ɕ uː d͡ʑ ʌ̹ ŋ	주정
주제	t͡ɕ u d͡ʑ e̞	주제
주중	t͡ɕ u d͡ʑ u ŋ	주중
주차	t͡ɕ uː t͡ɕʰ a̠	주차
주차장	t͡ɕ uː t͡ɕʰ a̠ d͡ʑ a̠ ŋ	주차장
주체	t͡ɕ u t͡ɕʰ e̞	주체
주체사상	t͡ɕ u t͡ɕʰ e̞ sʰ a̠ sʰ a̠ ŋ	주체사상
죽마고우	t͡ɕ u ŋ m a̠ ɡ o̞ u	중마고우
죽부인	t͡ɕ u k̚ p͈ u i n	죽뿌인
죽순	t͡ɕ u k s͈ u n	죽쑨
죽음	t͡ɕ u ɡ ɯ m	주금
죽지	t͡ɕ u k̚ t͡ɕ͈ i	죽찌
준말	t͡ɕ uː n m a̠ ɭ	준말
준비	t͡ɕ uː n b i	준비
준비하다	t͡ɕ uː n b i ɦ a̠ d a̠	준비하다
줄곧	t͡ɕ u ɭ ɡ o̞ t̚	줄곧
줄공치	t͡ɕ u ɭ ɡ o̞ ŋ t͡ɕʰ i	줄공치
줄기	t͡ɕ u ɭ ɡ i	줄기
줄다	t͡ɕ uː ɭ d a̠	줄다
줄어들다	t͡ɕ u ɾ ʌ̹ d ɯ ɭ d a̠	주러들다
줄이다	t͡ɕ u ɾ i d a̠	주리다
줍다	t͡ɕ uː p̚ t͈ a̠	줍따
중간	t͡ɕ u ŋ ɡ a̠ n	중간
중견수	t͡ɕ u ŋ ɡ j ʌ̹ n sʰ u	중견수
중경	t͡ɕ u ŋ ɡ j ʌ̹ ŋ	중경
중계	t͡ɕ u ŋ ɡ j e̞	중계
중고기	t͡ɕ uː ŋ ɡ o̞ ɡ i	중고기
중공	t͡ɕ u ŋ ɡ o̞ ŋ	중공
중국어	t͡ɕ u ŋ ɡ u ɡ ʌ̹	중구거
중국인	t͡ɕ u ŋ ɡ u ɡ i n	중구긴
중국학	t͡ɕ u ŋ ɡ u kʰ a̠ k̚	중구칵
중국화	t͡ɕ u ŋ ɡ u kʰ w a̠	중구콰
중년	t͡ɕ u ŋ ɲ j ʌ̹ n	중년
중도	t͡ɕ u ŋ d o̞	중도
중독	t͡ɕ u ŋ d o̞ k̚	중독
중량	t͡ɕ uː ŋ ɲ j a̠ ŋ	중냥
중립	t͡ɕ u ŋ n i p̚	중닙
중문	t͡ɕ u ŋ m u n	중문
중부	t͡ɕ u ŋ b u	중부
중사	t͡ɕ u ŋ sʰ a̠	중사
중성	t͡ɕ u ŋ sʰ ʌ̹ ŋ	중성
중성자	t͡ɕ u ŋ sʰ ʌ̹ ŋ d͡ʑ a̠	중성자
중세	t͡ɕ u ŋ sʰ e̞	중세
중심	t͡ɕ u ŋ ɕʰ i m	중심
중앙	t͡ɕ u ŋ a̠ ŋ	주앙
중앙아메리카	t͡ɕ u ŋ a̠ ŋ a̠ m e̞ ɾ i kʰ a̠	주아아메리카
중요	t͡ɕ uː ŋ j o	주요
중요성	t͡ɕ uː ŋ j o s͈ ʌ̹ ŋ	주요썽
중요하다	t͡ɕ uː ŋ j o ɦ a̠ d a̠	주요하다
중위	t͡ɕ u ŋ ɥ i	주위
중죄	t͡ɕ uː ŋ d͡ʑ w e̞	중죄
중증	t͡ɕ uː ŋ t͡ɕ͈ ɯ ŋ	중쯩
중지	t͡ɕ u ŋ d͡ʑ i	중지
중징계	t͡ɕ uː ŋ d͡ʑ i ŋ ɡ j e̞	중징계
중학교	t͡ɕ u ŋ ɦ a̠ k̚ k͈ j o	중학꾜
중화	t͡ɕ u ŋ β w a̠	중화
중화민국	t͡ɕ u ŋ β w a̠ m i n ɡ u k̚	중화민국
쥐창시	t͡ɕ ɥ i t͡ɕʰ a̠ ŋ ɕʰ i	쥐창시
즉시	t͡ɕ ɯ k ɕ͈ i	즉씨
즐거움	t͡ɕ ɯ ɭ ɡ ʌ̹ u m	즐거움
즐겁다	t͡ɕ ɯ ɭ ɡ ʌ̹ p̚ t͈ a̠	즐겁따
증가	t͡ɕ ɯ ŋ ɡ a̠	증가
증가하다	t͡ɕ ɯ ŋ ɡ a̠ ɦ a̠ d a̠	증가하다
증거	t͡ɕ ɯ ŋ ɡ ʌ̹	증거
증권사	t͡ɕ ɯ ŋ k͈ w ʌ̹ n sʰ a̠	증꿘사
증기	t͡ɕ ɯ ŋ ɡ i	증기
증명	t͡ɕ ɯ ŋ m j ʌ̹ ŋ	증명
증명하다	t͡ɕ ɯ ŋ m j ʌ̹ ŋ ɦ a̠ d a̠	증명하다
증상	t͡ɕ ɯ ŋ sʰ a̠ ŋ	증상
증설	t͡ɕ ɯ ŋ sʰ ʌ̹ ɭ	증설
증설하다	t͡ɕ ɯ ŋ sʰ ʌ̹ ɾ ɦ a̠ d a̠	증설하다
증언	t͡ɕ ɯ ŋ ʌ̹ n	즈언
증여	t͡ɕ ɯ ŋ j ʌ̹	즈여
증오	t͡ɕ ɯ ŋ o̞	즈오
증오심	t͡ɕ ɯ ŋ o̞ ɕʰ i m	즈오심
증인	t͡ɕ ɯ ŋ i n	즈인
증조	t͡ɕ ɯ ŋ d͡ʑ o̞	증조
증조부	t͡ɕ ɯ ŋ d͡ʑ o̞ b u	증조부
증진하다	t͡ɕ ɯ ŋ d͡ʑ i n ɦ a̠ d a̠	증진하다
증후군	t͡ɕ ɯ ŋ β u ɡ u n	증후군
지각	t͡ɕ i ɡ a̠ k̚	지각
지갑	t͡ɕ i ɡ a̠ p̚	지갑
지게미	t͡ɕ i ɡ e̞ m i	지게미
지겹다	t͡ɕ i ɡ j ʌ̹ p̚ t͈ a̠	지겹따
지경	t͡ɕ i ɡ j ʌ̹ ŋ	지경
지구	t͡ɕ i ɡ u	지구
지구의	t͡ɕ i ɡ u ɰ i	지구의
지국	t͡ɕ i ɡ u k̚	지국
지금	t͡ɕ i ɡ ɯ m	지금
지긋하다	t͡ɕ i ɡ ɯ tʰ a̠ d a̠	지그타다
지껄이다	t͡ɕ i k͈ ʌ̹ ɾ i d a̠	지꺼리다
지나	t͡ɕ i n a̠	지나
지나다	t͡ɕ i n a̠ d a̠	지나다
지나치다	t͡ɕ i n a̠ t͡ɕʰ i d a̠	지나치다
지난	t͡ɕ i n a̠ n	지난
지난번	t͡ɕ i n a̠ n b ʌ̹ n	지난번
지난주	t͡ɕ i n a̠ ɲ d͡ʑ u	지난주
지니다	t͡ɕ i n i d a̠	지니다
지다	t͡ɕ i d a̠	지다
지도자	t͡ɕ i d o̞ d͡ʑ a̠	지도자
지랄하다	t͡ɕ i ɾ a̠ ɾ ɦ a̠ d a̠	지랄하다
지렁이	t͡ɕ i ɾ ʌ̹ ŋ i	지러이
지뢰	t͡ɕ i ɾ w e̞	지뢰
지루하다	t͡ɕ i ɾ u ɦ a̠ d a̠	지루하다
지류	t͡ɕ i ɾ j u	지류
지르코늄	t͡ɕ i ɾ ɯ kʰ o̞ ɲ j u m	지르코늄
지름	t͡ɕ i ɾ ɯ m	지름
지름길	t͡ɕ i ɾ ɯ m ɡ i ɭ	지름길
지리산	t͡ɕ i ɾ i sʰ a̠ n	지리산
지리학	t͡ɕ i ɾ i ɦ a̠ k̚	지리학
지린	t͡ɕ i ɾ i n	지린
지만	t͡ɕ i m a̠ n	지만
지면	t͡ɕ i m j ʌ̹ n	지면
지방	t͡ɕ i b a̠ ŋ	지방
지방산	t͡ɕ i b a̠ ŋ sʰ a̠ n	지방산
지복직관	t͡ɕ iː b o̞ k̚ t͡ɕ͈ i k̚ k͈ w a̠ n	지복찍꽌
지불	t͡ɕ i b u ɭ	지불
지붕	t͡ɕ i b u ŋ	지붕
지속적	t͡ɕ i sʰ o̞ k̚ t͡ɕ͈ ʌ̹ k̚	지속쩍
지시하다	t͡ɕ i ɕʰ i ɦ a̠ d a̠	지시하다
지식	t͡ɕ i ɕʰ i k̚	지식
지식인	t͡ɕ i ɕʰ i ɡ i n	지시긴
지압	t͡ɕ i a̠ p̚	지압
지역	t͡ɕ i j ʌ̹ k̚	지역
지역사회	t͡ɕ i j ʌ̹ k s͈ a̠ β w e̞	지역싸회
지옥	t͡ɕ i o̞ k̚	지옥
지우다	t͡ɕ i u d a̠	지우다
지원	t͡ɕ i w ʌ̹ n	지원
지원자	t͡ɕ i w ʌ̹ ɲ d͡ʑ a̠	지원자
지위	t͡ɕ i ɥ i	지위
지은이	t͡ɕ i ɯ n i	지으니
지저분하다	t͡ɕ i d͡ʑ ʌ̹ b u n ɦ a̠ d a̠	지저분하다
지적하다	t͡ɕ i d͡ʑ ʌ̹ kʰ a̠ d a̠	지저카다
지점	t͡ɕ i d͡ʑ ʌ̹ m	지점
지정학	t͡ɕ i d͡ʑ ʌ̹ ŋ ɦ a̠ k̚	지정학
지줌	t͡ɕ i d͡ʑ u m	지줌
지지	t͡ɕ i d͡ʑ i	지지
지진	t͡ɕ i d͡ʑ i n	지진
지질	t͡ɕ i d͡ʑ i ɭ	지질
지출	t͡ɕ i t͡ɕʰ u ɭ	지출
지치다	t͡ɕ iː t͡ɕʰ i d a̠	지치다
지칭하다	t͡ɕ i t͡ɕʰ i ŋ ɦ a̠ d a̠	지칭하다
지팡이	t͡ɕ i pʰ a̠ ŋ i	지파이
지폐	t͡ɕ i pʰ j e̞	지폐
지푸라기	t͡ɕ i pʰ u ɾ a̠ ɡ i	지푸라기
지하	t͡ɕ i ɦ a̠	지하
지하도	t͡ɕ i ɦ a̠ d o̞	지하도
지하드	t͡ɕ i ɦ a̠ d ɯ	지하드
지하실	t͡ɕ i ɦ a̠ ɕʰ i ɭ	지하실
지하철	t͡ɕ i ɦ a̠ t͡ɕʰ ʌ̹ ɭ	지하철
지하철역	t͡ɕ i ɦ a̠ t͡ɕʰ ʌ̹ ɾ j ʌ̹ k̚	지하처력
지혈	t͡ɕ i ʝ j ʌ̹ ɭ	지혈
지협	t͡ɕ i ʝ j ʌ̹ p̚	지협
지혜	t͡ɕ i ʝ j e̞	지혜
지휘자	t͡ɕ i ɦ ɥ i d͡ʑ a̠	지휘자
직감	t͡ɕ i k̚ k͈ a̠ m	직깜
직관	t͡ɕ i k̚ k͈ w a̠ n	직꽌
직기	t͡ɕ i k̚ k͈ i	직끼
직원	t͡ɕ i ɡ w ʌ̹ n	지권
직위	t͡ɕ i ɡ ɥ i	지귀
직전	t͡ɕ i k̚ t͡ɕ͈ ʌ̹ n	직쩐
직접	t͡ɕ i k̚ t͡ɕ͈ ʌ̹ p̚	직쩝
직접적	t͡ɕ i k̚ t͡ɕ͈ ʌ̹ p̚ t͡ɕ͈ ʌ̹ k̚	직쩝쩍
직후	t͡ɕ i kʰ u	지쿠
진공청소기	t͡ɕ i n ɡ o̞ ŋ t͡ɕʰ ʌ̹ ŋ sʰ o̞ ɡ i	진공청소기
진단	t͡ɕ iː n d a̠ n	진단
진동	t͡ɕ i n d o̞ ŋ	진동
진동수	t͡ɕ i n d o̞ ŋ sʰ u	진동수
진료소	t͡ɕ iː ʎ ʎ j o sʰ o̞	질료소
진루	t͡ɕ iː ɭ ɭ u	질루
진리	t͡ɕ i ʎ ʎ i	질리
진보	t͡ɕ iː n b o̞	진보
진부하다	t͡ɕ i n b u ɦ a̠ d a̠	진부하다
진실	t͡ɕ i n ɕʰ i ɭ	진실
진실하다	t͡ɕ i n ɕʰ i ɾ ɦ a̠ d a̠	진실하다
진압	t͡ɕ iː n a̠ p̚	지납
진열장	t͡ɕ iː ɲ j ʌ̹ ʎ d͡ʑ a̠ ŋ	지녈장
진주	t͡ɕ i ɲ d͡ʑ u	진주
진지	t͡ɕ iː ɲ d͡ʑ i	진지
진지하다	t͡ɕ i ɲ d͡ʑ i ɦ a̠ d a̠	진지하다
진짜	t͡ɕ i ɲ t͡ɕ͈ a̠	진짜
진출	t͡ɕ iː ɲ t͡ɕʰ u ɭ	진출
진한	t͡ɕ i n ɦ a̠ n	진한
진화	t͡ɕ i n β w a̠	진화
진흙	t͡ɕ i n ɣ ɯ k̚	진ɣㅡㄱ
질녀	t͡ɕ i ʎ ʎ j ʌ̹	질려
질량	t͡ɕ i ʎ ʎ j a̠ ŋ	질량
질리다	t͡ɕ i ʎ ʎ i d a̠	질리다
질문	t͡ɕ i ɭ m u n	질문
질문하다	t͡ɕ i ɭ m u n ɦ a̠ d a̠	질문하다
질병	t͡ɕ i ɭ b j ʌ̹ ŋ	질병
질서	t͡ɕ i ɭ s͈ ʌ̹	질써
질소	t͡ɕ i ɭ sʰ o̞	질소
질타	t͡ɕ i ɭ tʰ a̠	질타
질투	t͡ɕ i ɭ tʰ u	질투
질풍노도	t͡ɕ i ɭ pʰ u ŋ n o̞ d o̞	질풍노도
짊다	t͡ɕ i m t͈ a̠	짐따
짐바브웨	t͡ɕ i m b a̠ b ɯ w e̞	짐바브웨
짐승	t͡ɕ i m sʰ ɯ ŋ	짐승
짐작	t͡ɕ i m d͡ʑ a̠ k̚	짐작
집게	t͡ɕ i p̚ k͈ e̞	집께
집결	t͡ɕ i p̚ k͈ j ʌ̹ ɭ	집껼
집계	t͡ɕ i p̚ k͈ j e̞	집꼐
집권당	t͡ɕ i p̚ k͈ w ʌ̹ n d a̠ ŋ	집꿘당
집다	t͡ɕ i p̚ t͈ a̠	집따
집단화	t͡ɕ i p̚ t͈ a̠ n β w a̠	집딴화
집들	t͡ɕ i p̚ t͈ ɯ ɭ	집뜰
집박쥐	t͡ɕ i p̚ p͈ a̠ k̚ t͡ɕ͈ ɥ i	집빡쮜
집사	t͡ɕ i p s͈ a̠	집싸
집사람	t͡ɕ i p s͈ a̠ ɾ a̠ m	집싸람
집안	t͡ɕ i b a̠ n	지반
집어넣다	t͡ɕ i b ʌ̹ n ʌ̹ tʰ a̠	지버너타
집중	t͡ɕ i p̚ t͡ɕ͈ u ŋ	집쭝
집중되다	t͡ɕ i p̚ t͡ɕ͈ u ŋ d w e̞ d a̠	집쭝되다
집쥐	t͡ɕ i p̚ t͡ɕ͈ ɥ i	집쮜
집토끼	t͡ɕ i p̚ tʰ o̞ k͈ i	집토끼
집필	t͡ɕ i p̚ pʰ i ɭ	집필
집합	t͡ɕ i pʰ a̠ p̚	지팝
집회	t͡ɕ i pʰ w e̞	지푀
짓다	t͡ɕ iː t̚ t͈ a̠	짇따
징계	t͡ɕ i ŋ ɡ j e̞	징계
징병	t͡ɕ i ŋ b j ʌ̹ ŋ	징병
짙다	t͡ɕ i t̚ t͈ a̠	짇따
짙푸르다	t͡ɕ i t̚ pʰ u ɾ ɯ d a̠	짇푸르다
짚다	t͡ɕ i p̚ t͈ a̠	집따
짜다	t͡ɕ͈ a̠ d a̠	짜다
짜리	t͡ɕ͈ a̠ ɾ i	짜리
짜릿하다	t͡ɕ͈ a̠ ɾ i tʰ a̠ d a̠	짜리타다
짜장면	t͡ɕ͈ a̠ d͡ʑ a̠ ŋ m j ʌ̹ n	짜장면
짜하다	t͡ɕ͈ a̠ː ɦ a̠ d a̠	짜하다
짝사랑	t͡ɕ͈ a̠ k s͈ a̠ ɾ a̠ ŋ	짝싸랑
짝짓기	t͡ɕ͈ a̠ k̚ t͡ɕ͈ i t̚ k͈ i	짝찓끼
짠하다	t͡ɕ͈ a̠ː n ɦ a̠ d a̠	짠하다
짧다	t͡ɕ͈ a̠ ɭ t͈ a̠	짤따
짬뽕	t͡ɕ͈ a̠ m p͈ o̞ ŋ	짬뽕
짭짤하다	t͡ɕ͈ a̠ p̚ t͡ɕ͈ a̠ ɾ ɦ a̠ d a̠	짭짤하다
쩨마	t͡ɕ͈ e̞ m a̠	쩨마
쪼다	t͡ɕ͈ o̞ d a̠	쪼다
쪽발이	t͡ɕ͈ o̞ k̚ p͈ a̠ ɾ i	쪽빠리
쫄면	t͡ɕ͈ o̞ ɭ m j ʌ̹ n	쫄면
쫓기다	t͡ɕ͈ o̞ t̚ k͈ i d a̠	쫃끼다
쫓다	t͡ɕ͈ o̞ t̚ t͈ a̠	쫃따
쯔놈	t͡ɕ͈ ɯ n o̞ m	쯔놈
찌꺼기	t͡ɕ͈ i k͈ ʌ̹ ɡ i	찌꺼기
찌르다	t͡ɕ͈ i ɾ ɯ d a̠	찌르다
찌창	t͡ɕ͈ i t͡ɕʰ a̠ ŋ	찌창
찍소리	t͡ɕ͈ i k s͈ o̞ ɾ i	찍쏘리
찐만두	t͡ɕ͈ i n m a̠ n d u	찐만두
찐빵	t͡ɕ͈ i n p͈ a̠ ŋ	찐빵
찜질방	t͡ɕ͈ i m d͡ʑ i ɭ b a̠ ŋ	찜질방
차갑다	t͡ɕʰ a̠ ɡ a̠ p̚ t͈ a̠	차갑따
차고	t͡ɕʰ a̠ ɡ o̞	차고
차단	t͡ɕʰ a̠ː d a̠ n	차단
차드	t͡ɕʰ a̠ d ɯ	차드
차라리	t͡ɕʰ a̠ ɾ a̠ ɾ i	차라리
차량	t͡ɕʰ a̠ ɾ j a̠ ŋ	차량
차례	t͡ɕʰ a̠ ɾ j e̞	차례
차림	t͡ɕʰ a̠ ɾ i m	차림
차림표	t͡ɕʰ a̠ ɾ i m pʰ j o	차림표
차마	t͡ɕʰ a̠ m a̠	차마
차마당	t͡ɕʰ a̠ m a̠ d a̠ ŋ	차마당
차별	t͡ɕʰ a̠ b j ʌ̹ ɭ	차별
차이	t͡ɕʰ a̠ i	차이
차이나타운	t͡ɕʰ a̠ i n a̠ tʰ a̠ u n	차이나타운
차이니스	t͡ɕʰ a̠ i n i sʰ ɯ	차이니스
차이다	t͡ɕʰ a̠ i d a̠	차이다
차장	t͡ɕʰ a̠ d͡ʑ a̠ ŋ	차장
차지하다	t͡ɕʰ a̠ d͡ʑ i ɦ a̠ d a̠	차지하다
차질	t͡ɕʰ a̠ d͡ʑ i ɭ	차질
차츰	t͡ɕʰ a̠ t͡ɕʰ ɯ m	차츰
차트	t͡ɕʰ a̠ tʰ ɯ	차트
착각	t͡ɕʰ a̠ k̚ k͈ a̠ k̚	착깍
착공	t͡ɕʰ a̠ k̚ k͈ o̞ ŋ	착꽁
착석	t͡ɕʰ a̠ k s͈ ʌ̹ k̚	착썩
착용하다	t͡ɕʰ a̠ ɡ j o ŋ ɦ a̠ d a̠	차굥하다
착하다	t͡ɕʰ a̠ kʰ a̠ d a̠	차카다
찬가	t͡ɕʰ a̠ː n ɡ a̠	찬가
찬사	t͡ɕʰ a̠ː n sʰ a̠	찬사
찬스	t͡ɕʰ a̠ n sʰ ɯ	찬스
찬장	t͡ɕʰ a̠ː ɲ d͡ʑ a̠ ŋ	찬장
찰나	t͡ɕʰ a̠ ɭ ɭ a̠	찰라
찰스	t͡ɕʰ a̠ ɭ sʰ ɯ	찰스
찰흙	t͡ɕʰ a̠ ɾ ɣ ɯ k̚	찰ɣㅡㄱ
참가자	t͡ɕʰ a̠ m ɡ a̠ d͡ʑ a̠	참가자
참고	t͡ɕʰ a̠ m ɡ o̞	참고
참기름	t͡ɕʰ a̠ m ɡ i ɾ ɯ m	참기름
참다	t͡ɕʰ a̠ː m t͈ a̠	참따
참되다	t͡ɕʰ a̠ m t͈ w e̞ d a̠	참뙤다
참말	t͡ɕʰ a̠ m m a̠ ɭ	참말
참모장	t͡ɕʰ a̠ː m m o̞ d͡ʑ a̠ ŋ	참모장
참붕어	t͡ɕʰ a̠ m b u ŋ ʌ̹	참부어
참사	t͡ɕʰ a̠ m sʰ a̠	참사
참석하다	t͡ɕʰ a̠ m sʰ ʌ̹ kʰ a̠ d a̠	참서카다
참수리	t͡ɕʰ a̠ m sʰ u ɾ i	참수리
참여	t͡ɕʰ a̠ m j ʌ̹	차며
참외	t͡ɕʰ a̠ m w e̞	차뫼
참을성	t͡ɕʰ a̠ m ɯ ɭ sʰ ʌ̹ ŋ	차믈성
참전	t͡ɕʰ a̠ m d͡ʑ ʌ̹ n	참전
참조하다	t͡ɕʰ a̠ m d͡ʑ o̞ ɦ a̠ d a̠	참조하다
참중고기	t͡ɕʰ a̠ m d͡ʑ u ŋ ɡ o̞ ɡ i	참중고기
참회	t͡ɕʰ a̠ m β w e̞	참회
찻집	t͡ɕʰ a̠ t̚ t͡ɕ͈ i p̚	찯찝
창궐	t͡ɕʰ a̠ ŋ ɡ w ʌ̹ ɭ	창궐
창문	t͡ɕʰ a̠ ŋ m u n	창문
창설	t͡ɕʰ a̠ː ŋ sʰ ʌ̹ ɭ	창설
창세기	t͡ɕʰ a̠ː ŋ sʰ e̞ ɡ i	창세기
창업	t͡ɕʰ a̠ː ŋ ʌ̹ p̚	차업
창원	t͡ɕʰ a̠ ŋ w ʌ̹ n	차원
창자	t͡ɕʰ a̠ ŋ d͡ʑ a̠	창자
창작	t͡ɕʰ a̠ ŋ d͡ʑ a̠ k̚	창작
창제	t͡ɕʰ a̠ː ŋ d͡ʑ e̞	창제
창조	t͡ɕʰ a̠ː ŋ d͡ʑ o̞	창조
창조자	t͡ɕʰ a̠ː ŋ d͡ʑ o̞ d͡ʑ a̠	창조자
창조적	t͡ɕʰ a̠ː ŋ d͡ʑ o̞ d͡ʑ ʌ̹ k̚	창조적
창조하다	t͡ɕʰ a̠ː ŋ d͡ʑ o̞ ɦ a̠ d a̠	창조하다
창턱	t͡ɕʰ a̠ ŋ tʰ ʌ̹ k̚	창턱
찾다	t͡ɕʰ a̠ t̚ t͈ a̠	찯따
찾아가다	t͡ɕʰ a̠ d͡ʑ a̠ ɡ a̠ d a̠	차자가다
찾아보다	t͡ɕʰ a̠ d͡ʑ a̠ b o̞ d a̠	차자보다
찾아오다	t͡ɕʰ a̠ d͡ʑ a̠ o̞ d a̠	차자오다
채소	t͡ɕʰ ɛː sʰ o̞	채소
채소밭	t͡ɕʰ ɛː sʰ o̞ b a̠ t̚	채소받
채식주의	t͡ɕʰ ɛː ɕʰ i k̚ t͡ɕ͈ u ɰ i	채식쭈의
채식주의자	t͡ɕʰ ɛː ɕʰ i k̚ t͡ɕ͈ u ɰ i d͡ʑ a̠	채식쭈의자
채용하다	t͡ɕʰ ɛː j o ŋ ɦ a̠ d a̠	채용하다
처가	t͡ɕʰ ʌ̹ ɡ a̠	처가
처남	t͡ɕʰ ʌ̹ n a̠ m	처남
처녀	t͡ɕʰ ɘː ɲ j ʌ̹	처녀
처녀막	t͡ɕʰ ɘː ɲ j ʌ̹ m a̠ k̚	처녀막
처럼	t͡ɕʰ ʌ̹ ɾ ʌ̹ m	처럼
처리	t͡ɕʰ ɘː ɾ i	처리
처방	t͡ɕʰ ʌ̹ b a̠ ŋ	처방
처방전	t͡ɕʰ ɘː b a̠ ŋ d͡ʑ ʌ̹ n	처방전
처벌	t͡ɕʰ ɘː b ʌ̹ ɭ	처벌
처신	t͡ɕʰ ɘː ɕʰ i n	처신
처음	t͡ɕʰ ʌ̹ ɯ m	처음
처지	t͡ɕʰ ɘː d͡ʑ i	처지
척결	t͡ɕʰ ʌ̹ k̚ k͈ j ʌ̹ ɭ	척껼
척수	t͡ɕʰ ʌ̹ k s͈ u	척쑤
척추	t͡ɕʰ ʌ̹ k̚ t͡ɕʰ u	척추
척추동물	t͡ɕʰ ʌ̹ k̚ t͡ɕʰ u d o̞ ŋ m u ɭ	척추동물
천국	t͡ɕʰ ʌ̹ n ɡ u k̚	천국
천당	t͡ɕʰ ʌ̹ n d a̠ ŋ	천당
천도	t͡ɕʰ ɘː n d o̞	천도
천둥	t͡ɕʰ ʌ̹ n d u ŋ	천둥
천리마	t͡ɕʰ ʌ̹ ʎ ʎ i m a̠	철리마
천리안	t͡ɕʰ ʌ̹ ʎ ʎ i a̠ n	철리안
천만	t͡ɕʰ ʌ̹ n m a̠ n	천만
천만에요	t͡ɕʰ ʌ̹ n m a̠ n e̞ j o	천마네요
천부적	t͡ɕʰ ʌ̹ n b u d͡ʑ ʌ̹ k̚	천부적
천사	t͡ɕʰ ʌ̹ n sʰ a̠	천사
천성	t͡ɕʰ ʌ̹ n sʰ ʌ̹ ŋ	천성
천안문	t͡ɕʰ ʌ̹ n a̠ n m u n	처난문
천왕성	t͡ɕʰ ʌ̹ n w a̠ ŋ sʰ ʌ̹ ŋ	처놩성
천자문	t͡ɕʰ ʌ̹ ɲ d͡ʑ a̠ m u n	천자문
천장	t͡ɕʰ ʌ̹ ɲ d͡ʑ a̠ ŋ	천장
천제	t͡ɕʰ ʌ̹ ɲ d͡ʑ e̞	천제
천조국	t͡ɕʰ ʌ̹ ɲ d͡ʑ o̞ ɡ u k̚	천조국
천주교	t͡ɕʰ ʌ̹ ɲ d͡ʑ u ɡ j o	천주교
천지	t͡ɕʰ ʌ̹ ɲ d͡ʑ i	천지
천지인	t͡ɕʰ ʌ̹ ɲ d͡ʑ i i n	천지인
천천히	t͡ɕʰ ɘː ɲ t͡ɕʰ ʌ̹ n ʝ i	천천히
천체	t͡ɕʰ ʌ̹ ɲ t͡ɕʰ e̞	천체
천하	t͡ɕʰ ʌ̹ n ɦ a̠	천하
천황	t͡ɕʰ ʌ̹ n β w a̠ ŋ	천황
철갑	t͡ɕʰ ʌ̹ ɭ ɡ a̠ p̚	철갑
철도	t͡ɕʰ ʌ̹ ɭ t͈ o̞	철또
철밥통	t͡ɕʰ ʌ̹ ɭ b a̠ p̚ tʰ o̞ ŋ	철밥통
철부지	t͡ɕʰ ʌ̹ ɭ b u d͡ʑ i	철부지
철자법	t͡ɕʰ ʌ̹ ʎ t͡ɕ͈ a̠ p͈ ʌ̹ p̚	철짜뻡
철저하다	t͡ɕʰ ʌ̹ ʎ t͡ɕ͈ ʌ̹ ɦ a̠ d a̠	철쩌하다
철저히	t͡ɕʰ ʌ̹ ʎ t͡ɕ͈ ʌ̹ ʝ i	철쩌히
철쭉	t͡ɕʰ ʌ̹ ʎ t͡ɕ͈ u k̚	철쭉
철퇴	t͡ɕʰ ʌ̹ ɭ tʰ w e̞	철퇴
철판	t͡ɕʰ ʌ̹ ɭ pʰ a̠ n	철판
철폐	t͡ɕʰ ʌ̹ ɭ pʰ j e̞	철폐
철학	t͡ɕʰ ʌ̹ ɾ ɦ a̠ k̚	철학
첫날	t͡ɕʰ ʌ̹ n n a̠ ɭ	천날
첫눈	t͡ɕʰ ʌ̹ n n u n	천눈
첫차	t͡ɕʰ ʌ̹ t̚ t͡ɕʰ a̠	첟차
청각	t͡ɕʰ ʌ̹ ŋ ɡ a̠ k̚	청각
청결	t͡ɕʰ ʌ̹ ŋ ɡ j ʌ̹ ɭ	청결
청국장	t͡ɕʰ ʌ̹ ŋ ɡ u k̚ t͡ɕ͈ a̠ ŋ	청국짱
청남방	t͡ɕʰ ʌ̹ ŋ n a̠ m b a̠ ŋ	청남방
청년	t͡ɕʰ ʌ̹ ŋ ɲ j ʌ̹ n	청년
청동	t͡ɕʰ ʌ̹ ŋ d o̞ ŋ	청동
청둥오리	t͡ɕʰ ʌ̹ ŋ d u ŋ o̞ ɾ i	청두오리
청량음료	t͡ɕʰ ʌ̹ ŋ ɲ j a̠ ŋ ɯ m ɲ j o	청냐음뇨
청바지	t͡ɕʰ ʌ̹ ŋ b a̠ d͡ʑ i	청바지
청소	t͡ɕʰ ʌ̹ ŋ sʰ o̞	청소
청소년	t͡ɕʰ ʌ̹ ŋ sʰ o̞ ɲ j ʌ̹ n	청소년
청순	t͡ɕʰ ʌ̹ ŋ sʰ u n	청순
청진	t͡ɕʰ ʌ̹ ŋ d͡ʑ i n	청진
청천벽력	t͡ɕʰ ʌ̹ ŋ t͡ɕʰ ʌ̹ n b j ʌ̹ ŋ ɲ j ʌ̹ k̚	청천병녁
청첩장	t͡ɕʰ ɘː ŋ t͡ɕʰ ʌ̹ p̚ t͡ɕ͈ a̠ ŋ	청첩짱
청초하다	t͡ɕʰ ʌ̹ ŋ t͡ɕʰ o̞ ɦ a̠ d a̠	청초하다
청춘	t͡ɕʰ ʌ̹ ŋ t͡ɕʰ u n	청춘
청탁	t͡ɕʰ ʌ̹ ŋ tʰ a̠ k̚	청탁
체결	t͡ɕʰ e̞ ɡ j ʌ̹ ɭ	체결
체구	t͡ɕʰ e̞ ɡ u	체구
체념	t͡ɕʰ e̞ ɲ j ʌ̹ m	체념
체력	t͡ɕʰ e̞ ɾ j ʌ̹ k̚	체력
체르노빌	t͡ɕʰ e̞ ɾ ɯ n o̞ b i ɭ	체르노빌
체리	t͡ɕʰ e̞ ɾ i	체리
체면	t͡ɕʰ e̞ m j ʌ̹ n	체면
체스	t͡ɕʰ e̞ sʰ ɯ	체스
체스꼬슬로벤스꼬	t͡ɕʰ e̞ sʰ ɯ k͈ o̞ sʰ ɯ ɭ ɭ o̞ b e̞ n sʰ ɯ k͈ o̞	체스꼬슬로벤스꼬
체온계	t͡ɕʰ e̞ o̞ n ɡ j e̞	체온계
체육	t͡ɕʰ e̞ j u k̚	체육
체육관	t͡ɕʰ e̞ j u k̚ k͈ w a̠ n	체육꽌
체인	t͡ɕʰ e̞ i n	체인
체제	t͡ɕʰ e̞ d͡ʑ e̞	체제
체중	t͡ɕʰ e̞ d͡ʑ u ŋ	체중
체질	t͡ɕʰ e̞ d͡ʑ i ɭ	체질
체커	t͡ɕʰ e̞ kʰ ʌ̹	체커
체코	t͡ɕʰ e̞ kʰ o̞	체코
체포	t͡ɕʰ e̞ pʰ o̞	체포
체험	t͡ɕʰ e̞ ɦ ʌ̹ m	체험
쳐죽이다	t͡ɕʰ ʌ̹ d͡ʑ u ɡ i d a̠	처주기다
초고속	t͡ɕʰ o̞ ɡ o̞ sʰ o̞ k̚	초고속
초고추장	t͡ɕʰ o̞ ɡ o̞ t͡ɕʰ u d͡ʑ a̠ ŋ	초고추장
초능력	t͡ɕʰ o̞ n ɯ ŋ ɲ j ʌ̹ k̚	초능녁
초등학교	t͡ɕʰ o̞ d ɯ ŋ ɦ a̠ k̚ k͈ j o	초등학꾜
초딩	t͡ɕʰ o̞ d i ŋ	초딩
초로	t͡ɕʰ o̞ ɾ o̞	초로
초록빛	t͡ɕʰ o̞ ɾ o̞ k̚ p͈ i t̚	초록삗
초반	t͡ɕʰ o̞ b a̠ n	초반
초밥	t͡ɕʰ o̞ b a̠ p̚	초밥
초순	t͡ɕʰ o̞ sʰ u n	초순
초승달	t͡ɕʰ o̞ sʰ ɯ ŋ t͈ a̠ ɭ	초승딸
초원	t͡ɕʰ o̞ w ʌ̹ n	초원
초유	t͡ɕʰ o̞ j u	초유
초음파	t͡ɕʰ o̞ ɯ m pʰ a̠	초음파
초인	t͡ɕʰ o̞ i n	초인
초자연적	t͡ɕʰ o̞ d͡ʑ a̠ j ʌ̹ ɲ d͡ʑ ʌ̹ k̚	초자연적
초점	t͡ɕʰ o̞ t͡ɕ͈ ʌ̹ m	초쩜
초지	t͡ɕʰ o̞ d͡ʑ i	초지
초콜렛	t͡ɕʰ o̞ kʰ o̞ ɭ ɭ e̞ t̚	초콜렏
초콜릿	t͡ɕʰ o̞ kʰ o̞ ʎ ʎ i t̚	초콜릳
초특급	t͡ɕʰ o̞ tʰ ɯ k̚ k͈ ɯ p̚	초특끕
초판	t͡ɕʰ o̞ pʰ a̠ n	초판
초하루	t͡ɕʰ o̞ ɦ a̠ ɾ u	초하루
초혼	t͡ɕʰ o̞ β o̞ n	초혼
촉각	t͡ɕʰ o̞ k̚ k͈ a̠ k̚	촉깍
촉법소년	t͡ɕʰ o̞ k̚ p͈ ʌ̹ p s͈ o̞ ɲ j ʌ̹ n	촉뻡쏘년
촉수	t͡ɕʰ o̞ k s͈ u	촉쑤
촌극	t͡ɕʰ o̞ː n ɡ ɯ k̚	촌극
촌놈	t͡ɕʰ o̞ n n o̞ m	촌놈
촌락	t͡ɕʰ o̞ː ɭ ɭ a̠ k̚	촐락
총각	t͡ɕʰ o̞ː ŋ ɡ a̠ k̚	총각
총명	t͡ɕʰ o̞ ŋ m j ʌ̹ ŋ	총명
총서	t͡ɕʰ o̞ ŋ sʰ ʌ̹	총서
총영사관	t͡ɕʰ o̞ ŋ j ʌ̹ ŋ sʰ a̠ ɡ w a̠ n	초영사관
총장	t͡ɕʰ o̞ː ŋ d͡ʑ a̠ ŋ	총장
총체적	t͡ɕʰ o̞ ŋ t͡ɕʰ e̞ d͡ʑ ʌ̹ k̚	총체적
총총	t͡ɕʰ o̞ ŋ t͡ɕʰ o̞ ŋ	총총
총통	t͡ɕʰ o̞ː ŋ tʰ o̞ ŋ	총통
총화	t͡ɕʰ o̞ ŋ β w a̠	총화
촬영	t͡ɕʰ w a̠ ɾ j ʌ̹ ŋ	촤령
최강	t͡ɕʰ w e̞ː ɡ a̠ ŋ	최강
최근	t͡ɕʰ w e̞ː ɡ ɯ n	최근
최상급	t͡ɕʰ w e̞ː sʰ a̠ ŋ ɡ ɯ p̚	최상급
최선	t͡ɕʰ w e̞ː sʰ ʌ̹ n	최선
최소한	t͡ɕʰ w e̞ː sʰ o̞ ɦ a̠ n	최소한
최종	t͡ɕʰ w e̞ː d͡ʑ o̞ ŋ	최종
최초	t͡ɕʰ w e̞ː t͡ɕʰ o̞	최초
추가	t͡ɕʰ u ɡ a̠	추가
추격	t͡ɕʰ u ɡ j ʌ̹ k̚	추격
추구	t͡ɕʰ u ɡ u	추구
추구하다	t͡ɕʰ u ɡ u ɦ a̠ d a̠	추구하다
추락	t͡ɕʰ u ɾ a̠ k̚	추락
추리닝	t͡ɕʰ u ɾ i n i ŋ	추리닝
추밀원	t͡ɕʰ u m i ɾ w ʌ̹ n	추미뤈
추방	t͡ɕʰ u b a̠ ŋ	추방
추석	t͡ɕʰ u sʰ ʌ̹ k̚	추석
추수	t͡ɕʰ u sʰ u	추수
추악하다	t͡ɕʰ u a̠ kʰ a̠ d a̠	추아카다
추억	t͡ɕʰ u ʌ̹ k̚	추억
추위	t͡ɕʰ u ɥ i	추위
추적하다	t͡ɕʰ u d͡ʑ ʌ̹ kʰ a̠ d a̠	추저카다
추진	t͡ɕʰ u d͡ʑ i n	추진
추진하다	t͡ɕʰ u d͡ʑ i n ɦ a̠ d a̠	추진하다
추천하다	t͡ɕʰ u t͡ɕʰ ʌ̹ n ɦ a̠ d a̠	추천하다
추출	t͡ɕʰ u t͡ɕʰ u ɭ	추출
추출물	t͡ɕʰ u t͡ɕʰ u ɭ m u ɭ	추출물
추측	t͡ɕʰ u t͡ɕʰ ɯ k̚	추측
축복	t͡ɕʰ u k̚ p͈ o̞ k̚	축뽁
축사	t͡ɕʰ u k s͈ a̠	축싸
축소	t͡ɕʰ u k s͈ o̞	축쏘
축음기	t͡ɕʰ u ɡ ɯ m ɡ i	추금기
축제	t͡ɕʰ u k̚ t͡ɕ͈ e̞	축쩨
축척	t͡ɕʰ u k̚ t͡ɕʰ ʌ̹ k̚	축척
축하	t͡ɕʰ u kʰ a̠	추카
춘하추동	t͡ɕʰ u n ɦ a̠ t͡ɕʰ u d o̞ ŋ	춘하추동
출구	t͡ɕʰ u ɭ ɡ u	출구
출근	t͡ɕʰ u ɭ ɡ ɯ n	출근
출근시간	t͡ɕʰ u ɭ ɡ ɯ n ɕʰ i ɡ a̠ n	출근시간
출근하다	t͡ɕʰ u ɭ ɡ ɯ n ɦ a̠ d a̠	출근하다
출금	t͡ɕʰ u ɭ ɡ ɯ m	출금
출발하다	t͡ɕʰ u ɭ b a̠ ɾ ɦ a̠ d a̠	출발하다
출산	t͡ɕʰ u ɭ s͈ a̠ n	출싼
출산율	t͡ɕʰ u ɭ sʰ a̠ ɲ j u ɭ	출사뉼
출석	t͡ɕʰ u ɭ s͈ ʌ̹ k̚	출썩
출신	t͡ɕʰ u ɭ ɕ͈ i n	출씬
출신성분	t͡ɕʰ u ɭ ɕ͈ i n sʰ ʌ̹ ŋ b u n	출씬성분
출연	t͡ɕʰ u ɾ j ʌ̹ n	추련
출원자	t͡ɕʰ u ɾ w ʌ̹ ɲ d͡ʑ a̠	추뤈자
출전	t͡ɕʰ u ʎ d͡ʑ ʌ̹ n	출전
출출하다	t͡ɕʰ u ʎ t͡ɕʰ u ɾ ɦ a̠ d a̠	출출하다
출퇴근하다	t͡ɕʰ u ɭ tʰ w e̞ ɡ ɯ n ɦ a̠ d a̠	출퇴근하다
출판사	t͡ɕʰ u ɭ pʰ a̠ n sʰ a̠	출판사
출판하다	t͡ɕʰ u ɭ pʰ a̠ n ɦ a̠ d a̠	출판하다
출혈	t͡ɕʰ u ɾ ʝ j ʌ̹ ɭ	출혈
춤꾼	t͡ɕʰ u m k͈ u n	춤꾼
춤추다	t͡ɕʰ u m t͡ɕʰ u d a̠	춤추다
춥다	t͡ɕʰ u p̚ t͈ a̠	춥따
충격	t͡ɕʰ u ŋ ɡ j ʌ̹ k̚	충격
충고	t͡ɕʰ u ŋ ɡ o̞	충고
충돌	t͡ɕʰ u ŋ d o̞ ɭ	충돌
충분하다	t͡ɕʰ u ŋ b u n ɦ a̠ d a̠	충분하다
충분히	t͡ɕʰ u ŋ b u n ʝ i	충분히
충성	t͡ɕʰ u ŋ sʰ ʌ̹ ŋ	충성
충수	t͡ɕʰ u ŋ sʰ u	충수
충실하다	t͡ɕʰ u ŋ ɕʰ i ɾ ɦ a̠ d a̠	충실하다
충전기	t͡ɕʰ u ŋ d͡ʑ ʌ̹ n ɡ i	충전기
충청북도	t͡ɕʰ u ŋ t͡ɕʰ ʌ̹ ŋ b u k̚ t͈ o̞	충청북또
충충	t͡ɕʰ u ŋ t͡ɕʰ u ŋ	충충
충칭	t͡ɕʰ u ŋ t͡ɕʰ i ŋ	충칭
취급	t͡ɕʰ ɥ i ɡ ɯ p̚	취급
취나물	t͡ɕʰ ɥ i n a̠ m u ɭ	취나물
취리히	t͡ɕʰ ɥ i ɾ i ʝ i	취리히
취미	t͡ɕʰ ɥ iː m i	취미
취소	t͡ɕʰ ɥ iː sʰ o̞	취소
취직	t͡ɕʰ ɥ iː d͡ʑ i k̚	취직
취하다	t͡ɕʰ ɥ iː ɦ a̠ d a̠	취하다
취향	t͡ɕʰ ɥ iː ʝ j a̠ ŋ	취향
측위	t͡ɕʰ ɯ ɡ ɥ i	츠귀
층운	t͡ɕʰ ɯ ŋ u n	츠운
치는	t͡ɕʰ i n ɯ n	치는
치다	t͡ɕʰ i d a̠	치다
치료	t͡ɕʰ i ɾ j o	치료
치료제	t͡ɕʰ i ɾ j o d͡ʑ e̞	치료제
치르다	t͡ɕʰ i ɾ ɯ d a̠	치르다
치마	t͡ɕʰ i m a̠	치마
치아	t͡ɕʰ i a̠	치아
치안	t͡ɕʰ i a̠ n	치안
치어리더	t͡ɕʰ i ʌ̹ ɾ i d ʌ̹	치어리더
치열	t͡ɕʰ i j ʌ̹ ɭ	치열
치와와	t͡ɕʰ i w a̠ w a̠	치와와
치욕	t͡ɕʰ i j o k̚	치욕
치우	t͡ɕʰ i u	치우
치즈	t͡ɕʰ i d͡ʑ ɯ	치즈
치타	t͡ɕʰ i tʰ a̠	치타
치통	t͡ɕʰ i tʰ o̞ ŋ	치통
치한	t͡ɕʰ i ɦ a̠ n	치한
친구	t͡ɕʰ i n ɡ u	친구
친근하다	t͡ɕʰ i n ɡ ɯ n ɦ a̠ d a̠	친근하다
친밀	t͡ɕʰ i n m i ɭ	친밀
친삼촌	t͡ɕʰ i n sʰ a̠ m t͡ɕʰ o̞ n	친삼촌
친선	t͡ɕʰ i n sʰ ʌ̹ n	친선
친일파	t͡ɕʰ i n i ɭ pʰ a̠	치닐파
친절	t͡ɕʰ i ɲ d͡ʑ ʌ̹ ɭ	친절
친족	t͡ɕʰ i ɲ d͡ʑ o̞ k̚	친족
친척	t͡ɕʰ i ɲ t͡ɕʰ ʌ̹ k̚	친척
칠레	t͡ɕʰ i ɭ ɭ e̞	칠레
칠리	t͡ɕʰ i ʎ ʎ i	칠리
칠면조	t͡ɕʰ i ɭ m j ʌ̹ ɲ d͡ʑ o̞	칠면조
칠월	t͡ɕʰ i ɾ w ʌ̹ ɭ	치뤌
칠판	t͡ɕʰ i ɭ pʰ a̠ n	칠판
침공	t͡ɕʰ iː m ɡ o̞ ŋ	침공
침낭	t͡ɕʰ iː m n a̠ ŋ	침낭
침략	t͡ɕʰ iː m ɲ j a̠ k̚	침냑
침목	t͡ɕʰ i m m o̞ k̚	침목
침묵	t͡ɕʰ i m m u k̚	침묵
침묵하다	t͡ɕʰ i m m u kʰ a̠ d a̠	침무카다
침범	t͡ɕʰ iː m b ʌ̹ m	침범
침술	t͡ɕʰ i m sʰ u ɭ	침술
침실	t͡ɕʰ iː m ɕʰ i ɭ	침실
침입	t͡ɕʰ iː m i p̚	치밉
칭찬	t͡ɕʰ i ŋ t͡ɕʰ a̠ n	칭찬
칭찬하다	t͡ɕʰ i ŋ t͡ɕʰ a̠ n ɦ a̠ d a̠	칭찬하다
칭하이	t͡ɕʰ i ŋ ɦ a̠ i	칭하이
카나	kʰ a̠ n a̠	카나
카나리아	kʰ a̠ n a̠ ɾ i a̠	카나리아
카놀라유	kʰ a̠ n o̞ ɭ ɭ a̠ j u	카놀라유
카드	kʰ a̠ d ɯ	카드
카드뮴	kʰ a̠ d ɯ m j u m	카드뮴
카라치	kʰ a̠ ɾ a̠ t͡ɕʰ i	카라치
카라카스	kʰ a̠ ɾ a̠ kʰ a̠ sʰ ɯ	카라카스
카란	kʰ a̠ ɾ a̠ n	카란
카르마	kʰ a̠ ɾ ɯ m a̠	카르마
카르복실기	kʰ a̠ ɾ ɯ b o̞ k ɕ͈ i ɭ ɡ i	카르복씰기
카르빌아민	kʰ a̠ ɾ ɯ b i ɾ a̠ m i n	카르비라민
카르텔	kʰ a̠ ɾ ɯ tʰ e̞ ɭ	카르텔
카메라	kʰ a̠ m e̞ ɾ a̠	카메라
카메룬	kʰ a̠ m e̞ ɾ u n	카메룬
카멜레온	kʰ a̠ m e̞ ɭ ɭ e̞ o̞ n	카멜레온
카보베르데	kʰ a̠ b o̞ b e̞ ɾ ɯ d e̞	카보베르데
카복실산	kʰ a̠ b o̞ k ɕ͈ i ɭ sʰ a̠ n	카복씰산
카불	kʰ a̠ b u ɭ	카불
카세트	kʰ a̠ sʰ e̞ tʰ ɯ	카세트
카옌	kʰ a̠ j e̞ n	카옌
카우보이	kʰ a̠ u b o̞ i	카우보이
카우치	kʰ a̠ u t͡ɕʰ i	카우치
카운터	kʰ a̠ u n tʰ ʌ̹	카운터
카이로	kʰ a̠ i ɾ o̞	카이로
카이만	kʰ a̠ i m a̠ n	카이만
카자흐스탄	kʰ a̠ d͡ʑ a̠ ɣ ɯ sʰ ɯ tʰ a̠ n	카자ɣㅡ스탄
카지노	kʰ a̠ d͡ʑ i n o̞	카지노
카타르	kʰ a̠ tʰ a̠ ɾ ɯ	카타르
카트	kʰ a̠ tʰ ɯ	카트
카트만두	kʰ a̠ tʰ ɯ m a̠ n d u	카트만두
카페	k͈ a̠ pʰ e̞	까페
카페테리아	kʰ a̠ pʰ e̞ tʰ e̞ ɾ i a̠	카페테리아
칵테일	kʰ a̠ k̚ tʰ e̞ i ɭ	칵테일
칼날	kʰ a̠ ɭ ɭ a̠ ɭ	칼랄
칼라	kʰ a̠ ɭ ɭ a̠	칼라
칼로리	kʰ a̠ ɭ ɭ o̞ ɾ i	칼로리
칼륨	kʰ a̠ ʎ ʎ j u m	칼륨
칼리닌그라드	kʰ a̠ ʎ ʎ i n i n ɡ ɯ ɾ a̠ d ɯ	칼리닌그라드
칼리파	kʰ a̠ ʎ ʎ i pʰ a̠	칼리파
칼바람	kʰ a̠ ɭ b a̠ ɾ a̠ m	칼바람
칼상어	kʰ a̠ ɭ sʰ a̠ ŋ ʌ̹	칼사어
칼슘	kʰ a̠ ɭ ɕʰ u m	칼숨
칼자루	kʰ a̠ ʎ d͡ʑ a̠ ɾ u	칼자루
칼집	kʰ a̠ ʎ t͡ɕ͈ i p̚	칼찝
칼파스	kʰ a̠ ɭ pʰ a̠ sʰ ɯ	칼파스
캄보디아	kʰ a̠ m b o̞ d i a̠	캄보디아
캄팔라	kʰ a̠ m pʰ a̠ ɭ ɭ a̠	캄팔라
캐다	kʰ ɛː d a̠	캐다
커닝	kʰ ʌ̹ n i ŋ	커닝
커다랗다	kʰ ɘː d a̠ ɾ a̠ tʰ a̠	커다라타
커리	kʰ ʌ̹ ɾ i	커리
커뮤니케이션	kʰ ʌ̹ m j u n i kʰ e̞ i ɕʰ ʌ̹ n	커뮤니케이선
커뮤니티	kʰ ʌ̹ m j u n i tʰ i	커뮤니티
커미션	kʰ ʌ̹ m i ɕʰ ʌ̹ n	커미선
커밍아웃	kʰ ʌ̹ m i ŋ a̠ u t̚	커미아욷
커브	kʰ ʌ̹ b ɯ	커브
커서	kʰ ʌ̹ sʰ ʌ̹	커서
커지다	kʰ ʌ̹ d͡ʑ i d a̠	커지다
커튼	kʰ ʌ̹ tʰ ɯ n	커튼
커플	kʰ ʌ̹ pʰ ɯ ɭ	커플
커피숍	kʰ ʌ̹ pʰ i ɕʰ o p̚	커피숍
컴퓨터	kʰ ʌ̹ m pʰ j u tʰ ʌ̹	컴퓨터
케더링	kʰ e̞ d ʌ̹ ɾ i ŋ	케더링
케바케	kʰ e̞ b a̠ kʰ e̞	케바케
케이블	kʰ e̞ i b ɯ ɭ	케이블
케이크	kʰ e̞ i k x ɯ	케익흐
케이터링	kʰ e̞ i tʰ ʌ̹ ɾ i ŋ	케이터링
케이프타운	kʰ e̞ i pʰ ɯ tʰ a̠ u n	케이프타운
케익	kʰ e̞ i k̚	케익
케첩	kʰ e̞ t͡ɕʰ ʌ̹ p̚	케첩
케톤	kʰ e̞ tʰ o̞ n	케톤
켈빈	kʰ e̞ ɭ b i n	켈빈
코끼리	kʰ o̞ k͈ i ɾ i	코끼리
코냑	kʰ o̞ ɲ j a̠ k̚	코냑
코너	kʰ o̞ n ʌ̹	코너
코드	kʰ o̞ d ɯ	코드
코란	kʰ o̞ ɾ a̠ n	코란
코로나	kʰ o̞ ɾ o̞ n a̠	코로나
코로나비루스	kʰ o̞ ɾ o̞ n a̠ b i ɾ u sʰ ɯ	코로나비루스
코리아	kʰ o̞ ɾ i a̠	코리아
코린	kʰ o̞ ɾ i n	코린
코린치쥐	kʰ o̞ ɾ i ɲ t͡ɕʰ i d͡ʑ ɥ i	코린치쥐
코미디	kʰ o̞ m i d i	코미디
코발트	kʰ o̞ b a̠ ɭ tʰ ɯ	코발트
코브라	kʰ o̞ b ɯ ɾ a̠	코브라
코뿔소	kʰ o̞ p͈ u ɭ s͈ o̞	코뿔쏘
코소보	kʰ o̞ sʰ o̞ b o̞	코소보
코스	kʰ o̞ sʰ ɯ	코스
코스모스	kʰ o̞ sʰ ɯ m o̞ sʰ ɯ	코스모스
코스타리카	kʰ o̞ sʰ ɯ tʰ a̠ ɾ i kʰ a̠	코스타리카
코알라	kʰ o̞ a̠ ɭ ɭ a̠	코알라
코요테	kʰ o̞ j o tʰ e̞	코요테
코이	kʰ o̞ i	코이
코카인	kʰ o̞ kʰ a̠ i n	코카인
코카콜라	kʰ o̞ kʰ a̠ kʰ o̞ ɭ ɭ a̠	코카콜라
코코넛	kʰ o̞ kʰ o̞ n ʌ̹ t̚	코코넏
코크스	kʰ o̞ k x ɯ sʰ ɯ	콕흐스
코트	kʰ o̞ tʰ ɯ	코트
코트디부아르	kʰ o̞ tʰ ɯ d i b u a̠ ɾ ɯ	코트디부아르
코튼	kʰ o̞ tʰ ɯ n	코튼
코펜하겐	kʰ o̞ pʰ e̞ n ɦ a̠ ɡ e̞ n	코펜하겐
코피	kʰ o̞ pʰ i	코피
코헬렛	kʰ o̞ ɦ e̞ ɭ ɭ e̞ t̚	코헬렏
콘도미니엄	kʰ o̞ n d o̞ m i n i ʌ̹ m	콘도미니엄
콘돔	kʰ o̞ n d o̞ m	콘돔
콘서트	kʰ o̞ n sʰ ʌ̹ tʰ ɯ	콘서트
콘셉트	kʰ o̞ n sʰ e̞ p̚ tʰ ɯ	콘셉트
콘스탄티누스	kʰ o̞ n sʰ ɯ tʰ a̠ n tʰ i n u sʰ ɯ	콘스탄티누스
콘크리트	kʰ o̞ n k x ɯ ɾ i tʰ ɯ	콘ㄱ흐리트
콜라	kʰ o̞ ɭ ɭ a̠	콜라
콜라보	kʰ o̞ ɭ ɭ a̠ b o̞	콜라보
콜레스테롤	kʰ o̞ ɭ ɭ e̞ sʰ ɯ tʰ e̞ ɾ o̞ ɭ	콜레스테롤
콜록	kʰ o̞ ɭ ɭ o̞ k̚	콜록
콜록콜록	kʰ o̞ ɭ ɭ o̞ k̚ kʰ o̞ ɭ ɭ o̞ k̚	콜록콜록
콜론	kʰ o̞ ɭ ɭ o̞ n	콜론
콜옵션	kʰ o̞ ɾ o̞ p ɕ͈ ʌ̹ n	코롭썬
콜카타	kʰ o̞ ɭ kʰ a̠ tʰ a̠	콜카타
콜호스	kʰ o̞ ɾ β o̞ sʰ ɯ	콜호스
콤바인	kʰ o̞ m b a̠ i n	콤바인
콤퓨터	kʰ o̞ m pʰ j u tʰ ʌ̹	콤퓨터
콤플렉스	kʰ o̞ m pʰ ɯ ɭ ɭ e̞ k s͈ ɯ	콤플렉쓰
콧물	kʰ o̞ n m u ɭ	콘물
콩고	kʰ o̞ ŋ ɡ o̞	콩고
콩나물	kʰ o̞ ŋ n a̠ m u ɭ	콩나물
콩자반	kʰ o̞ ŋ d͡ʑ a̠ b a̠ n	콩자반
콩팥	kʰ o̞ ŋ pʰ a̠ t̚	콩팓
쾨뻰하븐	kʰ w e̞ p͈ e̞ n ɦ a̠ b ɯ n	쾨뻰하븐
쾰른	kʰ w e̞ ɭ ɭ ɯ n	쾰른
쿠데타	kʰ u d e̞ tʰ a̠	쿠데타
쿠션	kʰ u ɕʰ ʌ̹ n	쿠선
쿠알라룸푸르	kʰ u a̠ ɭ ɭ a̠ ɾ u m pʰ u ɾ ɯ	쿠알라룸푸르
쿨쿨	kʰ u ɭ kʰ u ɭ	쿨쿨
쿵후	kʰ u ŋ β u	쿵후
퀴나졸린	kʰ ɥ i n a̠ d͡ʑ o̞ ʎ ʎ i n	퀴나졸린
퀴즈	kʰ ɥ i d͡ʑ ɯ	퀴즈
크기	k x ɯ ɡ i	ㄱ흐기
크다	k x ɯ d a̠	ㄱ흐다
크레용	k x ɯ ɾ e̞ j o ŋ	ㄱ흐레용
크레인	k x ɯ ɾ e̞ i n	ㄱ흐레인
크레파스	k x ɯ ɾ e̞ pʰ a̠ sʰ ɯ	ㄱ흐레파스
크로뮴	k x ɯ ɾ o̞ m j u m	ㄱ흐로뮴
크로스드레싱	k x ɯ ɾ o̞ sʰ ɯ d ɯ ɾ e̞ ɕʰ i ŋ	ㄱ흐로스드레싱
크로아티아	k x ɯ ɾ o̞ a̠ tʰ i a̠	ㄱ흐로아티아
크로켓	k x ɯ ɾ o̞ kʰ e̞ t̚	ㄱ흐로켇
크롬	k x ɯ ɾ o̞ m	ㄱ흐롬
크리스마스이브	k x ɯ ɾ i sʰ ɯ m a̠ sʰ ɯ i b ɯ	ㄱ흐리스마스이브
크리스천	k x ɯ ɾ i sʰ ɯ t͡ɕʰ ʌ̹ n	ㄱ흐리스천
크리켓	k x ɯ ɾ i kʰ e̞ t̚	ㄱ흐리켇
크림반도	k x ɯ ɾ i m b a̠ n d o̞	ㄱ흐림반도
크세논	k x ɯ sʰ e̞ n o̞ n	ㄱ흐세논
큰고니	k x ɯ n ɡ o̞ n i	ㄱ흔고니
큰기러기	k x ɯ n ɡ i ɾ ʌ̹ ɡ i	ㄱ흔기러기
큰물	k x ɯ n m u ɭ	ㄱ흔물
큰바다사자	k x ɯ n b a̠ d a̠ sʰ a̠ d͡ʑ a̠	ㄱ흔바다사자
큰아들	k x ɯ n a̠ d ɯ ɭ	ㄱ흐나들
큰아버지	k x ɯ n a̠ b ʌ̹ d͡ʑ i	ㄱ흐나버지
큰일	k x ɯ n n i ɭ	ㄱ흔닐
클라리넷	k x ɯ ɭ ɭ a̠ ɾ i n e̞ t̚	ㄱ흘라리넫
클라우드	k x ɯ ɭ ɭ a̠ u d ɯ	ㄱ흘라우드
클럽	k x ɯ ɭ ɭ ʌ̹ p̚	ㄱ흘럽
클로버	k x ɯ ɭ ɭ o̞ b ʌ̹	ㄱ흘로버
클리닝	k x ɯ ʎ ʎ i n i ŋ	ㄱ흘리닝
클릭	k x ɯ ʎ ʎ i k̚	ㄱ흘릭
클립	k x ɯ ʎ ʎ i p̚	ㄱ흘립
타나크	tʰ a̠ n a̠ k x ɯ	타낙흐
타다	tʰ a̠ d a̠	타다
타밀어	tʰ a̠ m i ɾ ʌ̹	타미러
타슈켄트	tʰ a̠ ɕʰ u kʰ e̞ n tʰ ɯ	타수켄트
타워	tʰ a̠ w ʌ̹	타워
타원	tʰ a̠ː w ʌ̹ n	타원
타율	tʰ a̠ː j u ɭ	타율
타이	tʰ a̠ i	타이
타이가	tʰ a̠ i ɡ a̠	타이가
타이르다	tʰ a̠ i ɾ ɯ d a̠	타이르다
타이머	tʰ a̠ i m ʌ̹	타이머
타이베이	tʰ a̠ i b e̞ i	타이베이
타이어	tʰ a̠ i ʌ̹	타이어
타이타늄	tʰ a̠ i tʰ a̠ ɲ j u m	타이타늄
타이틀	tʰ a̠ i tʰ ɯ ɭ	타이틀
타이페이	tʰ a̠ i pʰ e̞ i	타이페이
타일	tʰ a̠ i ɭ	타일
타자	tʰ a̠ː d͡ʑ a̠	타자
타조	tʰ a̠ː d͡ʑ o̞	타조
타협	tʰ a̠ː ʝ j ʌ̹ p̚	타협
타협하다	tʰ a̠ː ʝ j ʌ̹ pʰ a̠ d a̠	타혀파다
탁구	tʰ a̠ k̚ k͈ u	탁꾸
탁아소	tʰ a̠ ɡ a̠ sʰ o̞	타가소
탁자	tʰ a̠ k̚ t͡ɕ͈ a̠	탁짜
탁치	tʰ a̠ k̚ t͡ɕʰ i	탁치
탄로	tʰ a̠ː ɭ ɭ o̞	탈로
탄성	tʰ a̠ n sʰ ʌ̹ ŋ	탄성
탄소	tʰ a̠ː n sʰ o̞	탄소
탄수화물	tʰ a̠ː n sʰ u β w a̠ m u ɭ	탄수화물
탄압	tʰ a̠ː n a̠ p̚	타납
탄약고	tʰ a̠ː ɲ j a̠ k̚ k͈ o̞	타냑꼬
탄화	tʰ a̠ː n β w a̠	탄화
탄화수소	tʰ a̠ː n β w a̠ sʰ u sʰ o̞	탄화수소
탈락	tʰ a̠ ɭ ɭ a̠ k̚	탈락
탈륨	tʰ a̠ ʎ ʎ j u m	탈륨
탈린	tʰ a̠ ʎ ʎ i n	탈린
탈북자	tʰ a̠ ɭ b u k̚ t͡ɕ͈ a̠	탈북짜
탈영병	tʰ a̠ ɾ j ʌ̹ ŋ b j ʌ̹ ŋ	타령병
탈영자	tʰ a̠ ɾ j ʌ̹ ŋ d͡ʑ a̠	타령자
탈의실	tʰ a̠ ɾ ɰ i ɕʰ i ɭ	타릐실
탈출기	tʰ a̠ ʎ t͡ɕʰ u ɭ ɡ i	탈출기
탈환	tʰ a̠ ɾ β w a̠ n	탈환
탐구	tʰ a̠ m ɡ u	탐구
탐라	tʰ a̠ m n a̠	탐나
탐사	tʰ a̠ m sʰ a̠	탐사
탐욕	tʰ a̠ m j o k̚	타묙
탐정	tʰ a̠ m d͡ʑ ʌ̹ ŋ	탐정
탐험	tʰ a̠ m ɦ ʌ̹ m	탐험
탐험가	tʰ a̠ m ɦ ʌ̹ m ɡ a̠	탐험가
탑승권	tʰ a̠ p s͈ ɯ ŋ k͈ w ʌ̹ n	탑씅꿘
태도	tʰ ɛː d o̞	태도
터덜터덜	tʰ ʌ̹ d ʌ̹ ɭ tʰ ʌ̹ d ʌ̹ ɭ	터덜터덜
터미널	tʰ ʌ̹ m i n ʌ̹ ɭ	터미널
터빈	tʰ ʌ̹ b i n	터빈
턱뼈	tʰ ʌ̹ k̚ p͈ j ʌ̹	턱뼈
턱선	tʰ ʌ̹ k s͈ ʌ̹ n	턱썬
턱수염	tʰ ʌ̹ k s͈ u j ʌ̹ m	턱쑤염
털다	tʰ ɘː ɭ d a̠	털다
털어놓다	tʰ ʌ̹ ɾ ʌ̹ n o̞ tʰ a̠	터러노타
텅스텐	tʰ ʌ̹ ŋ sʰ ɯ tʰ e̞ n	텅스텐
테니스장	tʰ e̞ n i sʰ ɯ d͡ʑ a̠ ŋ	테니스장
테러리스트	tʰ e̞ ɾ ʌ̹ ɾ i sʰ ɯ tʰ ɯ	테러리스트
테러범	tʰ e̞ ɾ ʌ̹ b ʌ̹ m	테러범
테레비	tʰ e̞ ɾ e̞ b i	테레비
테스트	tʰ e̞ sʰ ɯ tʰ ɯ	테스트
테이블	tʰ e̞ i b ɯ ɭ	테이블
테이프	tʰ e̞ i pʰ ɯ	테이프
테크네튬	tʰ e̞ k x ɯ n e̞ tʰ j u m	텍흐네튬
테헤란	tʰ e̞ ɦ e̞ ɾ a̠ n	테헤란
텍스트	tʰ e̞ k s͈ ɯ tʰ ɯ	텍쓰트
텐구	tʰ e̞ n ɡ u	텐구
텐트	tʰ e̞ n tʰ ɯ	텐트
텔레비	tʰ e̞ ɭ ɭ e̞ b i	텔레비
텔레비전	tʰ e̞ ɭ ɭ e̞ b i d͡ʑ ʌ̹ n	텔레비전
텔루르	tʰ e̞ ɭ ɭ u ɾ ɯ	텔루르
템플렛	tʰ e̞ m pʰ ɯ ɭ ɭ e̞ t̚	템플렏
톈진	tʰ j e̞ ɲ d͡ʑ i n	톈진
토고	tʰ o̞ ɡ o̞	토고
토끼	tʰ o̞ k͈ i	토끼
토네이도	tʰ o̞ n e̞ i d o̞	토네이도
토란	tʰ o̞ ɾ a̠ n	토란
토론	tʰ o̞ː ɾ o̞ n	토론
토바고	tʰ o̞ b a̠ ɡ o̞	토바고
토성	tʰ o̞ sʰ ʌ̹ ŋ	토성
토스터	tʰ o̞ sʰ ɯ tʰ ʌ̹	토스터
토스트	tʰ o̞ sʰ ɯ tʰ ɯ	토스트
토시	tʰ o̞ ɕʰ i	토시
토요일	tʰ o̞ j o i ɭ	토요일
토욕혼	tʰ o̞ j o kʰ o̞ n	토요콘
토우	tʰ o̞ u	토우
토의하다	tʰ o̞ː ɰ i ɦ a̠ d a̠	토의하다
토지	tʰ o̞ d͡ʑ i	토지
토착	tʰ o̞ t͡ɕʰ a̠ k̚	토착
토치	tʰ o̞ t͡ɕʰ i	토치
토픽	tʰ o̞ pʰ i k̚	토픽
통가	tʰ o̞ ŋ ɡ a̠	통가
통계	tʰ o̞ː ŋ ɡ j e̞	통계
통계학	tʰ o̞ː ŋ ɡ j e̞ ɦ a̠ k̚	통계학
통과	tʰ o̞ ŋ ɡ w a̠	통과
통과하다	tʰ o̞ ŋ ɡ w a̠ ɦ a̠ d a̠	통과하다
통근	tʰ o̞ ŋ ɡ ɯ n	통근
통근하다	tʰ o̞ ŋ ɡ ɯ n ɦ a̠ d a̠	통근하다
통금	tʰ o̞ ŋ ɡ ɯ m	통금
통념	tʰ o̞ ŋ ɲ j ʌ̹ m	통념
통로	tʰ o̞ ŋ n o̞	통노
통신	tʰ o̞ ŋ ɕʰ i n	통신
통역사	tʰ o̞ ŋ j ʌ̹ k s͈ a̠	토역싸
통일	tʰ o̞ː ŋ i ɭ	토일
통제	tʰ o̞ː ŋ d͡ʑ e̞	통제
통조림	tʰ o̞ ŋ d͡ʑ o̞ ɾ i m	통조림
통증	tʰ o̞ː ŋ t͡ɕ͈ ɯ ŋ	통쯩
통찰력	tʰ o̞ː ŋ t͡ɕʰ a̠ ʎ ʎ j ʌ̹ k̚	통찰력
통풍	tʰ o̞ː ŋ pʰ u ŋ	통풍
통하다	tʰ o̞ ŋ ɦ a̠ d a̠	통하다
통합	tʰ o̞ː ŋ ɦ a̠ p̚	통합
통화	tʰ o̞ ŋ β w a̠	통화
퇴비	tʰ w e̞ b i	퇴비
퇴위	tʰ w e̞ ɥ i	퇴위
퇴직금	tʰ w e̞ː d͡ʑ i k̚ k͈ ɯ m	퇴직끔
퇴진	tʰ w e̞ː d͡ʑ i n	퇴진
퇴폐	tʰ w e̞ pʰ j e̞	퇴폐
퇴학	tʰ w e̞ː ɦ a̠ k̚	퇴학
투구	tʰ u ɡ u	투구
투기	tʰ u ɡ i	투기
투명하다	tʰ u m j ʌ̹ ŋ ɦ a̠ d a̠	투명하다
투수	tʰ u sʰ u	투수
투옥	tʰ u o̞ k̚	투옥
투척	tʰ u t͡ɕʰ ʌ̹ k̚	투척
투탕카멘	tʰ u tʰ a̠ ŋ kʰ a̠ m e̞ n	투탕카멘
투표	tʰ u pʰ j o	투표
투표자	tʰ u pʰ j o d͡ʑ a̠	투표자
투표함	tʰ u pʰ j o ɦ a̠ m	투표함
투항	tʰ u ɦ a̠ ŋ	투항
퉁명스럽다	tʰ u ŋ m j ʌ̹ ŋ sʰ ɯ ɾ ʌ̹ p̚ t͈ a̠	퉁명스럽따
튀기다	tʰ ɥ i ɡ i d a̠	튀기다
튀김	tʰ ɥ i ɡ i m	튀김
튀니지	tʰ ɥ i n i d͡ʑ i	튀니지
튀다	tʰ ɥ i d a̠	튀다
튤립	tʰ j u ʎ ʎ i p̚	튤립
트다	tʰ ɯ d a̠	트다
트러스트	tʰ ɯ ɾ ʌ̹ sʰ ɯ tʰ ɯ	트러스트
트럼펫	tʰ ɯ ɾ ʌ̹ m pʰ e̞ t̚	트럼펟
트럼프	tʰ ɯ ɾ ʌ̹ m pʰ ɯ	트럼프
트렁크	tʰ ɯ ɾ ʌ̹ ŋ k x ɯ	트렁ㄱ흐
트레이너	tʰ ɯ ɾ e̞ i n ʌ̹	트레이너
트로트	tʰ ɯ ɾ o̞ tʰ ɯ	트로트
트로피	tʰ ɯ ɾ o̞ pʰ i	트로피
트로필륨	tʰ ɯ ɾ o̞ pʰ i ʎ ʎ j u m	트로필륨
트롤리	tʰ ɯ ɾ o̞ ʎ ʎ i	트롤리
트롱프뢰유	tʰ ɯ ɾ o̞ ŋ pʰ ɯ ɾ w e̞ j u	트롱프뢰유
트리케라톱스	tʰ ɯ ɾ i kʰ e̞ ɾ a̠ tʰ o̞ p s͈ ɯ	트리케라톱쓰
트림	tʰ ɯː ɾ i m	트림
트빌리시	tʰ ɯ b i ʎ ʎ i ɕʰ i	트빌리시
트이다	tʰ ɯ i d a̠	트이다
특권	tʰ ɯ k̚ k͈ w ʌ̹ n	특꿘
특급시	tʰ ɯ k̚ k͈ ɯ p ɕ͈ i	특끕씨
특기	tʰ ɯ k̚ k͈ i	특끼
특례	tʰ ɯ ŋ ɲ j e̞	틍녜
특별하다	tʰ ɯ k̚ p͈ j ʌ̹ ɾ ɦ a̠ d a̠	특뼐하다
특별히	tʰ ɯ k̚ p͈ j ʌ̹ ɾ ʝ i	특뼐히
특성	tʰ ɯ k s͈ ʌ̹ ŋ	특썽
특유	tʰ ɯ ɡ j u	트규
특정	tʰ ɯ k̚ t͡ɕ͈ ʌ̹ ŋ	특쩡
특정하다	tʰ ɯ k̚ t͡ɕ͈ ʌ̹ ŋ ɦ a̠ d a̠	특쩡하다
특징	tʰ ɯ k̚ t͡ɕ͈ i ŋ	특찡
튼튼하다	tʰ ɯ n tʰ ɯ n ɦ a̠ d a̠	튼튼하다
틀다	tʰ ɯ ɭ d a̠	틀다
틀리다	tʰ ɯ ʎ ʎ i d a̠	틀리다
틀림없다	tʰ ɯ ʎ ʎ i m ʌ̹ p̚ t͈ a̠	틀리멉따
틀림없이	tʰ ɯ ʎ ʎ i m ʌ̹ p ɕ͈ i	틀리멉씨
티끌	tʰ i k͈ ɯ ɭ	티끌
티라나	tʰ i ɾ a̠ n a̠	티라나
티라노사우루스	tʰ i ɾ a̠ n o̞ sʰ a̠ u ɾ u sʰ ɯ	티라노사우루스
티베트	tʰ i b e̞ tʰ ɯ	티베트
티브이	tʰ i b ɯ i	티브이
티셔츠	tʰ i ɕʰ ʌ̹ t͡ɕʰ ɯ	티서츠
티슈	tʰ i ɕʰ u	티수
티아졸	tʰ i a̠ d͡ʑ o̞ ɭ	티아졸
티오펜	tʰ i o̞ pʰ e̞ n	티오펜
티읕	tʰ i ɯ t̚	티읃
티켓	tʰ i kʰ e̞ t̚	티켇
티탄	tʰ i tʰ a̠ n	티탄
팅팅	tʰ i ŋ tʰ i ŋ	팅팅
파고다	pʰ a̠ ɡ o̞ d a̠	파고다
파괴	pʰ a̠ː ɡ w e̞	파괴
파나마	pʰ a̠ n a̠ m a̠	파나마
파다	pʰ a̠ d a̠	파다
파동	pʰ a̠ d o̞ ŋ	파동
파동함수	pʰ a̠ d o̞ ŋ ɦ a̠ m sʰ u	파동함수
파드닥	pʰ a̠ d ɯ d a̠ k̚	파드닥
파라과이	pʰ a̠ ɾ a̠ ɡ w a̠ i	파라과이
파라솔	pʰ a̠ ɾ a̠ sʰ o̞ ɭ	파라솔
파라오	pʰ a̠ ɾ a̠ o̞	파라오
파랑	pʰ a̠ ɾ a̠ ŋ	파랑
파렴치하다	pʰ a̠ː ɾ j ʌ̹ m t͡ɕʰ i ɦ a̠ d a̠	파렴치하다
파리	pʰ a̠ ɾ i	파리
파리하다	pʰ a̠ ɾ i ɦ a̠ d a̠	파리하다
파문	pʰ a̠ː m u n	파문
파벌	pʰ a̠ b ʌ̹ ɭ	파벌
파사삭	pʰ a̠ sʰ a̠ sʰ a̠ k̚	파사삭
파삭	pʰ a̠ sʰ a̠ k̚	파삭
파삭파삭	pʰ a̠ sʰ a̠ k̚ pʰ a̠ sʰ a̠ k̚	파삭파삭
파산	pʰ a̠ː sʰ a̠ n	파산
파슈토어	pʰ a̠ ɕʰ u tʰ o̞ ʌ̹	파수토어
파스타	pʰ a̠ sʰ ɯ tʰ a̠	파스타
파스텔	pʰ a̠ sʰ ɯ tʰ e̞ ɭ	파스텔
파슬리	pʰ a̠ sʰ ɯ ʎ ʎ i	파슬리
파시스트	pʰ a̠ ɕʰ i sʰ ɯ tʰ ɯ	파시스트
파시즘	pʰ a̠ ɕʰ i d͡ʑ ɯ m	파시즘
파업	pʰ a̠ː ʌ̹ p̚	파업
파운데이션	pʰ a̠ u n d e̞ i ɕʰ ʌ̹ n	파운데이선
파운드	pʰ a̠ u n d ɯ	파운드
파이	pʰ a̠ i	파이
파이프	pʰ a̠ i pʰ ɯ	파이프
파이프오르간	pʰ a̠ i pʰ ɯ o̞ ɾ ɯ ɡ a̠ n	파이프오르간
파인더	pʰ a̠ i n d ʌ̹	파인더
파일	pʰ a̠ i ɭ	파일
파자마	pʰ a̠ d͡ʑ a̠ m a̠	파자마
파장	pʰ a̠ d͡ʑ a̠ ŋ	파장
파출소	pʰ a̠ t͡ɕʰ u ɭ sʰ o̞	파출소
파친코	pʰ a̠ t͡ɕʰ i n kʰ o̞	파친코
파탄	pʰ a̠ː tʰ a̠ n	파탄
파트너	pʰ a̠ tʰ ɯ n ʌ̹	파트너
파트타임	pʰ a̠ tʰ ɯ tʰ a̠ i m	파트타임
파파라치	pʰ a̠ pʰ a̠ ɾ a̠ t͡ɕʰ i	파파라치
파파야	pʰ a̠ pʰ a̠ j a̠	파파야
판결	pʰ a̠ n ɡ j ʌ̹ ɭ	판결
판공실	pʰ a̠ n ɡ o̞ ŋ ɕʰ i ɭ	판공실
판권	pʰ a̠ n k͈ w ʌ̹ n	판꿘
판다	pʰ a̠ n d a̠	판다
판도	pʰ a̠ n d o̞	판도
판도라	pʰ a̠ n d o̞ ɾ a̠	판도라
판문점	pʰ a̠ n m u ɲ d͡ʑ ʌ̹ m	판문점
판소리	pʰ a̠ n s͈ o̞ ɾ i	판쏘리
판자	pʰ a̠ ɲ d͡ʑ a̠	판자
판지	pʰ a̠ ɲ d͡ʑ i	판지
판판하다	pʰ a̠ n pʰ a̠ n ɦ a̠ d a̠	판판하다
팔각	pʰ a̠ ɭ ɡ a̠ k̚	팔각
팔걸이	pʰ a̠ ɭ ɡ ʌ̹ ɾ i	팔거리
팔극권	pʰ a̠ ɭ ɡ ɯ k̚ k͈ w ʌ̹ n	팔극꿘
팔꿈치	pʰ a̠ ɭ k͈ u m t͡ɕʰ i	팔꿈치
팔다	pʰ a̠ ɭ d a̠	팔다
팔다리	pʰ a̠ ɭ d a̠ ɾ i	팔다리
팔딱	pʰ a̠ ɭ t͈ a̠ k̚	팔딱
팔뚝	pʰ a̠ ɭ t͈ u k̚	팔뚝
팔라듐	pʰ a̠ ɭ ɭ a̠ d j u m	팔라듐
팔라우	pʰ a̠ ɭ ɭ a̠ u	팔라우
팔랑귀	pʰ a̠ ɭ ɭ a̠ ŋ ɡ ɥ i	팔랑귀
팔레스타인	pʰ a̠ ɭ ɭ e̞ sʰ ɯ tʰ a̠ i n	팔레스타인
팔목	pʰ a̠ ɭ m o̞ k̚	팔목
팔미트산	pʰ a̠ ɭ m i tʰ ɯ sʰ a̠ n	팔미트산
팔방미인	pʰ a̠ ɭ b a̠ ŋ m i i n	팔방미인
팔팔하다	pʰ a̠ ɭ pʰ a̠ ɾ ɦ a̠ d a̠	팔팔하다
팝콘	pʰ a̠ p̚ kʰ o̞ n	팝콘
팥빙수	pʰ a̠ t̚ p͈ i ŋ sʰ u	팓삥수
패권	pʰ ɛː k͈ w ʌ̹ n	패꿘
패전	pʰ ɛː d͡ʑ ʌ̹ n	패전
퍼센트	pʰ ʌ̹ sʰ e̞ n tʰ ɯ	퍼센트
펄떡	pʰ ʌ̹ ɭ t͈ ʌ̹ k̚	펄떡
펄럭펄럭	pʰ ʌ̹ ɭ ɭ ʌ̹ k̚ pʰ ʌ̹ ɭ ɭ ʌ̹ k̚	펄럭펄럭
페놀	pʰ e̞ n o̞ ɭ	페놀
페니	pʰ e̞ n i	페니
페닐기	pʰ e̞ n i ɭ ɡ i	페닐기
페달	pʰ e̞ d a̠ ɭ	페달
페르샤어	pʰ e̞ ɾ ɯ ɕʰ a̠ ʌ̹	페르사어
페르시아	pʰ e̞ ɾ ɯ ɕʰ i a̠	페르시아
페미니즘	pʰ e̞ m i n i d͡ʑ ɯ m	페미니즘
페샤와르	pʰ e̞ ɕʰ a̠ w a̠ ɾ ɯ	페사와르
페스트	pʰ e̞ sʰ ɯ tʰ ɯ	페스트
페이지	pʰ e̞ i d͡ʑ i	페이지
펜션	pʰ e̞ n ɕʰ ʌ̹ n	펜선
펠리컨	pʰ e̞ ʎ ʎ i kʰ ʌ̹ n	펠리컨
펩타이드	pʰ e̞ p̚ tʰ a̠ i d ɯ	펩타이드
펩티드	pʰ e̞ p̚ tʰ i d ɯ	펩티드
펭귄	pʰ e̞ ŋ ɡ ɥ i n	펭귄
펴다	pʰ j ʌ̹ d a̠	펴다
편견	pʰ j ʌ̹ n ɡ j ʌ̹ n	편견
편경	pʰ j ʌ̹ n ɡ j ʌ̹ ŋ	편경
편도	pʰ j ʌ̹ n d o̞	편도
편람	pʰ j ʌ̹ ɭ ɭ a̠ m	펼람
편리하다	pʰ j ʌ̹ ʎ ʎ i ɦ a̠ d a̠	펼리하다
편린	pʰ j ʌ̹ ʎ ʎ i n	펼린
편복	pʰ j ʌ̹ n b o̞ k̚	편복
편성	pʰ j ʌ̹ n sʰ ʌ̹ ŋ	편성
편안하다	pʰ j ʌ̹ n a̠ n ɦ a̠ d a̠	펴난하다
편의	pʰ j ʌ̹ n ɰ i	펴늬
편의점	pʰ j ʌ̹ n ɰ i d͡ʑ ʌ̹ m	펴늬점
편자	pʰ j ʌ̹ ɲ d͡ʑ a̠	편자
편종	pʰ j ʌ̹ ɲ d͡ʑ o̞ ŋ	편종
편중	pʰ j ʌ̹ ɲ d͡ʑ u ŋ	편중
편지	pʰ j ɘː ɲ d͡ʑ i	편지
편집	pʰ j ʌ̹ ɲ d͡ʑ i p̚	편집
편집자	pʰ j ʌ̹ ɲ d͡ʑ i p̚ t͡ɕ͈ a̠	편집짜
편찮다	pʰ j ʌ̹ ɲ t͡ɕʰ a̠ n tʰ a̠	편찬타
편찮으시다	pʰ j ʌ̹ ɲ t͡ɕʰ a̠ n ɯ ɕʰ i d a̠	편차느시다
편하다	pʰ j ʌ̹ n ɦ a̠ d a̠	편하다
펼쳐지다	pʰ j ʌ̹ ʎ t͡ɕʰ ʌ̹ d͡ʑ i d a̠	펼처지다
펼치다	pʰ j ʌ̹ ʎ t͡ɕʰ i d a̠	펼치다
폄하	pʰ j ɘː m ɦ a̠	폄하
폄훼	pʰ j ɘː m β w e̞	폄훼
평가	pʰ j ɘː ŋ k͈ a̠	평까
평균	pʰ j ʌ̹ ŋ ɡ j u n	평균
평면	pʰ j ʌ̹ ŋ m j ʌ̹ n	평면
평민	pʰ j ʌ̹ ŋ m i n	평민
평범하다	pʰ j ʌ̹ ŋ b ʌ̹ m ɦ a̠ d a̠	평범하다
평상	pʰ j ʌ̹ ŋ sʰ a̠ ŋ	평상
평성	pʰ j ʌ̹ ŋ sʰ ʌ̹ ŋ	평성
평소	pʰ j ʌ̹ ŋ sʰ o̞	평소
평수	pʰ j ʌ̹ ŋ s͈ u	평쑤
평안남도	pʰ j ʌ̹ ŋ a̠ n n a̠ m d o̞	펴안남도
평야	pʰ j ʌ̹ ŋ j a̠	펴야
평양	pʰ j ʌ̹ ŋ j a̠ ŋ	펴양
평온	pʰ j ʌ̹ ŋ o̞ n	펴온
평의회	pʰ j ɘː ŋ ɰ i β w e̞	펴의회
평일	pʰ j ʌ̹ ŋ i ɭ	펴일
평정	pʰ j ʌ̹ ŋ d͡ʑ ʌ̹ ŋ	평정
평창	pʰ j ʌ̹ ŋ t͡ɕʰ a̠ ŋ	평창
평판	pʰ j ɘː ŋ pʰ a̠ n	평판
평형	pʰ j ʌ̹ ŋ ʝ j ʌ̹ ŋ	평형
평화	pʰ j ʌ̹ ŋ β w a̠	평화
폐경	pʰ j e̞ː ɡ j ʌ̹ ŋ	폐경
폐급	pʰ j e̞ː k͈ ɯ p̚	폐끕
폐기종	pʰ j e̞ː ɡ i d͡ʑ o̞ ŋ	폐기종
폐단	pʰ j e̞ː d a̠ n	폐단
폐렴	pʰ j e̞ː ɾ j ʌ̹ m	폐렴
폐어	pʰ j e̞ː ʌ̹	폐어
폐지	pʰ j e̞ː d͡ʑ i	폐지
폐회식	pʰ j e̞ː β w e̞ ɕʰ i k̚	폐회식
포도	pʰ o̞ d o̞	포도
포도주	pʰ o̞ d o̞ d͡ʑ u	포도주
포럼	pʰ o̞ ɾ ʌ̹ m	포럼
포르투갈어	pʰ o̞ ɾ ɯ tʰ u ɡ a̠ ɾ ʌ̹	포르투가러
포름알데히드	pʰ o̞ ɾ ɯ m a̠ ɭ d e̞ ʝ i d ɯ	포르말데히드
포부	pʰ o̞ː b u	포부
포삭	pʰ o̞ sʰ a̠ k̚	포삭
포스터	pʰ o̞ sʰ ɯ tʰ ʌ̹	포스터
포슬포슬	pʰ o̞ sʰ ɯ ɭ pʰ o̞ sʰ ɯ ɭ	포슬포슬
포옹	pʰ o̞ː o̞ ŋ	포옹
포옹하다	pʰ o̞ː o̞ ŋ ɦ a̠ d a̠	포옹하다
포유류	pʰ o̞ː j u ɾ j u	포유류
포인트	pʰ o̞ i n tʰ ɯ	포인트
포자	pʰ o̞ d͡ʑ a̠	포자
포치	pʰ o̞ t͡ɕʰ i	포치
포크	pʰ o̞ k x ɯ	폭흐
포탈	pʰ o̞ tʰ a̠ ɭ	포탈
포트	pʰ o̞ tʰ ɯ	포트
포트루이스	pʰ o̞ tʰ ɯ ɾ u i sʰ ɯ	포트루이스
포플러	pʰ o̞ pʰ ɯ ɭ ɭ ʌ̹	포플러
포피	pʰ o̞ pʰ i	포피
포함	pʰ o̞ ɦ a̠ m	포함
포화	pʰ o̞ː β w a̠	포화
폭격기	pʰ o̞ k̚ k͈ j ʌ̹ k̚ k͈ i	폭껵끼
폭넓다	pʰ o̞ ŋ n ʌ̹ ɭ t͈ a̠	퐁널따
폭동	pʰ o̞ k̚ t͈ o̞ ŋ	폭똥
폭력	pʰ o̞ ŋ ɲ j ʌ̹ k̚	퐁녁
폭발	pʰ o̞ k̚ p͈ a̠ ɭ	폭빨
폭정	pʰ o̞ k̚ t͡ɕ͈ ʌ̹ ŋ	폭쩡
폭탄	pʰ o̞ k̚ tʰ a̠ n	폭탄
폭파	pʰ o̞ k̚ pʰ a̠	폭파
폭풍	pʰ o̞ k̚ pʰ u ŋ	폭풍
폭풍우	pʰ o̞ k̚ pʰ u ŋ u	폭푸우
폴란드	pʰ o̞ ɭ ɭ a̠ n d ɯ	폴란드
폴란드인	pʰ o̞ ɭ ɭ a̠ n d ɯ i n	폴란드인
폴로	pʰ o̞ ɭ ɭ o̞	폴로
폴로늄	pʰ o̞ ɭ ɭ o̞ ɲ j u m	폴로늄
폴리프로필렌	pʰ o̞ ʎ ʎ i pʰ ɯ ɾ o̞ pʰ i ɭ ɭ e̞ n	폴리프로필렌
퐁뒤	pʰ o̞ ŋ d ɥ i	퐁뒤
표고	pʰ j o ɡ o̞	표고
표고버섯	pʰ j o ɡ o̞ b ʌ̹ sʰ ʌ̹ t̚	표고버섣
표면	pʰ j o m j ʌ̹ n	표면
표절	pʰ j o d͡ʑ ʌ̹ ɭ	표절
표제	pʰ j o d͡ʑ e̞	표제
표제어	pʰ j o d͡ʑ e̞ ʌ̹	표제어
표준어	pʰ j o d͡ʑ u n ʌ̹	표주너
표준화	pʰ j oː d͡ʑ u n β w a̠	표준화
표지	pʰ j o d͡ʑ i	표지
표지판	pʰ j o d͡ʑ i pʰ a̠ n	표지판
표하다	pʰ j oː ɦ a̠ d a̠	표하다
표현	pʰ j o ʝ j ʌ̹ n	표현
표현하다	pʰ j o ʝ j ʌ̹ n ɦ a̠ d a̠	표현하다
푸껫	pʰ u k͈ e̞ t̚	푸껟
푸다	pʰ u d a̠	푸다
푸르다	pʰ u ɾ ɯ d a̠	푸르다
푸르스름하다	pʰ u ɾ ɯ sʰ ɯ ɾ ɯ m ɦ a̠ d a̠	푸르스름하다
푸서석푸서석	pʰ u sʰ ʌ̹ sʰ ʌ̹ k̚ pʰ u sʰ ʌ̹ sʰ ʌ̹ k̚	푸서석푸서석
푸석	pʰ u sʰ ʌ̹ k̚	푸석
푸젠	pʰ u d͡ʑ e̞ n	푸젠
푸짐하다	pʰ u d͡ʑ i m ɦ a̠ d a̠	푸짐하다
풀네임	pʰ u ɭ ɭ e̞ i m	풀레임
풀발	pʰ u ɭ b a̠ ɭ	풀발
풀이	pʰ u ɾ i	푸리
품갚음하다	pʰ u m ɡ a̠ pʰ ɯ m ɦ a̠ d a̠	품가픔하다
품격	pʰ uː m k͈ j ʌ̹ k̚	품껵
품다	pʰ uː m t͈ a̠	품따
품목	pʰ uː m m o̞ k̚	품목
풋볼	pʰ u t̚ p͈ o̞ ɭ	푿뽈
풋옵션	pʰ u d o̞ p ɕ͈ ʌ̹ n	푸돕썬
풍경	pʰ u ŋ ɡ j ʌ̹ ŋ	풍경
풍금	pʰ u ŋ ɡ ɯ m	풍금
풍덩풍덩	pʰ u ŋ d ʌ̹ ŋ pʰ u ŋ d ʌ̹ ŋ	풍덩풍덩
풍력단지	pʰ u ŋ ɲ j ʌ̹ k̚ t͈ a̠ ɲ d͡ʑ i	풍녁딴지
풍미	pʰ u ŋ m i	풍미
풍부	pʰ u ŋ b u	풍부
풍부하다	pʰ u ŋ b u ɦ a̠ d a̠	풍부하다
풍선	pʰ u ŋ sʰ ʌ̹ n	풍선
풍속	pʰ u ŋ sʰ o̞ k̚	풍속
풍수	pʰ u ŋ sʰ u	풍수
풍습	pʰ u ŋ sʰ ɯ p̚	풍습
풍요	pʰ u ŋ j o	푸요
풍자문	pʰ u ŋ d͡ʑ a̠ m u n	풍자문
퓨라잔	pʰ j u ɾ a̠ d͡ʑ a̠ n	퓨라잔
퓨마	pʰ j u m a̠	퓨마
프디	pʰ ɯ d i	프디
프라하	pʰ ɯ ɾ a̠ ɦ a̠	프라하
프랑스	pʰ ɯ ɾ a̠ ŋ sʰ ɯ	프랑스
프랑스빵	pʰ ɯ ɾ a̠ ŋ sʰ ɯ p͈ a̠ ŋ	프랑스빵
프랑스어	pʰ ɯ ɾ a̠ ŋ sʰ ɯ ʌ̹	프랑스어
프러포즈	pʰ ɯ ɾ ʌ̹ pʰ o̞ d͡ʑ ɯ	프러포즈
프런트	pʰ ɯ ɾ ʌ̹ n tʰ ɯ	프런트
프레젠테이션	pʰ ɯ ɾ e̞ d͡ʑ e̞ n tʰ e̞ i ɕʰ ʌ̹ n	프레젠테이선
프로	pʰ ɯ ɾ o̞	프로
프로세서	pʰ ɯ ɾ o̞ sʰ e̞ sʰ ʌ̹	프로세서
프로세스	pʰ ɯ ɾ o̞ sʰ e̞ sʰ ɯ	프로세스
프로젝트	pʰ ɯ ɾ o̞ d͡ʑ e̞ k̚ tʰ ɯ	프로젝트
프로트악티늄	pʰ ɯ ɾ o̞ tʰ ɯ a̠ k̚ tʰ i ɲ j u m	프로트악티늄
프로파길	pʰ ɯ ɾ o̞ pʰ a̠ ɡ i ɭ	프로파길
프로판	pʰ ɯ ɾ o̞ pʰ a̠ n	프로판
프로펠러	pʰ ɯ ɾ o̞ pʰ e̞ ɭ ɭ ʌ̹	프로펠러
프로필렌	pʰ ɯ ɾ o̞ pʰ i ɭ ɭ e̞ n	프로필렌
프리즘	pʰ ɯ ɾ i d͡ʑ ɯ m	프리즘
프리지어	pʰ ɯ ɾ i d͡ʑ i ʌ̹	프리지어
프리토리아	pʰ ɯ ɾ i tʰ o̞ ɾ i a̠	프리토리아
프린터	pʰ ɯ ɾ i n tʰ ʌ̹	프린터
프탈라진	pʰ ɯ tʰ a̠ ɭ ɭ a̠ d͡ʑ i n	프탈라진
플라스마	pʰ ɯ ɭ ɭ a̠ sʰ ɯ m a̠	플라스마
플라스틱	pʰ ɯ ɭ ɭ a̠ sʰ ɯ tʰ i k̚	플라스틱
플러그	pʰ ɯ ɭ ɭ ʌ̹ ɡ ɯ	플러그
플러그인	pʰ ɯ ɭ ɭ ʌ̹ ɡ ɯ i n	플러그인
플러스	pʰ ɯ ɭ ɭ ʌ̹ sʰ ɯ	플러스
플루오렌	pʰ ɯ ɭ ɭ u o̞ ɾ e̞ n	플루오렌
플루토늄	pʰ ɯ ɭ ɭ u tʰ o̞ ɲ j u m	플루토늄
플루트	pʰ ɯ ɭ ɭ u tʰ ɯ	플루트
플립플롭	pʰ ɯ ʎ ʎ i p̚ pʰ ɯ ɭ ɭ o̞ p̚	플립플롭
피고	pʰ iː ɡ o̞	피고
피난	pʰ iː n a̠ n	피난
피난처	pʰ iː n a̠ ɲ t͡ɕʰ ʌ̹	피난처
피다	pʰ i d a̠	피다
피라미드	pʰ i ɾ a̠ m i d ɯ	피라미드
피란	pʰ i ɾ a̠ n	피란
피롤	pʰ i ɾ o̞ ɭ	피롤
피리딘	pʰ i ɾ i d i n	피리딘
피망	pʰ i m a̠ ŋ	피망
피부	pʰ i b u	피부
피스타치오	pʰ i sʰ ɯ tʰ a̠ t͡ɕʰ i o̞	피스타치오
피시	pʰ i ɕ͈ i	피씨
피시방	pʰ i ɕ͈ i b a̠ ŋ	피씨방
피아니스트	pʰ i a̠ n i sʰ ɯ tʰ ɯ	피아니스트
피에로	pʰ i e̞ ɾ o̞	피에로
피우다	pʰ i u d a̠	피우다
피워	pʰ i w ʌ̹	피워
피임	pʰ iː i m	피임
피임약	pʰ iː i m j a̠ k̚	피이먁
피지	pʰ i d͡ʑ i	피지
피크닉	pʰ i k x ɯ n i k̚	픽흐닉
피페리딘	pʰ i pʰ e̞ ɾ i d i n	피페리딘
피폭자	pʰ i pʰ o̞ k̚ t͡ɕ͈ a̠	피폭짜
피하다	pʰ iː ɦ a̠ d a̠	피하다
피혁	pʰ i ʝ j ʌ̹ k̚	피혁
픽업	pʰ i ɡ ʌ̹ p̚	피겁
핀란드	pʰ i ɭ ɭ a̠ n d ɯ	필란드
핀셋	pʰ i n sʰ e̞ t̚	핀섿
필름	pʰ i ɭ ɭ ɯ m	필름
필리핀	pʰ i ʎ ʎ i pʰ i n	필리핀
필수	pʰ i ɭ sʰ u	필수
필수적	pʰ i ɭ s͈ u d͡ʑ ʌ̹ k̚	필쑤적
필승	pʰ i ɭ s͈ ɯ ŋ	필씅
필요	pʰ i ɾ j o	피료
필요성	pʰ i ɾ j o s͈ ʌ̹ ŋ	피료썽
필요하다	pʰ i ɾ j o ɦ a̠ d a̠	피료하다
필자	pʰ i ʎ t͡ɕ͈ a̠	필짜
필터	pʰ i ɭ tʰ ʌ̹	필터
필통	pʰ i ɭ tʰ o̞ ŋ	필통
필획	pʰ i ɾ β w e̞ k̚	필획
핍박	pʰ i p̚ p͈ a̠ k̚	핍빡
핑계	pʰ i ŋ ɡ j e̞	핑계
핑퐁	pʰ i ŋ pʰ o̞ ŋ	핑퐁
하강	h a̠ː ɡ a̠ ŋ	하강
하고	h a̠ ɡ o̞	하고
하극상	h a̠ː ɡ ɯ k s͈ a̠ ŋ	하극쌍
하나	h a̠ n a̠	하나
하나님	h a̠ n a̠ n i m	하나님
하남	h a̠ n a̠ m	하남
하녀	h a̠ː ɲ j ʌ̹	하녀
하느님	h a̠ n ɯ n i m	하느님
하느작	h a̠ n ɯ d͡ʑ a̠ k̚	하느작
하늘	h a̠ n ɯ ɭ	하늘
하늘나라	h a̠ n ɯ ɭ ɭ a̠ ɾ a̠	하늘라라
하다	h a̠ d a̠	하다
하도	h a̠ d o̞	하도
하루빨리	h a̠ ɾ u p͈ a̠ ʎ ʎ i	하루빨리
하루살이	h a̠ ɾ u sʰ a̠ ɾ i	하루사리
하마	h a̠ m a̠	하마
하수도	h a̠ː sʰ u d o̞	하수도
하숙집	h a̠ː sʰ u k̚ t͡ɕ͈ i p̚	하숙찝
하시다	h a̠ ɕʰ i d a̠	하시다
하양	h a̠ j a̠ ŋ	하양
하얗다	h a̠ː j a̠ tʰ a̠	하야타
하여간	h a̠ j ʌ̹ ɡ a̠ n	하여간
하와	h a̠ w a̠	하와
하원	h a̠ː w ʌ̹ n	하원
하위	h a̠ ɥ i	하위
하이난	h a̠ i n a̠ n	하이난
하이드라진	h a̠ i d ɯ ɾ a̠ d͡ʑ i n	하이드라진
하이에나	h a̠ i e̞ n a̠	하이에나
하이퍼	h a̠ i pʰ ʌ̹	하이퍼
하인	h a̠ː i n	하인
하자	h a̠ d͡ʑ a̠	하자
하즈	h a̠ d͡ʑ ɯ	하즈
하지만	h a̠ d͡ʑ i m a̠ n	하지만
하천	h a̠ t͡ɕʰ ʌ̹ n	하천
하퇴삼두근	h a̠ tʰ w e̞ sʰ a̠ m d u ɡ ɯ n	하퇴삼두근
하트	h a̠ tʰ ɯ	하트
하품	h a̠ pʰ u m	하품
하프	h a̠ pʰ ɯ	하프
하플로그룹	h a̠ pʰ ɯ ɭ ɭ o̞ ɡ ɯ ɾ u p̚	하플로그룹
하필	h a̠ pʰ i ɭ	하필
학과	h a̠ k̚ k͈ w a̠	학꽈
학교	h a̠ k̚ k͈ j o	학꾜
학구	h a̠ k̚ k͈ u	학꾸
학급	h a̠ k̚ k͈ ɯ p̚	학끕
학기	h a̠ k̚ k͈ i	학끼
학년	h a̠ ŋ ɲ j ʌ̹ n	항년
학력	h a̠ ŋ ɲ j ʌ̹ k̚	항녁
학명	h a̠ ŋ m j ʌ̹ ŋ	항명
학문	h a̠ ŋ m u n	항문
학번	h a̠ k̚ p͈ ʌ̹ n	학뻔
학벌	h a̠ k̚ p͈ ʌ̹ ɭ	학뻘
학사	h a̠ k s͈ a̠	학싸
학살	h a̠ k s͈ a̠ ɭ	학쌀
학설	h a̠ k s͈ ʌ̹ ɭ	학썰
학술	h a̠ k s͈ u ɭ	학쑬
학습	h a̠ k s͈ ɯ p̚	학씁
학식	h a̠ k ɕ͈ i k̚	학씩
학원	h a̠ ɡ w ʌ̹ n	하권
학자	h a̠ k̚ t͡ɕ͈ a̠	학짜
학회	h a̠ kʰ w e̞	하쾨
한가	h a̠ n ɡ a̠	한가
한가위	h a̠ n ɡ a̠ ɥ i	한가위
한겨레	h a̠ n ɡ j ʌ̹ ɾ e̞	한겨레
한국	h a̠ː n ɡ u k̚	한국
한국말	h a̠ː n ɡ u ŋ m a̠ ɭ	한궁말
한국인	h a̠ː n ɡ u ɡ i n	한구긴
한국학	h a̠ː n ɡ u kʰ a̠ k̚	한구칵
한글	h a̠ː n ɡ ɯ ɭ	한글
한글날	h a̠ː n ɡ ɯ ɭ ɭ a̠ ɭ	한글랄
한꺼번에	h a̠ n k͈ ʌ̹ b ʌ̹ n e̞	한꺼버네
한도	h a̠ː n d o̞	한도
한동안	h a̠ n d o̞ ŋ a̠ n	한도안
한두	h a̠ n d u	한두
한둘	h a̠ n d u ɭ	한둘
한라산	h a̠ː ɭ ɭ a̠ sʰ a̠ n	할라산
한림원	h a̠ ʎ ʎ i m w ʌ̹ n	할리뭔
한마디	h a̠ n m a̠ d i	한마디
한물	h a̠ n m u ɭ	한물
한민족	h a̠ː n m i ɲ d͡ʑ o̞ k̚	한민족
한반도	h a̠ː n b a̠ n d o̞	한반도
한복	h a̠ː n b o̞ k̚	한복
한사군	h a̠ː n sʰ a̠ ɡ u n	한사군
한성	h a̠ː n sʰ ʌ̹ ŋ	한성
한숨	h a̠ n sʰ u m	한숨
한시름	h a̠ n ɕʰ i ɾ ɯ m	한시름
한식집	h a̠ n ɕ͈ i k̚ t͡ɕ͈ i p̚	한씩찝
한약	h a̠ː ɲ j a̠ k̚	하냑
한양	h a̠ː ɲ j a̠ ŋ	하냥
한어	h a̠ː n ʌ̹	하너
한여름	h a̠ n ɲ j ʌ̹ ɾ ɯ m	한녀름
한영	h a̠ː ɲ j ʌ̹ ŋ	하녕
한자어	h a̠ː ɲ t͡ɕ͈ a̠ ʌ̹	한짜어
한잔	h a̠ ɲ d͡ʑ a̠ n	한잔
한정되다	h a̠ ɲ d͡ʑ ʌ̹ ŋ d w e̞ d a̠	한정되다
한중	h a̠ː ɲ d͡ʑ u ŋ	한중
한참	h a̠ ɲ t͡ɕʰ a̠ m	한참
한테	h a̠ n tʰ e̞	한테
한편	h a̠ n pʰ j ʌ̹ n	한편
할라페뇨	h a̠ ɭ ɭ a̠ pʰ e̞ ɲ j o	할라페뇨
할로윈	h a̠ ɭ ɭ o̞ ɥ i n	할로윈
할머니	h a̠ ɭ m ʌ̹ n i	할머니
할머님	h a̠ ɭ m ʌ̹ n i m	할머님
할미꽃	h a̠ ɭ m i k͈ o̞ t̚	할미꼳
할아버지	h a̠ ɾ a̠ b ʌ̹ d͡ʑ i	하라버지
할인	h a̠ ɾ i n	하린
할퀴다	h a̠ ɭ kʰ ɥ i d a̠	할퀴다
함경	h a̠ m ɡ j ʌ̹ ŋ	함경
함경남도	h a̠ m ɡ j ʌ̹ ŋ n a̠ m d o̞	함경남도
함경북도	h a̠ m ɡ j ʌ̹ ŋ b u k̚ t͈ o̞	함경북또
함구증	h a̠ m ɡ u t͡ɕ͈ ɯ ŋ	함구쯩
함께	h a̠ m k͈ e̞	함께
함께하다	h a̠ m k͈ e̞ ɦ a̠ d a̠	함께하다
함량	h a̠ m ɲ j a̠ ŋ	함냥
함묵증	h a̠ m m u k̚ t͡ɕ͈ ɯ ŋ	함묵쯩
함부로	h a̠ m b u ɾ o̞	함부로
함성	h a̠ m sʰ ʌ̹ ŋ	함성
함수	h a̠ː m s͈ u	함쑤
함흥	h a̠ m ɣ ɯ ŋ	함ɣㅡㅇ
합격	h a̠ p̚ k͈ j ʌ̹ k̚	합껵
합계	h a̠ p̚ k͈ j e̞	합꼐
합금	h a̠ p̚ k͈ ɯ m	합끔
합기도	h a̠ p̚ k͈ i d o̞	합끼도
합법	h a̠ p̚ p͈ ʌ̹ p̚	합뻡
합법화	h a̠ p̚ p͈ ʌ̹ pʰ w a̠	합뻐퐈
합법화되다	h a̠ p̚ p͈ ʌ̹ pʰ w a̠ d w e̞ d a̠	합뻐퐈되다
합성록음하다	h a̠ p s͈ ʌ̹ ŋ n o̞ ɡ ɯ m ɦ a̠ d a̠	합썽노금하다
합성어	h a̠ p s͈ ʌ̹ ŋ ʌ̹	합써어
합스부르크	h a̠ p s͈ ɯ b u ɾ ɯ k x ɯ	합쓰부륵흐
합작	h a̠ p̚ t͡ɕ͈ a̠ k̚	합짝
합중국	h a̠ p̚ t͡ɕ͈ u ŋ ɡ u k̚	합쭝국
합창	h a̠ p̚ t͡ɕʰ a̠ ŋ	합창
합창단	h a̠ p̚ t͡ɕʰ a̠ ŋ d a̠ n	합창단
합체	h a̠ p̚ t͡ɕʰ e̞	합체
핫도그	h a̠ t̚ t͈ o̞ ɡ ɯ	핟또그
항공기	h a̠ː ŋ ɡ o̞ ŋ ɡ i	항공기
항공사	h a̠ː ŋ ɡ o̞ ŋ sʰ a̠	항공사
항복	h a̠ ŋ b o̞ k̚	항복
항상	h a̠ ŋ sʰ a̠ ŋ	항상
항성	h a̠ ŋ sʰ ʌ̹ ŋ	항성
항아리	h a̠ ŋ a̠ ɾ i	하아리
항암제	h a̠ː ŋ a̠ m d͡ʑ e̞	하암제
항의	h a̠ː ŋ ɰ i	하의
항일	h a̠ː ŋ i ɭ	하일
항체	h a̠ ŋ t͡ɕʰ e̞	항체
해결	h ɛː ɡ j ʌ̹ ɭ	해결
해결되다	h ɛː ɡ j ʌ̹ ɭ d w e̞ d a̠	해결되다
해고	h ɛː ɡ o̞	해고
해고하다	h ɛː ɡ o̞ ɦ a̠ d a̠	해고하다
해군	h ɛː ɡ u n	해군
해금	h ɛː ɡ ɯ m	해금
해녀	h ɛː ɲ j ʌ̹	해녀
해달	h ɛː d a̠ ɭ	해달
해도	h ɛː d o̞	해도
해리	h ɛː ɾ i	해리
해마	h ɛː m a̠	해마
해면	h ɛː m j ʌ̹ n	해면
해물	h ɛː m u ɭ	해물
해변	h ɛː b j ʌ̹ n	해변
해병	h ɛː b j ʌ̹ ŋ	해병
해부학	h ɛː b u ɦ a̠ k̚	해부학
해산물	h ɛː sʰ a̠ n m u ɭ	해산물
해삼	h ɛː sʰ a̠ m	해삼
해상도	h ɛː sʰ a̠ ŋ d o̞	해상도
해석하다	h ɛː sʰ ʌ̹ kʰ a̠ d a̠	해서카다
해소	h ɛː sʰ o̞	해소
해안	h ɛː a̠ n	해안
해열	h ɛː j ʌ̹ ɭ	해열
해왕성	h ɛː w a̠ ŋ sʰ ʌ̹ ŋ	해왕성
해외	h ɛː w e̞	해외
해일	h ɛː i ɭ	해일
해장	h ɛː d͡ʑ a̠ ŋ	해장
해저	h ɛː d͡ʑ ʌ̹	해저
해제	h ɛː d͡ʑ e̞	해제
해주	h ɛː d͡ʑ u	해주
해파리	h ɛː pʰ a̠ ɾ i	해파리
행복	h ɛː ŋ b o̞ k̚	행복
행운	h ɛː ŋ u n	해운
행운아	h ɛː ŋ u n a̠	해우나
행인	h ɛː ŋ i n	해인
허가	h ʌ̹ ɡ a̠	허가
허락	h ʌ̹ ɾ a̠ k̚	허락
허락하다	h ʌ̹ ɾ a̠ kʰ a̠ d a̠	허라카다
허리	h ʌ̹ ɾ i	허리
허리띠	h ʌ̹ ɾ i t͈ i	허리띠
허리케인	h ʌ̹ ɾ i kʰ e̞ i n	허리케인
허무주의	h ʌ̹ m u d͡ʑ u ɰ i	허무주의
허물다	h ʌ̹ m u ɭ d a̠	허물다
허베이	h ʌ̹ b e̞ i	허베이
허브티	h ʌ̹ b ɯ tʰ i	허브티
허수	h ʌ̹ sʰ u	허수
허술하다	h ʌ̹ sʰ u ɾ ɦ a̠ d a̠	허술하다
허영심	h ʌ̹ j ʌ̹ ŋ ɕʰ i m	허영심
허용	h ʌ̹ j o ŋ	허용
허허	h ʌ̹ ɦ ʌ̹	허허
헌금	h ɘː n ɡ ɯ m	헌금
헌법	h ɘː n p͈ ʌ̹ p̚	헌뻡
헌팅	h ʌ̹ n tʰ i ŋ	헌팅
험담	h ɘː m d a̠ m	험담
헛걸음	h ʌ̹ t̚ k͈ ʌ̹ ɾ ɯ m	헏꺼름
헛방귀	h ʌ̹ t̚ p͈ a̠ ŋ ɡ ɥ i	헏빵귀
헝가리	h ʌ̹ ŋ ɡ a̠ ɾ i	헝가리
헤드폰	h e̞ d ɯ pʰ o̞ n	헤드폰
헤로인	h e̞ ɾ o̞ i n	헤로인
헤르메스	h e̞ ɾ ɯ m e̞ sʰ ɯ	헤르메스
헤르츠	h e̞ ɾ ɯ t͡ɕʰ ɯ	헤르츠
헤모글로빈	h e̞ m o̞ ɡ ɯ ɭ ɭ o̞ b i n	헤모글로빈
헤아리다	h e̞ː a̠ ɾ i d a̠	헤아리다
헤어지다	h e̞ ʌ̹ d͡ʑ i d a̠	헤어지다
헤엄치다	h e̞ ʌ̹ m t͡ɕʰ i d a̠	헤엄치다
헤파이스토스	h e̞ pʰ a̠ i sʰ ɯ tʰ o̞ sʰ ɯ	헤파이스토스
헬기	h e̞ ɭ ɡ i	헬기
헬륨	h e̞ ʎ ʎ j u m	헬륨
헬리콥터	h e̞ ʎ ʎ i kʰ o̞ p̚ tʰ ʌ̹	헬리콥터
헬멧	h e̞ ɭ m e̞ t̚	헬멛
헬스클럽	h e̞ ɭ sʰ ɯ k x ɯ ɭ ɭ ʌ̹ p̚	헬슥흘럽
헵테인	h e̞ p̚ tʰ e̞ i n	헵테인
호기심	ɸʷ o̞ː ɡ i ɕʰ i m	호기심
호남	ɸʷ o̞ n a̠ m	호남
호놀룰루	ɸʷ o̞ n o̞ ɭ ɭ u ɭ ɭ u	호놀룰루
호두	ɸʷ o̞ d u	호두
호떡	ɸʷ o̞ t͈ ʌ̹ k̚	호떡
호랑	ɸʷ o̞ ɾ a̠ ŋ	호랑
호랑나비	ɸʷ o̞ː ɾ a̠ ŋ n a̠ b i	호랑나비
호랑이	ɸʷ o̞ː ɾ a̠ ŋ i	호라이
호러	ɸʷ o̞ ɾ ʌ̹	호러
호루라기	ɸʷ o̞ ɾ u ɾ a̠ ɡ i	호루라기
호르몬	ɸʷ o̞ ɾ ɯ m o̞ n	호르몬
호밀	ɸʷ o̞ m i ɭ	호밀
호박	ɸʷ o̞ː b a̠ k̚	호박
호소	ɸʷ o̞ sʰ o̞	호소
호숫가	ɸʷ o̞ sʰ u t̚ k͈ a̠	호숟까
호스	ɸʷ o̞ sʰ ɯ	호스
호전	ɸʷ o̞ː d͡ʑ ʌ̹ n	호전
호주	ɸʷ o̞ d͡ʑ u	호주
호주머니	ɸʷ o̞ d͡ʑ u m ʌ̹ n i	호주머니
호주인	ɸʷ o̞ d͡ʑ u i n	호주인
호지명	ɸʷ o̞ d͡ʑ i m j ʌ̹ ŋ	호지명
호텔	ɸʷ o̞ tʰ e̞ ɭ	호텔
호평	ɸʷ o̞ː pʰ j ʌ̹ ŋ	호평
호흡하다	ɸʷ o̞ ɣ ɯ pʰ a̠ d a̠	호ɣㅡ파다
혹성	ɸʷ o̞ k s͈ ʌ̹ ŋ	혹썽
혹시	ɸʷ o̞ k ɕ͈ i	혹씨
혹시나	ɸʷ o̞ k ɕ͈ i n a̠	혹씨나
혹여	ɸʷ o̞ ɡ j ʌ̹	호겨
혹여나	ɸʷ o̞ ɡ j ʌ̹ n a̠	호겨나
혹은	ɸʷ o̞ ɡ ɯ n	호근
혼돈	ɸʷ o̞ n d o̞ n	혼돈
혼란	ɸʷ o̞ː ɭ ɭ a̠ n	홀란
혼령	ɸʷ o̞ ʎ ʎ j ʌ̹ ŋ	홀령
혼례	ɸʷ o̞ ʎ ʎ j e̞	홀례
혼례식	ɸʷ o̞ ʎ ʎ j e̞ ɕʰ i k̚	홀례식
혼수	ɸʷ o̞ n sʰ u	혼수
혼약	ɸʷ o̞ ɲ j a̠ k̚	호냑
혼자	ɸʷ o̞ ɲ d͡ʑ a̠	혼자
혼합	ɸʷ o̞ n ɦ a̠ p̚	혼합
혼혈	ɸʷ o̞ː n ʝ j ʌ̹ ɭ	혼혈
홀로	ɸʷ o̞ ɭ ɭ o̞	홀로
홀소리어울림	ɸʷ o̞ ɭ s͈ o̞ ɾ i ʌ̹ u ʎ ʎ i m	홀쏘리어울림
홀아비	ɸʷ o̞ ɾ a̠ b i	호라비
홀어미	ɸʷ o̞ ɾ ʌ̹ m i	호러미
홈페이지	ɸʷ o̞ m pʰ e̞ i d͡ʑ i	홈페이지
홈페지	ɸʷ o̞ m pʰ e̞ d͡ʑ i	홈페지
홋카이도	ɸʷ o̞ t̚ kʰ a̠ i d o̞	혿카이도
홍길동	ɸʷ o̞ ŋ ɡ i ɭ d o̞ ŋ	홍길동
홍당무	ɸʷ o̞ ŋ d a̠ ŋ m u	홍당무
홍머리오리	ɸʷ o̞ ŋ m ʌ̹ ɾ i o̞ ɾ i	홍머리오리
홍보	ɸʷ o̞ ŋ b o̞	홍보
홍송어	ɸʷ o̞ ŋ sʰ o̞ ŋ ʌ̹	홍소어
홍수	ɸʷ o̞ ŋ sʰ u	홍수
홍시	ɸʷ o̞ ŋ ɕʰ i	홍시
홍어	ɸʷ o̞ ŋ ʌ̹	호어
홍어회	ɸʷ o̞ ŋ ʌ̹ β w e̞	호어회
홍역	ɸʷ o̞ ŋ j ʌ̹ k̚	호역
홍차	ɸʷ o̞ ŋ t͡ɕʰ a̠	홍차
홍콩	ɸʷ o̞ ŋ kʰ o̞ ŋ	홍콩
홍합	ɸʷ o̞ ŋ ɦ a̠ p̚	홍합
화가	ɸ w a̠ː ɡ a̠	화가
화강암	ɸ w a̠ ɡ a̠ ŋ a̠ m	화가암
화기	ɸ w a̠ː ɡ i	화기
화단	ɸ w a̠ d a̠ n	화단
화물	ɸ w a̠ː m u ɭ	화물
화보	ɸ w a̠ː b o̞	화보
화분	ɸ w a̠ b u n	화분
화사하다	ɸ w a̠ sʰ a̠ ɦ a̠ d a̠	화사하다
화산학	ɸ w a̠ː sʰ a̠ n ɦ a̠ k̚	화산학
화살	ɸ w a̠ sʰ a̠ ɭ	화살
화살표	ɸ w a̠ sʰ a̠ ɭ pʰ j o	화살표
화석	ɸ w a̠ː sʰ ʌ̹ k̚	화석
화신	ɸ w a̠ː ɕʰ i n	화신
화약	ɸ w a̠ː j a̠ k̚	화약
화염병	ɸ w a̠ː j ʌ̹ m p͈ j ʌ̹ ŋ	화염뼝
화요일	ɸ w a̠ j o i ɭ	화요일
화음	ɸ w a̠ ɯ m	화음
화이자	ɸ w a̠ i d͡ʑ a̠	화이자
화이팅	ɸ w a̠ i tʰ i ŋ	화이팅
화장장	ɸ w a̠ː d͡ʑ a̠ ŋ d͡ʑ a̠ ŋ	화장장
화장지	ɸ w a̠ d͡ʑ a̠ ŋ d͡ʑ i	화장지
화지	ɸ w a̠ d͡ʑ i	화지
화차	ɸ w a̠ː t͡ɕʰ a̠	화차
화창하다	ɸ w a̠ t͡ɕʰ a̠ ŋ ɦ a̠ d a̠	화창하다
화폐	ɸ w a̠ː pʰ j e̞	화폐
화학	ɸ w a̠ː ɦ a̠ k̚	화학
화학자	ɸ w a̠ː ɦ a̠ k̚ t͡ɕ͈ a̠	화학짜
화합물	ɸ w a̠ː ɦ a̠ m m u ɭ	화함물
확률	ɸ w a̠ ŋ ɲ j u ɭ	황뉼
확립	ɸ w a̠ ŋ n i p̚	황닙
확산	ɸ w a̠ k s͈ a̠ n	확싼
확성기	ɸ w a̠ k s͈ ʌ̹ ŋ ɡ i	확썽기
확신	ɸ w a̠ k ɕ͈ i n	확씬
확실하다	ɸ w a̠ k ɕ͈ i ɾ ɦ a̠ d a̠	확씰하다
확인	ɸ w a̠ ɡ i n	화긴
확인하다	ɸ w a̠ ɡ i n ɦ a̠ d a̠	화긴하다
확장	ɸ w a̠ k̚ t͡ɕ͈ a̠ ŋ	확짱
환경	ɸ w a̠ n ɡ j ʌ̹ ŋ	환경
환경오염	ɸ w a̠ n ɡ j ʌ̹ ŋ o̞ j ʌ̹ m	환겨오염
환관	ɸ w a̠ n ɡ w a̠ n	환관
환멸	ɸ w a̠ː n m j ʌ̹ ɭ	환멸
환불	ɸ w a̠ n b u ɭ	환불
환상	ɸ w a̠ː n sʰ a̠ ŋ	환상
환상적	ɸ w a̠ n sʰ a̠ ŋ d͡ʑ ʌ̹ k̚	환상적
환승	ɸ w a̠ː n sʰ ɯ ŋ	환승
환전	ɸ w a̠ ɲ d͡ʑ ʌ̹ n	환전
환절기	ɸ w a̠ː ɲ d͡ʑ ʌ̹ ɭ ɡ i	환절기
환하다	ɸ w a̠ː n ɦ a̠ d a̠	환하다
활기	ɸ w a̠ ɭ ɡ i	활기
활동	ɸ w a̠ ɭ t͈ o̞ ŋ	활똥
활동가	ɸ w a̠ ɭ t͈ o̞ ŋ ɡ a̠	활똥가
활동사진	ɸ w a̠ ɭ t͈ o̞ ŋ sʰ a̠ d͡ʑ i n	활똥사진
활동적	ɸ w a̠ ɭ t͈ o̞ ŋ d͡ʑ ʌ̹ k̚	활똥적
활동하다	ɸ w a̠ ɭ t͈ o̞ ŋ ɦ a̠ d a̠	활똥하다
활발	ɸ w a̠ ɭ b a̠ ɭ	활발
활발하다	ɸ w a̠ ɭ b a̠ ɾ ɦ a̠ d a̠	활발하다
활성	ɸ w a̠ ɭ s͈ ʌ̹ ŋ	활썽
활성탄	ɸ w a̠ ɭ s͈ ʌ̹ ŋ tʰ a̠ n	활썽탄
활용	ɸ w a̠ ɾ j o ŋ	화룡
활자	ɸ w a̠ ʎ t͡ɕ͈ a̠	활짜
황금	ɸ w a̠ ŋ ɡ ɯ m	황금
황도	ɸ w a̠ː ŋ d o̞	황도
황동	ɸ w a̠ ŋ d o̞ ŋ	황동
황량	ɸ w a̠ ŋ ɲ j a̠ ŋ	황냥
황량하다	ɸ w a̠ ŋ ɲ j a̠ ŋ ɦ a̠ d a̠	황냥하다
황로	ɸ w a̠ ŋ n o̞	황노
황어	ɸ w a̠ ŋ ʌ̹	화어
황제	ɸ w a̠ ŋ d͡ʑ e̞	황제
황조롱이	ɸ w a̠ ŋ d͡ʑ o̞ ɾ o̞ ŋ i	황조로이
황하	ɸ w a̠ ŋ ɦ a̠	황하
황혼	ɸ w a̠ ŋ β o̞ n	황혼
황후	ɸ w a̠ ŋ β u	황후
회계사	ɸ w e̞ː ɡ j e̞ sʰ a̠	회계사
회계학	ɸ w e̞ː ɡ j e̞ ɦ a̠ k̚	회계학
회관	ɸ w e̞ː ɡ w a̠ n	회관
회교	ɸ w e̞ ɡ j o	회교
회귀	ɸ w e̞ ɡ ɥ i	회귀
회담	ɸ w e̞ː d a̠ m	회담
회랑	ɸ w e̞ ɾ a̠ ŋ	회랑
회령	ɸ w e̞ː ɾ j ʌ̹ ŋ	회령
회복하다	ɸ w e̞ b o̞ kʰ a̠ d a̠	회보카다
회비	ɸ w e̞ː b i	회비
회사	ɸ w e̞ː sʰ a̠	회사
회사원	ɸ w e̞ː sʰ a̠ w ʌ̹ n	회사원
회상	ɸ w e̞ sʰ a̠ ŋ	회상
회원	ɸ w e̞ː w ʌ̹ n	회원
회음	ɸ w e̞ː ɯ m	회음
회장	ɸ w e̞ː d͡ʑ a̠ ŋ	회장
회전	ɸ w e̞ d͡ʑ ʌ̹ n	회전
회전목마	ɸ w e̞ d͡ʑ ʌ̹ n m o̞ ŋ m a̠	회전몽마
회합	ɸ w e̞ː ɦ a̠ p̚	회합
횡단	ɸ w e̞ ŋ d a̠ n	횡단
횡단보도	ɸ w e̞ ŋ d a̠ n b o̞ d o̞	횡단보도
횡적	ɸ w e̞ ŋ t͡ɕ͈ ʌ̹ k̚	횡쩍
횡파	ɸ w e̞ ŋ pʰ a̠	횡파
후견인	ɸʷ uː ɡ j ʌ̹ n i n	후겨닌
후계자	ɸʷ uː ɡ j e̞ d͡ʑ a̠	후계자
후뇌	ɸʷ u n w e̞	후뇌
후두	ɸʷ u d u	후두
후드	ɸʷ u d ɯ	후드
후레이크	ɸʷ u ɾ e̞ i k x ɯ	후레익흐
후베이	ɸʷ u b e̞ i	후베이
후보자	ɸʷ u b o̞ d͡ʑ a̠	후보자
후식	ɸʷ uː ɕʰ i k̚	후식
후예	ɸʷ uː j e̞	후예
후유증	ɸʷ uː j u t͡ɕ͈ ɯ ŋ	후유쯩
후작	ɸʷ u d͡ʑ a̠ k̚	후작
후조	ɸʷ u d͡ʑ o̞	후조
후지	ɸʷ u d͡ʑ i	후지
후추	ɸʷ u t͡ɕʰ u	후추
후춧가루	ɸʷ u t͡ɕʰ u t̚ k͈ a̠ ɾ u	후춛까루
후쿠시마	ɸʷ u kʰ u ɕʰ i m a̠	후쿠시마
훈독	ɸʷ uː n d o̞ k̚	훈독
훈민정음	ɸʷ uː n m i ɲ d͡ʑ ʌ̹ ŋ ɯ m	훈민저음
훈장	ɸʷ u ɲ d͡ʑ a̠ ŋ	훈장
훈제	ɸʷ u ɲ d͡ʑ e̞	훈제
훈주음종	ɸʷ uː ɲ d͡ʑ u ɯ m d͡ʑ o̞ ŋ	훈주음종
훑어보다	ɸʷ u ɭ tʰ ʌ̹ b o̞ d a̠	훌터보다
휘파람	h ɥ i pʰ a̠ ɾ a̠ m	휘파람
휠체어	h ɥ i ʎ t͡ɕʰ e̞ ʌ̹	휠체어
흐느적	x ɯ n ɯ d͡ʑ ʌ̹ k̚	흐느적
흐르다	x ɯ ɾ ɯ d a̠	흐르다
흐름	x ɯ ɾ ɯ m	흐름
흐릿하다	x ɯ ɾ i tʰ a̠ d a̠	흐리타다
흐지부지	x ɯ d͡ʑ i b u d͡ʑ i	흐지부지
흑두루미	x ɯ k̚ t͈ u ɾ u m i	흑뚜루미
흑로	x ɯ ŋ n o̞	흥노
흑설탕	x ɯ k s͈ ʌ̹ ɭ tʰ a̠ ŋ	흑썰탕
흑인	x ɯ ɡ i n	흐긴
흑체	x ɯ k̚ t͡ɕʰ e̞	흑체
흑흑	x ɯ k x ɯ k̚	흑흑
흔들다	x ɯ n d ɯ ɭ d a̠	흔들다
흔들리다	x ɯ n d ɯ ʎ ʎ i d a̠	흔들리다
흔적	x ɯ ɲ d͡ʑ ʌ̹ k̚	흔적
흔하다	x ɯ n ɦ a̠ d a̠	흔하다
흔히	x ɯ n ʝ i	흔히
흘러가다	x ɯ ɭ ɭ ʌ̹ ɡ a̠ d a̠	흘러가다
흘리다	x ɯ ʎ ʎ i d a̠	흘리다
흠결	x ɯ m ɡ j ʌ̹ ɭ	흠결
흠뻑	x ɯ m p͈ ʌ̹ k̚	흠뻑
흡사	x ɯ p s͈ a̠	흡싸
흡수지	x ɯ p s͈ u d͡ʑ i	흡쑤지
흡연	x ɯ b j ʌ̹ n	흐변
흡연자	x ɯ b j ʌ̹ ɲ d͡ʑ a̠	흐변자
흡인력	x ɯ b i ʎ ʎ j ʌ̹ k̚	흐빌력
흡혈귀	x ɯ pʰ j ʌ̹ ɭ ɡ ɥ i	흐펼귀
흥미	x ɯː ŋ m i	흥미
흥미롭다	x ɯː ŋ m i ɾ o̞ p̚ t͈ a̠	흥미롭따
흥분	x ɯ ŋ b u n	흥분
흥분하다	x ɯ ŋ b u n ɦ a̠ d a̠	흥분하다
흥정	x ɯ ŋ d͡ʑ ʌ̹ ŋ	흥정
흥청망청	x ɯ ŋ t͡ɕʰ ʌ̹ ŋ m a̠ ŋ t͡ɕʰ ʌ̹ ŋ	흥청망청
흥하다	x ɯ ŋ ɦ a̠ d a̠	흥하다
흩다	x ɯ t̚ t͈ a̠	흗따
흩어지다	x ɯ tʰ ʌ̹ d͡ʑ i d a̠	흐터지다
